82	Rhône-Alpes	01	2	10	001	L; Abergement-Clémenciat	784	14	798
82	Rhône-Alpes	01	1	01	002	L; Abergement-de-Varey	221	4	225
82	Rhône-Alpes	01	1	01	004	Ambérieu-en-Bugey	13835	481	14316
82	Rhône-Alpes	01	2	30	005	Ambérieux-en-Dombes	1616	22	1638
82	Rhône-Alpes	01	1	04	006	Ambléon	116	6	122
82	Rhône-Alpes	01	1	01	007	Ambronay	2362	119	2481
82	Rhône-Alpes	01	1	17	008	Ambutrix	729	16	745
82	Rhône-Alpes	01	1	04	009	Andert-et-Condon	340	16	356
82	Rhône-Alpes	01	1	31	010	Anglefort	994	13	1007
82	Rhône-Alpes	01	4	22	011	Apremont	363	8	371
82	Rhône-Alpes	01	1	15	012	Aranc	302	7	309
82	Rhône-Alpes	01	1	28	013	Arandas	163	5	168
82	Rhône-Alpes	01	4	23	014	Arbent	3476	127	3603
82	Rhône-Alpes	01	1	04	015	Arbignieu	480	12	492
82	Rhône-Alpes	01	2	26	016	Arbigny	399	12	411
82	Rhône-Alpes	01	1	28	017	Argis	421	8	429
82	Rhône-Alpes	01	1	36	019	Armix	20	2	22
82	Rhône-Alpes	01	2	42	021	Ars-sur-Formans	1367	20	1387
82	Rhône-Alpes	01	1	09	022	Artemare	1126	40	1166
82	Rhône-Alpes	01	2	02	023	Asnières-sur-Saône	73	1	74
82	Rhône-Alpes	01	2	21	024	Attignat	2936	45	2981
82	Rhône-Alpes	01	2	02	025	Bâgé-la-Ville	3040	92	3132
82	Rhône-Alpes	01	2	02	026	Bâgé-le-Châtel	796	75	871
82	Rhône-Alpes	01	2	20	027	Balan	2348	91	2439
82	Rhône-Alpes	01	2	30	028	Baneins	572	7	579
82	Rhône-Alpes	01	4	22	170	Béard-Géovreissiat	925	35	960
82	Rhône-Alpes	01	2	11	029	Beaupont	624	5	629
82	Rhône-Alpes	01	2	34	030	Beauregard	870	17	887
82	Rhône-Alpes	01	2	20	032	Béligneux	2905	55	2960
82	Rhône-Alpes	01	4	03	033	Bellegarde-sur-Valserine	11790	371	12161
82	Rhône-Alpes	01	1	04	034	Belley	8755	428	9183
82	Rhône-Alpes	01	4	23	035	Belleydoux	321	17	338
82	Rhône-Alpes	01	4	41	031	Bellignat	3537	175	3712
82	Rhône-Alpes	01	1	09	036	Belmont-Luthézieu	514	15	529
82	Rhône-Alpes	01	1	18	037	Bénonces	275	4	279
82	Rhône-Alpes	01	2	11	038	Bény	724	20	744
82	Rhône-Alpes	01	1	09	039	Béon	373	13	386
82	Rhône-Alpes	01	2	21	040	Béréziat	445	10	455
82	Rhône-Alpes	01	1	01	041	Bettant	724	12	736
82	Rhône-Alpes	01	2	27	042	Bey	245	10	255
82	Rhône-Alpes	01	2	40	043	Beynost	4475	96	4571
82	Rhône-Alpes	01	4	03	044	Billiat	484	5	489
82	Rhône-Alpes	01	2	35	045	Birieux	236	2	238
82	Rhône-Alpes	01	2	10	046	Biziat	797	14	811
82	Rhône-Alpes	01	1	17	047	Blyes	886	13	899
82	Rhône-Alpes	01	2	07	245	Bohas-Meyriat-Rignat	811	36	847
82	Rhône-Alpes	01	2	20	049	La Boisse	2928	52	2980
82	Rhône-Alpes	01	2	26	050	Boissey	288	7	295
82	Rhône-Alpes	01	4	16	051	Bolozon	94	4	98
82	Rhône-Alpes	01	2	35	052	Bouligneux	309	3	312
82	Rhône-Alpes	01	2	99	053	Bourg-en-Bresse	40088	2096	42184
82	Rhône-Alpes	01	2	19	054	Bourg-Saint-Christophe	1173	18	1191
82	Rhône-Alpes	01	4	24	056	Boyeux-Saint-Jérôme	321	8	329
82	Rhône-Alpes	01	2	26	057	Boz	496	3	499
82	Rhône-Alpes	01	1	04	058	Brégnier-Cordon	832	24	856
82	Rhône-Alpes	01	1	09	059	Brénaz	92	4	96
82	Rhône-Alpes	01	4	06	060	Brénod	544	17	561
82	Rhône-Alpes	01	1	04	061	Brens	1158	34	1192
82	Rhône-Alpes	01	2	20	062	Bressolles	709	18	727
82	Rhône-Alpes	01	4	22	063	Brion	517	8	525
82	Rhône-Alpes	01	1	18	064	Briord	893	13	906
82	Rhône-Alpes	01	2	43	065	Buellas	1669	69	1738
82	Rhône-Alpes	01	1	36	066	La Burbanche	72	1	73
82	Rhône-Alpes	01	4	16	067	Ceignes	265	4	269
82	Rhône-Alpes	01	4	24	068	Cerdon	741	14	755
82	Rhône-Alpes	01	2	25	069	Certines	1445	35	1480
82	Rhône-Alpes	01	3	14	071	Cessy	3992	133	4125
82	Rhône-Alpes	01	2	07	072	Ceyzériat	2738	77	2815
82	Rhône-Alpes	01	1	36	073	Ceyzérieu	929	31	960
82	Rhône-Alpes	01	2	08	074	Chalamont	2322	37	2359
82	Rhône-Alpes	01	2	30	075	Chaleins	1165	32	1197
82	Rhône-Alpes	01	1	28	076	Chaley	127	5	132
82	Rhône-Alpes	01	4	24	077	Challes-la-Montagne	179	7	186
82	Rhône-Alpes	01	3	12	078	Challex	1225	28	1253
82	Rhône-Alpes	01	1	09	079	Champagne-en-Valromey	765	19	784
82	Rhône-Alpes	01	4	06	080	Champdor	464	12	476
82	Rhône-Alpes	01	4	03	081	Champfromier	677	19	696
82	Rhône-Alpes	01	1	31	082	Chanay	617	12	629
82	Rhône-Alpes	01	2	30	083	Chaneins	820	19	839
82	Rhône-Alpes	01	2	10	084	Chanoz-Châtenay	706	5	711
82	Rhône-Alpes	01	2	35	085	La Chapelle-du-Châtelard	341	5	346
82	Rhône-Alpes	01	4	22	087	Charix	294	6	300
82	Rhône-Alpes	01	2	19	088	Charnoz-sur-Ain	911	13	924
82	Rhône-Alpes	01	1	01	089	Château-Gaillard	1818	33	1851
82	Rhône-Alpes	01	2	08	090	Châtenay	352	3	355
82	Rhône-Alpes	01	4	03	091	Châtillon-en-Michaille	3120	78	3198
82	Rhône-Alpes	01	2	08	092	Châtillon-la-Palud	1562	69	1631
82	Rhône-Alpes	01	2	10	093	Châtillon-sur-Chalaronne	4922	211	5133
82	Rhône-Alpes	01	2	26	094	Chavannes-sur-Reyssouze	680	14	694
82	Rhône-Alpes	01	2	33	095	Chavannes-sur-Suran	644	11	655
82	Rhône-Alpes	01	2	10	096	Chaveyriat	927	19	946
82	Rhône-Alpes	01	1	09	097	Chavornay	199	10	209
82	Rhône-Alpes	01	1	04	098	Chazey-Bons	744	13	757
82	Rhône-Alpes	01	1	17	099	Chazey-sur-Ain	1464	40	1504
82	Rhône-Alpes	01	1	36	100	Cheignieu-la-Balme	157	2	159
82	Rhône-Alpes	01	4	06	101	Chevillard	162	8	170
82	Rhône-Alpes	01	2	26	102	Chevroux	933	10	943
82	Rhône-Alpes	01	3	14	103	Chevry	1235	50	1285
82	Rhône-Alpes	01	3	12	104	Chézery-Forens	434	14	448
82	Rhône-Alpes	01	2	42	105	Civrieux	1362	77	1439
82	Rhône-Alpes	01	2	07	106	Cize	170	2	172
82	Rhône-Alpes	01	1	28	107	Cleyzieu	135	0	135
82	Rhône-Alpes	01	2	11	108	Coligny	1154	21	1175
82	Rhône-Alpes	01	3	12	109	Collonges	1897	33	1930
82	Rhône-Alpes	01	1	04	110	Colomieu	115	2	117
82	Rhône-Alpes	01	1	28	111	Conand	104	5	109
82	Rhône-Alpes	01	4	06	112	Condamine	404	33	437
82	Rhône-Alpes	01	2	10	113	Condeissiat	756	16	772
82	Rhône-Alpes	01	3	12	114	Confort	525	17	542
82	Rhône-Alpes	01	2	21	115	Confrançon	1157	20	1177
82	Rhône-Alpes	01	1	36	116	Contrevoz	539	17	556
82	Rhône-Alpes	01	1	04	117	Conzieu	135	5	140
82	Rhône-Alpes	01	1	31	118	Corbonod	1176	22	1198
82	Rhône-Alpes	01	4	06	119	Corcelles	243	9	252
82	Rhône-Alpes	01	1	15	121	Corlier	124	2	126
82	Rhône-Alpes	01	1	15	122	Cormaranche-en-Bugey	859	77	936
82	Rhône-Alpes	01	2	27	123	Cormoranche-sur-Saône	1058	18	1076
82	Rhône-Alpes	01	2	29	124	Cormoz	625	8	633
82	Rhône-Alpes	01	2	33	125	Corveissiat	602	15	617
82	Rhône-Alpes	01	2	33	127	Courmangoux	507	10	517
82	Rhône-Alpes	01	2	29	128	Courtes	266	3	269
82	Rhône-Alpes	01	2	08	129	Crans	269	9	278
82	Rhône-Alpes	01	2	21	130	Cras-sur-Reyssouze	1256	15	1271
82	Rhône-Alpes	01	1	04	133	Cressin-Rochefort	374	4	378
82	Rhône-Alpes	01	2	27	134	Crottet	1722	51	1773
82	Rhône-Alpes	01	3	14	135	Crozet	1862	67	1929
82	Rhône-Alpes	01	2	27	136	Cruzilles-lès-Mépillat	818	17	835
82	Rhône-Alpes	01	1	31	138	Culoz	2909	54	2963
82	Rhône-Alpes	01	2	29	139	Curciat-Dongalon	456	7	463
82	Rhône-Alpes	01	2	21	140	Curtafond	702	8	710
82	Rhône-Alpes	01	1	36	141	Cuzieu	407	17	424
82	Rhône-Alpes	01	2	20	142	Dagneux	4099	50	4149
82	Rhône-Alpes	01	3	14	143	Divonne-les-Bains	8160	239	8399
82	Rhône-Alpes	01	2	02	144	Dommartin	841	12	853
82	Rhône-Alpes	01	2	10	146	Dompierre-sur-Chalaronne	389	6	395
82	Rhône-Alpes	01	2	25	145	Dompierre-sur-Veyle	1226	24	1250
82	Rhône-Alpes	01	2	11	147	Domsure	473	11	484
82	Rhône-Alpes	01	4	23	148	Dortan	1996	62	2058
82	Rhône-Alpes	01	1	01	149	Douvres	962	33	995
82	Rhône-Alpes	01	2	07	150	Drom	209	2	211
82	Rhône-Alpes	01	2	25	151	Druillat	1134	26	1160
82	Rhône-Alpes	01	4	23	152	Échallon	772	31	803
82	Rhône-Alpes	01	3	14	153	Échenevex	1631	57	1688
82	Rhône-Alpes	01	2	21	154	Étrez	803	16	819
82	Rhône-Alpes	01	1	28	155	Évosges	140	3	143
82	Rhône-Alpes	01	2	19	156	Faramans	681	14	695
82	Rhône-Alpes	01	2	30	157	Fareins	2137	43	2180
82	Rhône-Alpes	01	3	12	158	Farges	854	23	877
82	Rhône-Alpes	01	2	02	159	Feillens	3115	107	3222
82	Rhône-Alpes	01	3	13	160	Ferney-Voltaire	8025	233	8258
82	Rhône-Alpes	01	1	36	162	Flaxieu	63	3	66
82	Rhône-Alpes	01	2	21	163	Foissiat	1912	32	1944
82	Rhône-Alpes	01	2	30	165	Francheleins	1323	23	1346
82	Rhône-Alpes	01	2	34	166	Frans	1984	44	2028
82	Rhône-Alpes	01	2	32	167	Garnerans	656	22	678
82	Rhône-Alpes	01	2	32	169	Genouilleux	609	10	619
82	Rhône-Alpes	01	4	41	171	Géovreisset	903	31	934
82	Rhône-Alpes	01	2	33	172	Germagnat	145	0	145
82	Rhône-Alpes	01	3	14	173	Gex	10372	262	10634
82	Rhône-Alpes	01	4	03	174	Giron	162	6	168
82	Rhône-Alpes	01	2	26	175	Gorrevod	799	15	814
82	Rhône-Alpes	01	4	06	176	Le Grand-Abergement	109	6	115
82	Rhône-Alpes	01	2	07	177	Grand-Corent	161	4	165
82	Rhône-Alpes	01	2	27	179	Grièges	1899	57	1956
82	Rhône-Alpes	01	3	14	180	Grilly	762	26	788
82	Rhône-Alpes	01	4	41	181	Groissiat	1143	36	1179
82	Rhône-Alpes	01	1	18	182	Groslée	353	7	360
82	Rhône-Alpes	01	2	32	183	Guéreins	1308	33	1341
82	Rhône-Alpes	01	2	07	184	Hautecourt-Romanèche	773	20	793
82	Rhône-Alpes	01	1	15	185	Hauteville-Lompnes	4044	148	4192
82	Rhône-Alpes	01	1	28	186	Hostiaz	82	2	84
82	Rhône-Alpes	01	4	06	187	Hotonnes	306	17	323
82	Rhône-Alpes	01	2	32	188	Illiat	570	20	590
82	Rhône-Alpes	01	4	03	189	Injoux-Génissiat	1055	20	1075
82	Rhône-Alpes	01	1	18	190	Innimond	114	2	116
82	Rhône-Alpes	01	4	06	191	Izenave	164	5	169
82	Rhône-Alpes	01	4	16	192	Izernore	2278	72	2350
82	Rhône-Alpes	01	1	04	193	Izieu	201	4	205
82	Rhône-Alpes	01	2	34	194	Jassans-Riottier	5976	111	6087
82	Rhône-Alpes	01	2	07	195	Jasseron	1552	45	1597
82	Rhône-Alpes	01	2	21	196	Jayat	1049	11	1060
82	Rhône-Alpes	01	2	25	197	Journans	324	11	335
82	Rhône-Alpes	01	2	19	198	Joyeux	223	2	225
82	Rhône-Alpes	01	4	24	199	Jujurieux	2097	41	2138
82	Rhône-Alpes	01	4	24	200	Labalme	204	1	205
82	Rhône-Alpes	01	1	17	202	Lagnieu	6756	161	6917
82	Rhône-Alpes	01	2	27	203	Laiz	1130	30	1160
82	Rhône-Alpes	01	4	22	204	Lalleyriat	239	12	251
82	Rhône-Alpes	01	3	12	205	Lancrans	1052	37	1089
82	Rhône-Alpes	01	4	06	206	Lantenay	257	8	265
82	Rhône-Alpes	01	2	35	207	Lapeyrouse	292	5	297
82	Rhône-Alpes	01	1	04	208	Lavours	148	4	152
82	Rhône-Alpes	01	3	12	209	Léaz	569	16	585
82	Rhône-Alpes	01	3	14	210	Lélex	225	9	234
82	Rhône-Alpes	01	2	39	211	Lent	1328	29	1357
82	Rhône-Alpes	01	2	29	212	Lescheroux	683	3	686
82	Rhône-Alpes	01	1	17	213	Leyment	1273	20	1293
82	Rhône-Alpes	01	4	16	214	Leyssard	153	8	161
82	Rhône-Alpes	01	4	03	215	Lhôpital	59	1	60
82	Rhône-Alpes	01	1	18	216	Lhuis	854	16	870
82	Rhône-Alpes	01	1	09	218	Lochieu	91	4	95
82	Rhône-Alpes	01	1	18	219	Lompnas	149	3	152
82	Rhône-Alpes	01	1	09	221	Lompnieu	122	5	127
82	Rhône-Alpes	01	1	17	224	Loyettes	2645	29	2674
82	Rhône-Alpes	01	2	30	225	Lurcy	393	11	404
82	Rhône-Alpes	01	1	04	227	Magnieu	419	4	423
82	Rhône-Alpes	01	4	22	228	Maillat	668	14	682
82	Rhône-Alpes	01	2	21	229	Malafretaz	952	28	980
82	Rhône-Alpes	01	2	29	230	Mantenay-Montlin	288	3	291
82	Rhône-Alpes	01	2	02	231	Manziat	1924	61	1985
82	Rhône-Alpes	01	2	11	232	Marboz	2182	48	2230
82	Rhône-Alpes	01	1	18	233	Marchamp	118	3	121
82	Rhône-Alpes	01	1	36	234	Marignieu	148	4	152
82	Rhône-Alpes	01	2	35	235	Marlieux	887	45	932
82	Rhône-Alpes	01	2	21	236	Marsonnas	1005	17	1022
82	Rhône-Alpes	01	4	41	237	Martignat	1604	65	1669
82	Rhône-Alpes	01	2	42	238	Massieux	2428	37	2465
82	Rhône-Alpes	01	1	04	239	Massignieu-de-Rives	608	12	620
82	Rhône-Alpes	01	4	16	240	Matafelon-Granges	652	20	672
82	Rhône-Alpes	01	2	33	241	Meillonnas	1298	22	1320
82	Rhône-Alpes	01	4	24	242	Mérignat	139	4	143
82	Rhône-Alpes	01	2	30	243	Messimy-sur-Saône	1209	21	1230
82	Rhône-Alpes	01	2	19	244	Meximieux	7268	187	7455
82	Rhône-Alpes	01	2	10	246	Mézériat	2072	33	2105
82	Rhône-Alpes	01	3	14	247	Mijoux	379	18	397
82	Rhône-Alpes	01	2	42	248	Mionnay	2077	37	2114
82	Rhône-Alpes	01	2	40	249	Miribel	9066	139	9205
82	Rhône-Alpes	01	2	42	250	Misérieux	1762	223	1985
82	Rhône-Alpes	01	2	32	252	Mogneneins	727	25	752
82	Rhône-Alpes	01	2	39	254	Montagnat	1646	54	1700
82	Rhône-Alpes	01	1	18	255	Montagnieu	495	17	512
82	Rhône-Alpes	01	4	03	257	Montanges	330	10	340
82	Rhône-Alpes	01	2	32	258	Montceaux	1164	22	1186
82	Rhône-Alpes	01	2	43	259	Montcet	665	13	678
82	Rhône-Alpes	01	2	19	260	Le Montellier	244	6	250
82	Rhône-Alpes	01	2	35	261	Monthieux	599	20	619
82	Rhône-Alpes	01	2	20	262	Montluel	6999	175	7174
82	Rhône-Alpes	01	2	32	263	Montmerle-sur-Saône	3823	63	3886
82	Rhône-Alpes	01	2	39	264	Montracol	967	20	987
82	Rhône-Alpes	01	4	22	265	Montréal-la-Cluse	3457	90	3547
82	Rhône-Alpes	01	2	21	266	Montrevel-en-Bresse	2362	33	2395
82	Rhône-Alpes	01	1	04	268	Murs-et-Gélignieux	241	8	249
82	Rhône-Alpes	01	4	22	269	Nantua	3713	155	3868
82	Rhône-Alpes	01	1	04	271	Nattages	564	14	578
82	Rhône-Alpes	01	2	10	272	Neuville-les-Dames	1504	16	1520
82	Rhône-Alpes	01	2	25	273	Neuville-sur-Ain	1571	40	1611
82	Rhône-Alpes	01	4	22	274	Les Neyrolles	637	21	658
82	Rhône-Alpes	01	2	40	275	Neyron	2472	42	2514
82	Rhône-Alpes	01	2	20	276	Niévroz	1488	41	1529
82	Rhône-Alpes	01	1	28	277	Nivollet-Montgriffon	143	2	145
82	Rhône-Alpes	01	4	16	267	Nurieux-Volognat	1058	30	1088
82	Rhône-Alpes	01	1	28	279	Oncieu	91	4	95
82	Rhône-Alpes	01	1	18	280	Ordonnaz	141	1	142
82	Rhône-Alpes	01	3	13	281	Ornex	3531	125	3656
82	Rhône-Alpes	01	4	06	282	Outriaz	256	8	264
82	Rhône-Alpes	01	4	98	283	Oyonnax	22650	658	23308
82	Rhône-Alpes	01	2	26	284	Ozan	618	17	635
82	Rhône-Alpes	01	2	42	285	Parcieux	1095	42	1137
82	Rhône-Alpes	01	1	04	286	Parves	360	2	362
82	Rhône-Alpes	01	3	12	288	Péron	2143	44	2187
82	Rhône-Alpes	01	2	39	289	Péronnas	6054	340	6394
82	Rhône-Alpes	01	2	19	290	Pérouges	1204	35	1239
82	Rhône-Alpes	01	2	27	291	Perrex	826	16	842
82	Rhône-Alpes	01	4	06	292	Le Petit-Abergement	138	9	147
82	Rhône-Alpes	01	4	16	293	Peyriat	171	4	175
82	Rhône-Alpes	01	1	04	294	Peyrieu	821	20	841
82	Rhône-Alpes	01	2	32	295	Peyzieux-sur-Saône	473	12	485
82	Rhône-Alpes	01	2	11	296	Pirajoux	360	6	366
82	Rhône-Alpes	01	2	20	297	Pizay	777	18	795
82	Rhône-Alpes	01	4	03	298	Plagne	129	2	131
82	Rhône-Alpes	01	2	08	299	Le Plantay	540	13	553
82	Rhône-Alpes	01	4	22	300	Le Poizat	422	8	430
82	Rhône-Alpes	01	2	43	301	Polliat	2403	54	2457
82	Rhône-Alpes	01	1	04	302	Pollieu	157	7	164
82	Rhône-Alpes	01	4	24	303	Poncin	1644	45	1689
82	Rhône-Alpes	01	2	25	304	Pont-d;Ain	2627	51	2678
82	Rhône-Alpes	01	2	26	305	Pont-de-Vaux	2205	49	2254
82	Rhône-Alpes	01	2	27	306	Pont-de-Veyle	1593	98	1691
82	Rhône-Alpes	01	4	22	307	Port	847	27	874
82	Rhône-Alpes	01	3	12	308	Pougny	802	6	808
82	Rhône-Alpes	01	2	33	309	Pouillat	88	0	88
82	Rhône-Alpes	01	1	04	310	Prémeyzel	234	6	240
82	Rhône-Alpes	01	1	15	311	Prémillieu	36	1	37
82	Rhône-Alpes	01	2	33	312	Pressiat	224	6	230
82	Rhône-Alpes	01	3	13	313	Prévessin-Moëns	5980	202	6182
82	Rhône-Alpes	01	2	25	314	Priay	1488	22	1510
82	Rhône-Alpes	01	1	36	316	Pugieu	168	1	169
82	Rhône-Alpes	01	2	07	317	Ramasse	250	6	256
82	Rhône-Alpes	01	2	42	318	Rancé	641	11	652
82	Rhône-Alpes	01	2	30	319	Relevant	466	9	475
82	Rhône-Alpes	01	2	02	320	Replonges	3500	66	3566
82	Rhône-Alpes	01	2	07	321	Revonnas	788	10	798
82	Rhône-Alpes	01	2	42	322	Reyrieux	4093	94	4187
82	Rhône-Alpes	01	2	26	323	Reyssouze	929	25	954
82	Rhône-Alpes	01	2	19	325	Rignieux-le-Franc	950	17	967
82	Rhône-Alpes	01	2	10	328	Romans	587	7	594
82	Rhône-Alpes	01	1	36	329	Rossillon	148	4	152
82	Rhône-Alpes	01	1	09	330	Ruffieu	202	17	219
82	Rhône-Alpes	01	4	24	331	Saint-Alban	163	6	169
82	Rhône-Alpes	01	2	27	334	Saint-André-d;Huiriat	543	12	555
82	Rhône-Alpes	01	2	02	332	Saint-André-de-Bâgé	635	16	651
82	Rhône-Alpes	01	2	42	333	Saint-André-de-Corcy	2991	57	3048
82	Rhône-Alpes	01	2	10	335	Saint-André-le-Bouchoux	316	5	321
82	Rhône-Alpes	01	2	39	336	Saint-André-sur-Vieux-Jonc	1079	24	1103
82	Rhône-Alpes	01	2	26	337	Saint-Bénigne	1161	30	1191
82	Rhône-Alpes	01	1	18	338	Saint-Benoît	773	15	788
82	Rhône-Alpes	01	2	34	339	Saint-Bernard	1375	31	1406
82	Rhône-Alpes	01	1	04	340	Saint-Bois	123	2	125
82	Rhône-Alpes	01	1	04	341	Saint-Champ	139	4	143
82	Rhône-Alpes	01	2	27	343	Saint-Cyr-sur-Menthon	1636	42	1678
82	Rhône-Alpes	01	1	01	345	Saint-Denis-en-Bugey	2178	31	2209
82	Rhône-Alpes	01	2	43	344	Saint-Denis-lès-Bourg	5405	170	5575
82	Rhône-Alpes	01	2	21	346	Saint-Didier-d;Aussiat	863	13	876
82	Rhône-Alpes	01	2	34	347	Saint-Didier-de-Formans	1792	67	1859
82	Rhône-Alpes	01	2	32	348	Saint-Didier-sur-Chalaronne	2776	55	2831
82	Rhône-Alpes	01	2	19	349	Saint-Éloi	399	6	405
82	Rhône-Alpes	01	2	33	350	Saint-Étienne-du-Bois	2441	55	2496
82	Rhône-Alpes	01	2	32	351	Saint-Étienne-sur-Chalaronne	1468	40	1508
82	Rhône-Alpes	01	2	26	352	Saint-Étienne-sur-Reyssouze	531	11	542
82	Rhône-Alpes	01	3	13	354	Saint-Genis-Pouilly	8914	175	9089
82	Rhône-Alpes	01	2	27	355	Saint-Genis-sur-Menthon	408	10	418
82	Rhône-Alpes	01	2	10	356	Saint-Georges-sur-Renon	197	5	202
82	Rhône-Alpes	01	4	03	357	Saint-Germain-de-Joux	480	9	489
82	Rhône-Alpes	01	1	04	358	Saint-Germain-les-Paroisses	387	8	395
82	Rhône-Alpes	01	2	35	359	Saint-Germain-sur-Renon	236	8	244
82	Rhône-Alpes	01	3	12	360	Saint-Jean-de-Gonville	1496	54	1550
82	Rhône-Alpes	01	2	19	361	Saint-Jean-de-Niost	1421	39	1460
82	Rhône-Alpes	01	2	42	362	Saint-Jean-de-Thurigneux	710	9	719
82	Rhône-Alpes	01	4	24	363	Saint-Jean-le-Vieux	1609	85	1694
82	Rhône-Alpes	01	2	29	364	Saint-Jean-sur-Reyssouze	744	16	760
82	Rhône-Alpes	01	2	27	365	Saint-Jean-sur-Veyle	1082	30	1112
82	Rhône-Alpes	01	2	29	367	Saint-Julien-sur-Reyssouze	668	10	678
82	Rhône-Alpes	01	2	10	368	Saint-Julien-sur-Veyle	715	9	724
82	Rhône-Alpes	01	2	39	369	Saint-Just	881	39	920
82	Rhône-Alpes	01	2	02	370	Saint-Laurent-sur-Saône	1749	19	1768
82	Rhône-Alpes	01	2	35	371	Saint-Marcel	1212	19	1231
82	Rhône-Alpes	01	1	36	372	Saint-Martin-de-Bavel	443	12	455
82	Rhône-Alpes	01	4	22	373	Saint-Martin-du-Frêne	1077	46	1123
82	Rhône-Alpes	01	2	25	374	Saint-Martin-du-Mont	1651	42	1693
82	Rhône-Alpes	01	2	21	375	Saint-Martin-le-Châtel	790	22	812
82	Rhône-Alpes	01	2	40	376	Saint-Maurice-de-Beynost	3865	71	3936
82	Rhône-Alpes	01	2	19	378	Saint-Maurice-de-Gourdans	2498	49	2547
82	Rhône-Alpes	01	1	01	379	Saint-Maurice-de-Rémens	709	10	719
82	Rhône-Alpes	01	2	29	380	Saint-Nizier-le-Bouchoux	703	15	718
82	Rhône-Alpes	01	2	08	381	Saint-Nizier-le-Désert	880	17	897
82	Rhône-Alpes	01	2	35	383	Saint-Paul-de-Varax	1551	7	1558
82	Rhône-Alpes	01	1	28	384	Saint-Rambert-en-Bugey	2164	41	2205
82	Rhône-Alpes	01	2	39	385	Saint-Rémy	906	21	927
82	Rhône-Alpes	01	1	17	386	Saint-Sorlin-en-Bugey	1061	48	1109
82	Rhône-Alpes	01	2	21	387	Saint-Sulpice	142	0	142
82	Rhône-Alpes	01	2	29	388	Saint-Trivier-de-Courtes	1013	18	1031
82	Rhône-Alpes	01	2	30	389	Saint-Trivier-sur-Moignans	1877	28	1905
82	Rhône-Alpes	01	1	17	390	Saint-Vulbas	957	16	973
82	Rhône-Alpes	01	2	20	342	Sainte-Croix	534	9	543
82	Rhône-Alpes	01	2	42	353	Sainte-Euphémie	1482	36	1518
82	Rhône-Alpes	01	1	17	366	Sainte-Julie	889	12	901
82	Rhône-Alpes	01	2	30	382	Sainte-Olive	303	4	307
82	Rhône-Alpes	01	2	11	391	Salavre	284	5	289
82	Rhône-Alpes	01	4	16	392	Samognat	718	21	739
82	Rhône-Alpes	01	2	10	393	Sandrans	524	8	532
82	Rhône-Alpes	01	1	17	396	Sault-Brénaz	1043	12	1055
82	Rhône-Alpes	01	3	13	397	Sauverny	1078	42	1120
82	Rhône-Alpes	01	2	30	398	Savigneux	1204	13	1217
82	Rhône-Alpes	01	3	14	399	Ségny	1649	58	1707
82	Rhône-Alpes	01	1	18	400	Seillonnaz	138	3	141
82	Rhône-Alpes	01	3	13	401	Sergy	1977	46	2023
82	Rhône-Alpes	01	2	26	402	Sermoyer	669	14	683
82	Rhône-Alpes	01	1	18	403	Serrières-de-Briord	1174	19	1193
82	Rhône-Alpes	01	4	16	404	Serrières-sur-Ain	119	1	120
82	Rhône-Alpes	01	2	39	405	Servas	1184	15	1199
82	Rhône-Alpes	01	2	29	406	Servignat	160	1	161
82	Rhône-Alpes	01	1	31	407	Seyssel	942	21	963
82	Rhône-Alpes	01	2	07	408	Simandre-sur-Suran	650	20	670
82	Rhône-Alpes	01	1	09	409	Songieu	130	3	133
82	Rhône-Alpes	01	4	16	410	Sonthonnax-la-Montagne	320	20	340
82	Rhône-Alpes	01	1	17	411	Souclin	261	4	265
82	Rhône-Alpes	01	2	10	412	Sulignat	569	23	592
82	Rhône-Alpes	01	4	03	413	Surjoux	78	1	79
82	Rhône-Alpes	01	1	09	414	Sutrieu	235	8	243
82	Rhône-Alpes	01	1	09	415	Talissieu	425	5	430
82	Rhône-Alpes	01	1	28	416	Tenay	1120	26	1146
82	Rhône-Alpes	01	1	15	417	Thézillieu	324	4	328
82	Rhône-Alpes	01	2	40	418	Thil	1070	26	1096
82	Rhône-Alpes	01	3	13	419	Thoiry	5205	161	5366
82	Rhône-Alpes	01	2	32	420	Thoissey	1540	17	1557
82	Rhône-Alpes	01	1	28	421	Torcieu	698	13	711
82	Rhône-Alpes	01	2	25	422	Tossiat	1406	37	1443
82	Rhône-Alpes	01	2	42	423	Toussieux	769	22	791
82	Rhône-Alpes	01	2	42	424	Tramoyes	1674	35	1709
82	Rhône-Alpes	01	2	25	425	La Tranclière	301	3	304
82	Rhône-Alpes	01	2	33	426	Treffort-Cuisiat	2204	47	2251
82	Rhône-Alpes	01	2	34	427	Trévoux	6730	177	6907
82	Rhône-Alpes	01	2	32	428	Valeins	88	1	89
82	Rhône-Alpes	01	2	43	429	Vandeins	619	4	623
82	Rhône-Alpes	01	2	25	430	Varambon	521	14	535
82	Rhône-Alpes	01	1	17	431	Vaux-en-Bugey	1169	26	1195
82	Rhône-Alpes	01	2	11	432	Verjon	250	6	256
82	Rhône-Alpes	01	2	29	433	Vernoux	285	2	287
82	Rhône-Alpes	01	2	08	434	Versailleux	332	5	337
82	Rhône-Alpes	01	3	13	435	Versonnex	2144	57	2201
82	Rhône-Alpes	01	3	14	436	Vesancy	526	34	560
82	Rhône-Alpes	01	2	29	437	Vescours	208	4	212
82	Rhône-Alpes	01	2	02	439	Vésines	91	3	94
82	Rhône-Alpes	01	1	09	442	Vieu	380	14	394
82	Rhône-Alpes	01	4	06	441	Vieu-d;Izenave	693	15	708
82	Rhône-Alpes	01	2	35	443	Villars-les-Dombes	4399	92	4491
82	Rhône-Alpes	01	1	17	444	Villebois	1153	17	1170
82	Rhône-Alpes	01	2	11	445	Villemotier	632	12	644
82	Rhône-Alpes	01	2	30	446	Villeneuve	1383	21	1404
82	Rhône-Alpes	01	2	07	447	Villereversure	1208	104	1312
82	Rhône-Alpes	01	4	03	448	Villes	385	11	396
82	Rhône-Alpes	01	2	08	449	Villette-sur-Ain	673	23	696
82	Rhône-Alpes	01	2	19	450	Villieu-Loyes-Mollon	3095	61	3156
82	Rhône-Alpes	01	2	43	451	Viriat	6006	177	6183
82	Rhône-Alpes	01	1	36	452	Virieu-le-Grand	1156	28	1184
82	Rhône-Alpes	01	1	09	453	Virieu-le-Petit	309	5	314
82	Rhône-Alpes	01	1	04	454	Virignin	855	25	880
82	Rhône-Alpes	01	1	36	456	Vongnes	74	6	80
82	Rhône-Alpes	01	2	10	457	Vonnas	2790	59	2849
22	Picardie	02	2	09	001	Abbécourt	528	10	538
22	Picardie	02	2	14	002	Achery	587	9	596
22	Picardie	02	4	04	003	Acy	959	19	978
22	Picardie	02	2	19	004	Agnicourt-et-Séchelles	207	7	214
22	Picardie	02	2	21	005	Aguilcourt	349	11	360
22	Picardie	02	5	16	006	Aisonville-et-Bernoville	288	5	293
22	Picardie	02	2	12	007	Aizelles	112	3	115
22	Picardie	02	4	32	008	Aizy-Jouy	287	8	295
22	Picardie	02	3	20	009	Alaincourt	503	5	508
22	Picardie	02	4	32	010	Allemant	180	12	192
22	Picardie	02	4	35	011	Ambleny	1134	86	1220
22	Picardie	02	4	24	012	Ambrief	63	4	67
22	Picardie	02	2	21	013	Amifontaine	418	10	428
22	Picardie	02	2	09	014	Amigny-Rouy	731	15	746
22	Picardie	02	4	36	015	Ancienville	73	1	74
22	Picardie	02	2	14	016	Andelain	186	9	195
22	Picardie	02	2	14	017	Anguilcourt-le-Sart	292	8	300
22	Picardie	02	2	01	018	Anizy-le-Château	1895	28	1923
22	Picardie	02	3	29	019	Annois	383	3	386
22	Picardie	02	5	02	020	Any-Martin-Rieux	476	11	487
22	Picardie	02	2	26	021	Archon	87	2	89
22	Picardie	02	4	24	022	Arcy-Sainte-Restitue	427	19	446
22	Picardie	02	1	22	023	Armentières-sur-Ourcq	98	1	99
22	Picardie	02	2	38	024	Arrancy	50	1	51
22	Picardie	02	3	29	025	Artemps	359	5	364
22	Picardie	02	1	10	026	Artonges	184	2	186
22	Picardie	02	2	13	027	Assis-sur-Serre	275	4	279
22	Picardie	02	2	38	028	Athies-sous-Laon	2515	54	2569
22	Picardie	02	3	33	029	Attilly	384	10	394
22	Picardie	02	3	06	030	Aubencheul-aux-Bois	310	8	318
22	Picardie	02	5	02	031	Aubenton	713	8	721
22	Picardie	02	3	29	032	Aubigny-aux-Kaisnes	242	2	244
22	Picardie	02	2	12	033	Aubigny-en-Laonnois	116	2	118
22	Picardie	02	2	11	034	Audignicourt	102	2	104
22	Picardie	02	5	16	035	Audigny	265	7	272
22	Picardie	02	4	04	036	Augy	90	2	92
22	Picardie	02	2	18	037	Aulnois-sous-Laon	1292	27	1319
22	Picardie	02	2	26	038	Les Autels	74	3	77
22	Picardie	02	2	19	039	Autremencourt	185	3	188
22	Picardie	02	5	34	040	Autreppes	187	4	191
22	Picardie	02	2	09	041	Autreville	822	13	835
22	Picardie	02	1	08	042	Azy-sur-Marne	387	4	391
22	Picardie	02	4	35	043	Bagneux	73	1	74
22	Picardie	02	5	34	044	Bancigny	28	0	28
22	Picardie	02	2	13	046	Barenton-Bugny	589	9	598
22	Picardie	02	2	13	047	Barenton-Cel	136	2	138
22	Picardie	02	2	13	048	Barenton-sur-Serre	115	5	120
22	Picardie	02	2	11	049	Barisis	723	14	737
22	Picardie	02	5	23	050	Barzy-en-Thiérache	306	2	308
22	Picardie	02	1	10	051	Barzy-sur-Marne	386	7	393
22	Picardie	02	2	01	052	Bassoles-Aulers	132	3	135
22	Picardie	02	1	10	053	Baulne-en-Brie	288	5	293
22	Picardie	02	4	04	054	Bazoches-sur-Vesles	457	5	462
22	Picardie	02	5	02	055	Beaumé	97	3	100
22	Picardie	02	2	09	056	Beaumont-en-Beine	161	0	161
22	Picardie	02	3	06	057	Beaurevoir	1512	17	1529
22	Picardie	02	2	12	058	Beaurieux	793	16	809
22	Picardie	02	2	42	059	Beautor	2642	54	2696
22	Picardie	02	3	33	060	Beauvois-en-Vermandois	278	6	284
22	Picardie	02	3	03	061	Becquigny	284	5	289
22	Picardie	02	1	08	062	Belleau	135	3	138
22	Picardie	02	3	06	063	Bellenglise	386	8	394
22	Picardie	02	4	41	064	Belleu	3881	79	3960
22	Picardie	02	3	06	065	Bellicourt	636	15	651
22	Picardie	02	3	20	066	Benay	213	4	217
22	Picardie	02	5	23	067	Bergues-sur-Sambre	220	3	223
22	Picardie	02	5	27	068	Berlancourt	104	2	106
22	Picardie	02	2	26	069	Berlise	126	1	127
22	Picardie	02	5	16	070	Bernot	459	15	474
22	Picardie	02	4	35	071	Berny-Rivière	613	23	636
22	Picardie	02	2	12	072	Berrieux	177	6	183
22	Picardie	02	2	21	073	Berry-au-Bac	575	3	578
22	Picardie	02	2	14	074	Bertaucourt-Epourdon	610	6	616
22	Picardie	02	3	20	075	Berthenicourt	214	2	216
22	Picardie	02	2	21	076	Bertricourt	156	2	158
22	Picardie	02	4	41	077	Berzy-le-Sec	396	5	401
22	Picardie	02	2	11	078	Besmé	164	4	168
22	Picardie	02	5	02	079	Besmont	153	2	155
22	Picardie	02	2	18	080	Besny-et-Loizy	372	17	389
22	Picardie	02	2	09	081	Béthancourt-en-Vaux	420	5	425
22	Picardie	02	4	24	082	Beugneux	122	2	124
22	Picardie	02	1	15	083	Beuvardes	721	12	733
22	Picardie	02	1	07	084	Bézu-le-Guéry	259	11	270
22	Picardie	02	1	08	085	Bézu-Saint-Germain	959	14	973
22	Picardie	02	2	11	086	Bichancourt	1041	14	1055
22	Picardie	02	4	35	087	Bieuxy	30	0	30
22	Picardie	02	2	38	088	Bièvres	73	7	80
22	Picardie	02	4	41	089	Billy-sur-Aisne	1081	20	1101
22	Picardie	02	4	24	090	Billy-sur-Ourcq	215	6	221
22	Picardie	02	4	04	091	Blanzy-lès-Fismes	91	3	94
22	Picardie	02	2	11	093	Blérancourt	1262	59	1321
22	Picardie	02	1	08	094	Blesmes	371	13	384
22	Picardie	02	3	03	095	Bohain-en-Vermandois	5976	140	6116
22	Picardie	02	2	13	096	Bois-lès-Pargny	183	8	191
22	Picardie	02	2	30	097	Boncourt	250	5	255
22	Picardie	02	1	08	098	Bonneil	402	9	411
22	Picardie	02	1	22	099	Bonnesvalyn	242	9	251
22	Picardie	02	3	06	100	Bony	135	4	139
22	Picardie	02	2	19	101	Bosmont-sur-Serre	206	1	207
22	Picardie	02	2	12	102	Bouconville-Vauclair	181	0	181
22	Picardie	02	5	23	103	Boué	1265	12	1277
22	Picardie	02	2	21	104	Bouffignereux	103	4	107
22	Picardie	02	1	08	105	Bouresches	203	7	210
22	Picardie	02	2	12	106	Bourg-et-Comin	754	17	771
22	Picardie	02	2	11	107	Bourguignon-sous-Coucy	91	0	91
22	Picardie	02	2	01	108	Bourguignon-sous-Montbavin	133	5	138
22	Picardie	02	5	34	109	La Bouteille	502	7	509
22	Picardie	02	4	04	110	Braine	2162	38	2200
22	Picardie	02	2	01	111	Brancourt-en-Laonnois	677	13	690
22	Picardie	02	3	03	112	Brancourt-le-Grand	619	15	634
22	Picardie	02	1	08	114	Brasles	1318	46	1364
22	Picardie	02	3	29	117	Bray-Saint-Christophe	80	2	82
22	Picardie	02	4	32	118	Braye	120	3	123
22	Picardie	02	2	12	115	Braye-en-Laonnois	223	4	227
22	Picardie	02	5	34	116	Braye-en-Thiérache	139	3	142
22	Picardie	02	1	15	119	Brécy	352	8	360
22	Picardie	02	4	04	120	Brenelle	199	4	203
22	Picardie	02	4	24	121	Breny	268	10	278
22	Picardie	02	2	14	122	Brie	59	2	61
22	Picardie	02	3	20	123	Brissay-Choigny	317	4	321
22	Picardie	02	3	20	124	Brissy-Hamégicourt	639	11	650
22	Picardie	02	1	22	125	Brumetz	222	5	227
22	Picardie	02	2	26	126	Brunehamel	538	18	556
22	Picardie	02	2	38	128	Bruyères-et-Montbérault	1576	39	1615
22	Picardie	02	1	15	127	Bruyères-sur-Fère	206	11	217
22	Picardie	02	4	04	129	Bruys	19	0	19
22	Picardie	02	5	17	130	Bucilly	195	11	206
22	Picardie	02	4	32	131	Bucy-le-Long	1955	46	2001
22	Picardie	02	2	18	132	Bucy-lès-Cerny	185	10	195
22	Picardie	02	2	30	133	Bucy-lès-Pierrepont	416	12	428
22	Picardie	02	5	17	134	Buire	884	22	906
22	Picardie	02	5	05	135	Buironfosse	1189	16	1205
22	Picardie	02	5	34	136	Burelles	138	2	140
22	Picardie	02	1	22	137	Bussiares	122	0	122
22	Picardie	02	4	24	138	Buzancy	186	11	197
22	Picardie	02	2	09	139	Caillouël-Crépigny	420	8	428
22	Picardie	02	2	11	140	Camelin	442	9	451
22	Picardie	02	5	05	141	La Capelle	1853	89	1942
22	Picardie	02	3	29	142	Castres	231	4	235
22	Picardie	02	3	06	143	Le Catelet	194	5	199
22	Picardie	02	3	33	144	Caulaincourt	136	4	140
22	Picardie	02	2	09	145	Caumont	562	21	583
22	Picardie	02	1	10	147	La Celle-sous-Montmirail	114	2	116
22	Picardie	02	1	10	146	Celles-lès-Condé	74	5	79
22	Picardie	02	4	32	148	Celles-sur-Aisne	256	4	260
22	Picardie	02	3	20	149	Cerizy	58	2	60
22	Picardie	02	2	12	150	Cerny-en-Laonnois	71	1	72
22	Picardie	02	2	18	151	Cerny-lès-Bucy	116	8	124
22	Picardie	02	4	04	152	Cerseuil	91	3	94
22	Picardie	02	2	01	153	Cessières	470	14	484
22	Picardie	02	4	24	154	Chacrise	312	14	326
22	Picardie	02	2	01	155	Chaillevois	188	8	196
22	Picardie	02	2	13	156	Chalandry	217	6	223
22	Picardie	02	2	18	157	Chambry	718	24	742
22	Picardie	02	2	12	158	Chamouille	260	7	267
22	Picardie	02	2	11	159	Champs	293	10	303
22	Picardie	02	2	26	160	Chaourse	535	8	543
22	Picardie	02	1	10	161	La Chapelle-Monthodon	189	7	196
22	Picardie	02	1	07	162	La Chapelle-sur-Chézy	281	7	288
22	Picardie	02	1	07	163	Charly-sur-Marne	2739	50	2789
22	Picardie	02	1	15	164	Le Charmel	322	4	326
22	Picardie	02	2	14	165	Charmes	1659	45	1704
22	Picardie	02	1	10	166	Chartèves	368	10	378
22	Picardie	02	4	04	167	Chassemy	803	11	814
22	Picardie	02	1	08	168	Château-Thierry	14480	540	15020
22	Picardie	02	2	19	169	Châtillon-lès-Sons	81	3	84
22	Picardie	02	3	20	170	Châtillon-sur-Oise	129	6	135
22	Picardie	02	2	21	171	Chaudardes	88	3	91
22	Picardie	02	4	24	172	Chaudun	261	7	268
22	Picardie	02	2	09	173	Chauny	11983	437	12420
22	Picardie	02	4	32	174	Chavignon	762	14	776
22	Picardie	02	4	31	175	Chavigny	153	3	156
22	Picardie	02	4	32	176	Chavonne	193	2	195
22	Picardie	02	2	38	177	Chérêt	125	8	133
22	Picardie	02	2	12	178	Chermizy-Ailles	96	1	97
22	Picardie	02	4	04	179	Chéry-Chartreuve	341	6	347
22	Picardie	02	2	13	180	Chéry-lès-Pouilly	673	15	688
22	Picardie	02	2	26	181	Chéry-lès-Rozoy	105	1	106
22	Picardie	02	5	27	182	Chevennes	142	6	148
22	Picardie	02	2	01	183	Chevregny	192	5	197
22	Picardie	02	3	25	184	Chevresis-Monceau	356	5	361
22	Picardie	02	1	22	185	Chézy-en-Orxois	360	8	368
22	Picardie	02	1	07	186	Chézy-sur-Marne	1327	47	1374
22	Picardie	02	1	08	187	Chierry	1055	26	1081
22	Picardie	02	5	05	188	Chigny	155	10	165
22	Picardie	02	2	30	189	Chivres-en-Laonnois	367	3	370
22	Picardie	02	4	32	190	Chivres-Val	585	14	599
22	Picardie	02	2	38	191	Chivy-lès-Étouvelles	503	16	519
22	Picardie	02	1	22	192	Chouy	395	11	406
22	Picardie	02	1	15	193	Cierges	74	0	74
22	Picardie	02	2	19	194	Cilly	222	3	225
22	Picardie	02	4	04	195	Ciry-Salsogne	842	15	857
22	Picardie	02	2	38	196	Clacy-et-Thierret	346	3	349
22	Picardie	02	5	05	197	Clairfontaine	569	103	672
22	Picardie	02	4	32	198	Clamecy	223	3	226
22	Picardie	02	3	29	199	Clastres	611	3	614
22	Picardie	02	2	26	200	Clermont-les-Fermes	120	3	123
22	Picardie	02	4	35	201	Coeuvres-et-Valsery	462	7	469
22	Picardie	02	1	15	203	Coincy	1310	24	1334
22	Picardie	02	5	02	204	Coingt	77	1	78
22	Picardie	02	2	12	205	Colligis-Crandelain	181	2	183
22	Picardie	02	5	27	206	Colonfay	71	1	72
22	Picardie	02	2	09	207	Commenchon	191	5	196
22	Picardie	02	2	21	208	Concevreux	259	10	269
22	Picardie	02	1	10	209	Condé-en-Brie	656	14	670
22	Picardie	02	4	32	210	Condé-sur-Aisne	417	1	418
22	Picardie	02	2	21	211	Condé-sur-Suippe	229	6	235
22	Picardie	02	2	09	212	Condren	707	16	723
22	Picardie	02	1	10	213	Connigis	325	4	329
22	Picardie	02	3	29	214	Contescourt	66	1	67
22	Picardie	02	2	12	215	Corbeny	745	3	748
22	Picardie	02	4	36	216	Corcy	310	7	317
22	Picardie	02	2	11	219	Coucy-la-Ville	213	77	290
22	Picardie	02	2	11	217	Coucy-le-Château-Auffrique	1076	57	1133
22	Picardie	02	2	30	218	Coucy-lès-Eppes	576	6	582
22	Picardie	02	1	15	220	Coulonges-Cohan	428	11	439
22	Picardie	02	1	07	221	Coupru	186	3	189
22	Picardie	02	2	14	222	Courbes	34	0	34
22	Picardie	02	1	10	223	Courboin	296	9	305
22	Picardie	02	4	04	224	Courcelles-sur-Vesle	345	4	349
22	Picardie	02	1	22	225	Courchamps	89	0	89
22	Picardie	02	4	41	226	Courmelles	1700	31	1731
22	Picardie	02	1	15	227	Courmont	110	8	118
22	Picardie	02	1	10	228	Courtemont-Varennes	298	31	329
22	Picardie	02	2	30	229	Courtrizy-et-Fussigny	67	2	69
22	Picardie	02	4	04	230	Couvrelles	189	8	197
22	Picardie	02	2	13	231	Couvron-et-Aumencourt	1325	83	1408
22	Picardie	02	4	36	232	Coyolles	388	18	406
22	Picardie	02	4	24	233	Cramaille	130	5	135
22	Picardie	02	2	12	234	Craonne	76	2	78
22	Picardie	02	2	12	235	Craonnelle	111	0	111
22	Picardie	02	2	11	236	Crécy-au-Mont	289	6	295
22	Picardie	02	2	13	237	Crécy-sur-Serre	1454	50	1504
22	Picardie	02	2	18	238	Crépy	1896	32	1928
22	Picardie	02	1	10	239	Crézancy	1110	114	1224
22	Picardie	02	3	03	240	Croix-Fonsomme	227	3	230
22	Picardie	02	1	22	241	La Croix-sur-Ourcq	124	1	125
22	Picardie	02	1	07	242	Crouttes-sur-Marne	645	9	654
22	Picardie	02	4	31	243	Crouy	2716	55	2771
22	Picardie	02	5	05	244	Crupilly	66	1	67
22	Picardie	02	4	31	245	Cuffies	1686	23	1709
22	Picardie	02	3	29	246	Cugny	576	11	587
22	Picardie	02	2	19	248	Cuirieux	161	3	164
22	Picardie	02	4	24	249	Cuiry-Housse	107	2	109
22	Picardie	02	2	12	250	Cuiry-lès-Chaudardes	84	3	87
22	Picardie	02	2	26	251	Cuiry-lès-Iviers	37	1	38
22	Picardie	02	2	12	252	Cuissy-et-Geny	66	2	68
22	Picardie	02	4	35	253	Cuisy-en-Almont	317	10	327
22	Picardie	02	4	35	254	Cutry	115	1	116
22	Picardie	02	4	04	255	Cys-la-Commune	152	1	153
22	Picardie	02	2	26	256	Dagny-Lambercy	132	4	136
22	Picardie	02	3	29	257	Dallon	377	13	390
22	Picardie	02	1	22	258	Dammard	416	6	422
22	Picardie	02	4	36	259	Dampleux	437	11	448
22	Picardie	02	2	14	260	Danizy	569	6	575
22	Picardie	02	2	13	261	Dercy	367	7	374
22	Picardie	02	2	14	262	Deuillet	234	1	235
22	Picardie	02	4	04	263	Dhuizel	115	0	115
22	Picardie	02	2	26	264	Dizy-le-Gros	790	10	800
22	Picardie	02	2	26	265	Dohis	92	1	93
22	Picardie	02	2	26	266	Dolignon	59	0	59
22	Picardie	02	4	35	267	Dommiers	287	8	295
22	Picardie	02	1	07	268	Domptin	673	20	693
22	Picardie	02	5	23	269	Dorengt	157	0	157
22	Picardie	02	3	33	270	Douchy	150	1	151
22	Picardie	02	1	15	271	Dravegny	144	4	148
22	Picardie	02	4	24	272	Droizy	75	6	81
22	Picardie	02	3	29	273	Dury	196	3	199
22	Picardie	02	2	30	274	Ébouleau	206	1	207
22	Picardie	02	5	17	275	Effry	353	4	357
22	Picardie	02	5	05	276	Englancourt	118	4	122
22	Picardie	02	4	35	277	Épagny	341	5	346
22	Picardie	02	5	17	278	Éparcy	44	3	47
22	Picardie	02	1	08	279	Épaux-Bézu	588	16	604
22	Picardie	02	1	08	280	Épieds	389	12	401
22	Picardie	02	1	07	281	L; Épine-aux-Bois	259	2	261
22	Picardie	02	2	38	282	Eppes	411	5	416
22	Picardie	02	2	19	283	Erlon	292	8	300
22	Picardie	02	5	05	284	Erloy	92	1	93
22	Picardie	02	5	23	286	Esquéhéries	850	16	866
22	Picardie	02	3	20	287	Essigny-le-Grand	1109	32	1141
22	Picardie	02	3	39	288	Essigny-le-Petit	377	9	386
22	Picardie	02	1	07	289	Essises	430	12	442
22	Picardie	02	1	08	290	Essômes-sur-Marne	2741	80	2821
22	Picardie	02	3	06	291	Estrées	416	1	417
22	Picardie	02	1	08	292	Étampes-sur-Marne	1164	26	1190
22	Picardie	02	3	03	293	Étaves-et-Bocquiaux	556	9	565
22	Picardie	02	2	38	294	Étouvelles	223	10	233
22	Picardie	02	5	05	295	Étréaupont	895	17	912
22	Picardie	02	3	33	296	Étreillers	1199	35	1234
22	Picardie	02	1	08	297	Étrépilly	81	2	83
22	Picardie	02	5	37	298	Étreux	1509	31	1540
22	Picardie	02	2	21	299	Évergnicourt	566	6	572
22	Picardie	02	2	01	301	Faucoucourt	311	9	320
22	Picardie	02	4	36	302	Faverolles	343	8	351
22	Picardie	02	3	33	303	Fayet	588	20	608
22	Picardie	02	2	14	304	La Fère	3037	126	3163
22	Picardie	02	1	15	305	Fère-en-Tardenois	3270	71	3341
22	Picardie	02	3	25	306	La Ferté-Chevresis	589	14	603
22	Picardie	02	1	22	307	La Ferté-Milon	2240	148	2388
22	Picardie	02	5	23	308	Fesmy-le-Sart	490	4	494
22	Picardie	02	2	38	309	Festieux	604	8	612
22	Picardie	02	3	39	310	Fieulaine	281	1	282
22	Picardie	02	4	32	311	Filain	137	0	137
22	Picardie	02	5	05	312	La Flamengrie	1102	12	1114
22	Picardie	02	5	16	313	Flavigny-le-Grand-et-Beaurain	473	8	481
22	Picardie	02	3	29	315	Flavy-le-Martel	1636	22	1658
22	Picardie	02	4	36	316	Fleury	129	5	134
22	Picardie	02	3	33	317	Fluquières	213	8	221
22	Picardie	02	2	11	318	Folembray	1504	38	1542
22	Picardie	02	3	39	319	Fonsomme	535	8	543
22	Picardie	02	3	29	320	Fontaine-lès-Clercs	289	14	303
22	Picardie	02	5	34	321	Fontaine-lès-Vervins	987	178	1165
22	Picardie	02	3	39	322	Fontaine-Notre-Dame	384	2	386
22	Picardie	02	3	03	323	Fontaine-Uterte	127	3	130
22	Picardie	02	5	05	324	Fontenelle	289	3	292
22	Picardie	02	1	10	325	Fontenelle-en-Brie	210	8	218
22	Picardie	02	4	35	326	Fontenoy	494	14	508
22	Picardie	02	3	33	327	Foreste	184	0	184
22	Picardie	02	1	08	328	Fossoy	577	24	601
22	Picardie	02	2	14	329	Fourdrain	404	10	414
22	Picardie	02	3	33	330	Francilly-Selency	465	14	479
22	Picardie	02	5	27	331	Franqueville	130	3	133
22	Picardie	02	2	11	333	Fresnes	152	0	152
22	Picardie	02	1	15	332	Fresnes-en-Tardenois	253	4	257
22	Picardie	02	3	03	334	Fresnoy-le-Grand	3096	42	3138
22	Picardie	02	2	14	335	Fressancourt	210	8	218
22	Picardie	02	2	09	336	Frières-Faillouël	985	17	1002
22	Picardie	02	5	05	337	Froidestrées	208	0	208
22	Picardie	02	2	19	338	Froidmont-Cohartille	238	6	244
22	Picardie	02	1	22	339	Gandelu	679	9	688
22	Picardie	02	3	40	340	Gauchy	5443	109	5552
22	Picardie	02	5	34	341	Gercy	295	4	299
22	Picardie	02	5	05	342	Gergny	152	4	156
22	Picardie	02	3	33	343	Germaine	66	0	66
22	Picardie	02	2	21	344	Gernicourt	50	2	52
22	Picardie	02	3	20	345	Gibercourt	45	0	45
22	Picardie	02	2	30	346	Gizy	684	7	691
22	Picardie	02	1	08	347	Gland	497	10	507
22	Picardie	02	4	04	348	Glennes	226	4	230
22	Picardie	02	2	12	349	Goudelancourt-lès-Berrieux	63	0	63
22	Picardie	02	2	30	350	Goudelancourt-lès-Pierrepont	142	3	145
22	Picardie	02	1	15	351	Goussancourt	110	0	110
22	Picardie	02	3	06	352	Gouy	591	3	594
22	Picardie	02	4	24	665	Grand-Rozoy	293	8	301
22	Picardie	02	5	37	783	Grand-Verly	149	4	153
22	Picardie	02	2	19	353	Grandlup-et-Fay	320	9	329
22	Picardie	02	2	26	354	Grandrieux	88	1	89
22	Picardie	02	3	33	355	Gricourt	869	24	893
22	Picardie	02	1	22	356	Grisolles	193	2	195
22	Picardie	02	5	34	357	Gronard	73	3	76
22	Picardie	02	5	37	358	Grougis	385	10	395
22	Picardie	02	3	29	359	Grugies	1121	23	1144
22	Picardie	02	2	21	360	Guignicourt	2111	42	2153
22	Picardie	02	5	16	361	Guise	5173	120	5293
22	Picardie	02	2	09	362	Guivry	263	6	269
22	Picardie	02	2	11	363	Guny	446	7	453
22	Picardie	02	2	21	364	Guyencourt	225	11	236
22	Picardie	02	5	37	366	Hannapes	289	3	292
22	Picardie	02	3	29	367	Happencourt	148	3	151
22	Picardie	02	4	36	368	Haramont	611	7	618
22	Picardie	02	5	34	369	Harcigny	249	3	252
22	Picardie	02	3	06	370	Hargicourt	557	7	564
22	Picardie	02	3	40	371	Harly	1707	35	1742
22	Picardie	02	4	24	372	Hartennes-et-Taux	333	14	347
22	Picardie	02	5	34	373	Hary	222	4	226
22	Picardie	02	1	22	375	Hautevesnes	158	1	159
22	Picardie	02	5	16	376	Hauteville	167	6	173
22	Picardie	02	5	34	377	Haution	147	3	150
22	Picardie	02	5	17	378	La Hérie	153	4	157
22	Picardie	02	5	27	379	Le Hérie-la-Viéville	239	115	354
22	Picardie	02	3	20	380	Hinacourt	33	0	33
22	Picardie	02	5	17	381	Hirson	9383	373	9756
22	Picardie	02	3	33	382	Holnon	1433	38	1471
22	Picardie	02	3	40	383	Homblières	1471	41	1512
22	Picardie	02	5	34	384	Houry	63	0	63
22	Picardie	02	5	27	385	Housset	173	10	183
22	Picardie	02	5	16	386	Iron	222	3	225
22	Picardie	02	3	20	387	Itancourt	1118	22	1140
22	Picardie	02	5	02	388	Iviers	210	1	211
22	Picardie	02	1	10	389	Jaulgonne	666	16	682
22	Picardie	02	3	33	390	Jeancourt	238	1	239
22	Picardie	02	5	02	391	Jeantes	217	3	220
22	Picardie	02	3	06	392	Joncourt	322	6	328
22	Picardie	02	4	04	393	Jouaignes	170	2	172
22	Picardie	02	2	11	395	Jumencourt	154	2	156
22	Picardie	02	2	12	396	Jumigny	69	3	72
22	Picardie	02	3	29	397	Jussy	1243	15	1258
22	Picardie	02	4	31	398	Juvigny	280	2	282
22	Picardie	02	2	21	399	Juvincourt-et-Damary	493	2	495
22	Picardie	02	4	32	400	Laffaux	147	0	147
22	Picardie	02	5	34	401	Laigny	220	1	221
22	Picardie	02	3	33	402	Lanchy	52	1	53
22	Picardie	02	5	27	403	Landifay-et-Bertaignemont	292	8	300
22	Picardie	02	5	34	404	Landouzy-la-Cour	167	5	172
22	Picardie	02	5	02	405	Landouzy-la-Ville	526	8	534
22	Picardie	02	2	11	406	Landricourt	127	2	129
22	Picardie	02	2	01	407	Laniscourt	175	3	178
22	Picardie	02	2	97	408	Laon	25986	1005	26991
22	Picardie	02	2	30	409	Lappion	295	7	302
22	Picardie	02	4	36	410	Largny-sur-Automne	234	7	241
22	Picardie	02	1	22	411	Latilly	213	3	216
22	Picardie	02	4	24	412	Launoy	102	1	103
22	Picardie	02	2	01	413	Laval-en-Laonnois	255	8	263
22	Picardie	02	5	16	414	Lavaqueresse	212	5	217
22	Picardie	02	4	35	415	Laversine	152	2	154
22	Picardie	02	3	06	374	Lehaucourt	912	9	921
22	Picardie	02	5	27	416	Lemé	447	4	451
22	Picardie	02	3	06	417	Lempire	108	2	110
22	Picardie	02	5	05	418	Lerzy	219	0	219
22	Picardie	02	5	23	419	Leschelle	296	4	300
22	Picardie	02	3	39	420	Lesdins	854	18	872
22	Picardie	02	4	04	421	Lesges	83	9	92
22	Picardie	02	5	16	422	Lesquielles-Saint-Germain	859	24	883
22	Picardie	02	2	11	423	Leuilly-sous-Coucy	413	2	415
22	Picardie	02	4	31	424	Leury	104	4	108
22	Picardie	02	5	02	425	Leuze	162	4	166
22	Picardie	02	3	06	426	Levergies	587	16	603
22	Picardie	02	4	04	427	Lhuys	149	1	150
22	Picardie	02	1	22	428	Licy-Clignon	87	1	88
22	Picardie	02	2	12	429	Lierval	115	2	117
22	Picardie	02	2	30	430	Liesse-Notre-Dame	1275	77	1352
22	Picardie	02	2	42	431	Liez	435	5	440
22	Picardie	02	4	04	432	Limé	188	5	193
22	Picardie	02	2	26	433	Lislet	239	0	239
22	Picardie	02	2	01	434	Lizy	269	6	275
22	Picardie	02	5	02	435	Logny-lès-Aubenton	77	1	78
22	Picardie	02	4	36	438	Longpont	294	8	302
22	Picardie	02	4	04	439	Longueval-Barbonval	485	8	493
22	Picardie	02	2	21	440	Lor	142	6	148
22	Picardie	02	4	36	441	Louâtre	213	5	218
22	Picardie	02	1	15	442	Loupeigne	78	2	80
22	Picardie	02	1	07	443	Lucy-le-Bocage	175	2	177
22	Picardie	02	5	34	444	Lugny	126	4	130
22	Picardie	02	5	05	445	Luzoir	290	2	292
22	Picardie	02	3	20	446	Ly-Fontaine	120	0	120
22	Picardie	02	4	24	447	Maast-et-Violaine	160	4	164
22	Picardie	02	2	30	448	Mâchecourt	122	5	127
22	Picardie	02	1	22	449	Macogny	81	1	82
22	Picardie	02	5	16	450	Macquigny	374	5	379
22	Picardie	02	3	06	451	Magny-la-Fosse	128	4	132
22	Picardie	02	3	33	452	Maissemy	245	3	248
22	Picardie	02	2	21	453	Maizy	425	5	430
22	Picardie	02	2	21	454	La Malmaison	411	5	416
22	Picardie	02	5	16	455	Malzy	194	4	198
22	Picardie	02	2	11	456	Manicamp	309	12	321
22	Picardie	02	2	30	457	Marchais	379	4	383
22	Picardie	02	1	10	458	Marchais-en-Brie	275	4	279
22	Picardie	02	3	39	459	Marcy	157	8	165
22	Picardie	02	2	19	460	Marcy-sous-Marle	220	6	226
22	Picardie	02	2	09	461	Marest-Dampcourt	336	4	340
22	Picardie	02	1	15	462	Mareuil-en-Dôle	248	1	249
22	Picardie	02	5	27	463	Marfontaine	84	4	88
22	Picardie	02	4	32	464	Margival	320	8	328
22	Picardie	02	1	08	465	Marigny-en-Orxois	462	12	474
22	Picardie	02	1	22	467	Marizy-Saint-Mard	59	1	60
22	Picardie	02	1	22	466	Marizy-Sainte-Geneviève	130	3	133
22	Picardie	02	2	19	468	Marle	2351	60	2411
22	Picardie	02	5	16	469	Marly-Gomont	414	12	426
22	Picardie	02	5	02	470	Martigny	452	9	461
22	Picardie	02	2	12	471	Martigny-Courpierre	118	4	122
22	Picardie	02	2	30	472	Mauregny-en-Haye	434	11	445
22	Picardie	02	2	14	473	Mayot	171	1	172
22	Picardie	02	2	42	474	Mennessis	419	4	423
22	Picardie	02	2	21	475	Menneville	408	2	410
22	Picardie	02	5	37	476	Mennevret	664	6	670
22	Picardie	02	4	41	477	Mercin-et-Vaux	940	31	971
22	Picardie	02	2	01	478	Merlieux-et-Fouquerolles	273	2	275
22	Picardie	02	4	04	479	Merval	88	2	90
22	Picardie	02	2	13	480	Mesbrecourt-Richecourt	298	7	305
22	Picardie	02	3	40	481	Mesnil-Saint-Laurent	450	20	470
22	Picardie	02	2	21	482	Meurival	52	0	52
22	Picardie	02	3	20	483	Mézières-sur-Oise	542	4	546
22	Picardie	02	1	10	484	Mézy-Moulins	523	6	529
22	Picardie	02	4	41	485	Missy-aux-Bois	108	2	110
22	Picardie	02	2	30	486	Missy-lès-Pierrepont	114	0	114
22	Picardie	02	4	32	487	Missy-sur-Aisne	684	17	701
22	Picardie	02	5	37	488	Molain	147	2	149
22	Picardie	02	2	18	489	Molinchart	317	14	331
22	Picardie	02	2	01	490	Monampteuil	137	2	139
22	Picardie	02	5	27	491	Monceau-le-Neuf-et-Faucouzy	345	11	356
22	Picardie	02	2	19	493	Monceau-le-Waast	243	4	247
22	Picardie	02	2	14	492	Monceau-lès-Leups	473	5	478
22	Picardie	02	5	16	494	Monceau-sur-Oise	121	1	122
22	Picardie	02	5	17	495	Mondrepuis	1008	27	1035
22	Picardie	02	1	22	496	Monnes	118	1	119
22	Picardie	02	2	01	497	Mons-en-Laonnois	1149	20	1169
22	Picardie	02	3	25	503	Mont-d;Origny	860	9	869
22	Picardie	02	4	04	520	Mont-Notre-Dame	677	12	689
22	Picardie	02	5	02	522	Mont-Saint-Jean	80	2	82
22	Picardie	02	4	04	523	Mont-Saint-Martin	85	5	90
22	Picardie	02	1	08	524	Mont-Saint-Père	686	13	699
22	Picardie	02	2	30	498	Montaigu	732	6	738
22	Picardie	02	2	01	499	Montbavin	41	0	41
22	Picardie	02	3	03	500	Montbrehain	807	18	825
22	Picardie	02	2	38	501	Montchâlons	64	1	65
22	Picardie	02	2	26	502	Montcornet	1543	15	1558
22	Picardie	02	3	29	504	Montescourt-Lizerolles	1684	18	1702
22	Picardie	02	1	07	505	Montfaucon	181	5	186
22	Picardie	02	4	36	506	Montgobert	198	4	202
22	Picardie	02	4	24	507	Montgru-Saint-Hilaire	34	0	34
22	Picardie	02	2	12	508	Monthenault	120	2	122
22	Picardie	02	1	22	509	Monthiers	152	2	154
22	Picardie	02	1	10	510	Monthurel	150	7	157
22	Picardie	02	3	03	511	Montigny-en-Arrouaise	300	3	303
22	Picardie	02	1	22	512	Montigny-l;Allier	272	1	273
22	Picardie	02	2	19	513	Montigny-le-Franc	158	2	160
22	Picardie	02	4	35	514	Montigny-Lengrain	668	16	684
22	Picardie	02	1	10	515	Montigny-lès-Condé	79	0	79
22	Picardie	02	2	19	516	Montigny-sous-Marle	74	3	77
22	Picardie	02	2	13	517	Montigny-sur-Crécy	309	2	311
22	Picardie	02	1	10	518	Montlevon	248	10	258
22	Picardie	02	2	26	519	Montloué	157	3	160
22	Picardie	02	1	07	521	Montreuil-aux-Lions	1396	32	1428
22	Picardie	02	3	39	525	Morcourt	596	15	611
22	Picardie	02	2	26	526	Morgny-en-Thiérache	110	2	112
22	Picardie	02	4	35	527	Morsain	426	8	434
22	Picardie	02	4	35	528	Mortefontaine	239	11	250
22	Picardie	02	2	13	529	Mortiers	207	8	215
22	Picardie	02	2	12	530	Moulins	99	0	99
22	Picardie	02	2	12	531	Moussy-Verneuil	127	4	131
22	Picardie	02	3	20	532	Moÿ-de-l;Aisne	993	18	1011
22	Picardie	02	4	24	533	Muret-et-Crouttes	139	5	144
22	Picardie	02	2	21	534	Muscourt	44	0	44
22	Picardie	02	5	34	535	Nampcelles-la-Cour	137	2	139
22	Picardie	02	4	24	536	Nampteuil-sous-Muret	85	0	85
22	Picardie	02	4	32	537	Nanteuil-la-Fosse	147	3	150
22	Picardie	02	1	15	538	Nanteuil-Notre-Dame	67	1	68
22	Picardie	02	3	06	539	Nauroy	691	9	700
22	Picardie	02	1	08	540	Nesles-la-Montagne	1210	36	1246
22	Picardie	02	2	21	541	Neufchâtel-sur-Aisne	416	5	421
22	Picardie	02	2	09	542	Neuflieux	95	2	97
22	Picardie	02	1	22	543	Neuilly-Saint-Front	2175	40	2215
22	Picardie	02	5	17	544	Neuve-Maison	616	18	634
22	Picardie	02	2	19	545	La Neuville-Bosmont	183	3	186
22	Picardie	02	2	09	546	La Neuville-en-Beine	178	8	186
22	Picardie	02	5	27	547	La Neuville-Housset	63	5	68
22	Picardie	02	5	23	548	La Neuville-lès-Dorengt	385	4	389
22	Picardie	02	3	40	549	Neuville-Saint-Amand	893	11	904
22	Picardie	02	2	12	550	Neuville-sur-Ailette	96	4	100
22	Picardie	02	4	32	551	Neuville-sur-Margival	117	0	117
22	Picardie	02	3	25	552	Neuvillette	196	0	196
22	Picardie	02	2	30	553	Nizy-le-Comte	257	8	265
22	Picardie	02	1	07	555	Nogent-l;Artaud	2137	47	2184
22	Picardie	02	1	08	554	Nogentel	1019	22	1041
22	Picardie	02	2	26	556	Noircourt	90	1	91
22	Picardie	02	4	36	557	Noroy-sur-Ourcq	158	4	162
22	Picardie	02	5	23	558	Le Nouvion-en-Thiérache	2807	46	2853
22	Picardie	02	2	13	559	Nouvion-et-Catillon	535	4	539
22	Picardie	02	2	13	560	Nouvion-le-Comte	273	9	282
22	Picardie	02	2	38	561	Nouvion-le-Vineux	162	3	165
22	Picardie	02	4	35	562	Nouvron-Vingré	226	1	227
22	Picardie	02	5	16	563	Noyales	171	9	180
22	Picardie	02	4	41	564	Noyant-et-Aconin	476	17	493
22	Picardie	02	2	12	565	OEuilly	277	7	284
22	Picardie	02	2	09	566	Ognes	1174	30	1204
22	Picardie	02	5	17	567	Ohis	307	2	309
22	Picardie	02	4	36	568	Oigny-en-Valois	142	12	154
22	Picardie	02	5	37	569	Oisy	428	16	444
22	Picardie	02	3	29	570	Ollezy	166	0	166
22	Picardie	02	3	39	571	Omissy	807	116	923
22	Picardie	02	2	21	572	Orainville	492	2	494
22	Picardie	02	2	38	573	Orgeval	72	3	75
22	Picardie	02	5	17	574	Origny-en-Thiérache	1548	21	1569
22	Picardie	02	3	25	575	Origny-Sainte-Benoite	1726	17	1743
22	Picardie	02	4	35	576	Osly-Courtil	297	10	307
22	Picardie	02	4	32	577	Ostel	80	1	81
22	Picardie	02	2	12	578	Oulches-la-Vallée-Foulon	63	0	63
22	Picardie	02	4	24	579	Oulchy-la-Ville	127	3	130
22	Picardie	02	4	24	580	Oulchy-le-Château	833	16	849
22	Picardie	02	4	04	581	Paars	284	5	289
22	Picardie	02	2	12	582	Paissy	70	2	72
22	Picardie	02	2	12	583	Pancy-Courtecon	43	2	45
22	Picardie	02	5	05	584	Papleux	108	2	110
22	Picardie	02	4	24	585	Parcy-et-Tigny	249	3	252
22	Picardie	02	2	26	586	Parfondeval	155	6	161
22	Picardie	02	2	38	587	Parfondru	346	6	352
22	Picardie	02	2	12	588	Pargnan	62	0	62
22	Picardie	02	4	32	589	Pargny-Filain	234	5	239
22	Picardie	02	1	10	590	Pargny-la-Dhuys	170	7	177
22	Picardie	02	2	13	591	Pargny-les-Bois	136	7	143
22	Picardie	02	3	25	592	Parpeville	241	1	242
22	Picardie	02	4	31	593	Pasly	1021	40	1061
22	Picardie	02	1	22	594	Passy-en-Valois	164	2	166
22	Picardie	02	1	10	595	Passy-sur-Marne	152	3	155
22	Picardie	02	1	07	596	Pavant	799	13	812
22	Picardie	02	4	04	597	Perles	80	1	81
22	Picardie	02	4	35	598	Pernant	708	18	726
22	Picardie	02	5	37	784	Petit-Verly	188	1	189
22	Picardie	02	2	11	599	Pierremande	276	3	279
22	Picardie	02	2	19	600	Pierrepont	394	2	396
22	Picardie	02	2	21	601	Pignicourt	164	2	166
22	Picardie	02	2	01	602	Pinon	1811	31	1842
22	Picardie	02	3	29	604	Pithon	75	2	77
22	Picardie	02	3	25	605	Pleine-Selve	180	6	186
22	Picardie	02	4	24	606	Le Plessier-Huleu	76	4	80
22	Picardie	02	4	41	607	Ploisy	82	4	86
22	Picardie	02	5	34	608	Plomion	477	7	484
22	Picardie	02	2	38	609	Ployart-et-Vaurseine	21	0	21
22	Picardie	02	4	31	610	Pommiers	637	17	654
22	Picardie	02	4	32	612	Pont-Arcy	129	1	130
22	Picardie	02	2	11	616	Pont-Saint-Mard	185	8	193
22	Picardie	02	2	21	613	Pontavert	596	7	603
22	Picardie	02	3	33	614	Pontru	286	5	291
22	Picardie	02	3	33	615	Pontruet	339	20	359
22	Picardie	02	2	13	617	Pouilly-sur-Serre	524	50	574
22	Picardie	02	3	03	618	Prémont	757	14	771
22	Picardie	02	2	01	619	Prémontré	769	7	776
22	Picardie	02	4	04	620	Presles-et-Boves	356	7	363
22	Picardie	02	2	38	621	Presles-et-Thierny	383	19	402
22	Picardie	02	1	22	622	Priez	50	2	52
22	Picardie	02	5	34	623	Prisces	114	0	114
22	Picardie	02	5	16	624	Proisy	318	49	367
22	Picardie	02	5	16	625	Proix	147	0	147
22	Picardie	02	2	21	626	Prouvais	379	10	389
22	Picardie	02	2	21	627	Proviseux-et-Plesnoy	116	2	118
22	Picardie	02	4	36	628	Puiseux-en-Retz	217	3	220
22	Picardie	02	5	27	629	Puisieux-et-Clanlieu	296	11	307
22	Picardie	02	2	11	631	Quierzy	459	4	463
22	Picardie	02	2	11	632	Quincy-Basse	58	0	58
22	Picardie	02	4	04	633	Quincy-sous-le-Mont	66	3	69
22	Picardie	02	2	26	634	Raillimont	90	2	92
22	Picardie	02	3	03	635	Ramicourt	171	2	173
22	Picardie	02	3	25	636	Regny	209	4	213
22	Picardie	02	3	39	637	Remaucourt	319	14	333
22	Picardie	02	2	13	638	Remies	239	8	247
22	Picardie	02	3	20	639	Remigny	390	5	395
22	Picardie	02	3	25	640	Renansart	169	0	169
22	Picardie	02	2	26	641	Renneval	132	1	133
22	Picardie	02	2	26	642	Résigny	175	3	178
22	Picardie	02	4	35	643	Ressons-le-Long	755	36	791
22	Picardie	02	4	36	644	Retheuil	387	3	390
22	Picardie	02	1	10	645	Reuilly-Sauvigny	229	5	234
22	Picardie	02	4	04	646	Révillon	70	0	70
22	Picardie	02	5	37	647	Ribeauville	82	1	83
22	Picardie	02	3	25	648	Ribemont	1984	39	2023
22	Picardie	02	1	22	649	Rocourt-Saint-Martin	321	8	329
22	Picardie	02	5	05	650	Rocquigny	393	7	400
22	Picardie	02	2	14	651	Rogécourt	86	3	89
22	Picardie	02	5	34	652	Rogny	105	2	107
22	Picardie	02	1	07	653	Romeny-sur-Marne	487	9	496
22	Picardie	02	5	16	654	Romery	84	0	84
22	Picardie	02	1	15	655	Ronchères	130	5	135
22	Picardie	02	2	21	656	Roucy	404	12	416
22	Picardie	02	5	27	657	Rougeries	228	2	230
22	Picardie	02	3	33	658	Roupy	241	13	254
22	Picardie	02	3	39	659	Rouvroy	439	4	443
22	Picardie	02	2	26	660	Rouvroy-sur-Serre	44	1	45
22	Picardie	02	2	01	661	Royaucourt-et-Chailvet	198	5	203
22	Picardie	02	1	22	662	Rozet-Saint-Albin	286	10	296
22	Picardie	02	4	24	663	Rozières-sur-Crise	231	7	238
22	Picardie	02	1	10	664	Rozoy-Bellevalle	106	1	107
22	Picardie	02	2	26	666	Rozoy-sur-Serre	1025	8	1033
22	Picardie	02	4	35	667	Saconin-et-Breuil	221	15	236
22	Picardie	02	5	27	668	Sains-Richaumont	1005	22	1027
22	Picardie	02	1	10	669	Saint-Agnan	101	2	103
22	Picardie	02	5	34	670	Saint-Algis	159	7	166
22	Picardie	02	2	11	671	Saint-Aubin	322	5	327
22	Picardie	02	4	35	672	Saint-Bandry	260	4	264
22	Picardie	02	4	35	673	Saint-Christophe-à-Berry	426	3	429
22	Picardie	02	5	02	674	Saint-Clément	51	1	52
22	Picardie	02	2	30	676	Saint-Erme-Outre-et-Ramecourt	1832	40	1872
22	Picardie	02	1	10	677	Saint-Eugène	238	4	242
22	Picardie	02	1	22	679	Saint-Gengoulph	149	6	155
22	Picardie	02	2	14	680	Saint-Gobain	2337	49	2386
22	Picardie	02	5	27	681	Saint-Gobert	309	4	313
22	Picardie	02	4	04	682	Saint-Mard	118	4	122
22	Picardie	02	5	37	683	Saint-Martin-Rivière	125	1	126
22	Picardie	02	5	17	684	Saint-Michel	3535	59	3594
22	Picardie	02	2	14	685	Saint-Nicolas-aux-Bois	111	3	114
22	Picardie	02	2	11	686	Saint-Paul-aux-Bois	395	10	405
22	Picardie	02	4	35	687	Saint-Pierre-Aigle	352	13	365
22	Picardie	02	5	27	688	Saint-Pierre-lès-Franqueville	64	0	64
22	Picardie	02	2	19	689	Saint-Pierremont	62	1	63
22	Picardie	02	3	98	691	Saint-Quentin	55978	1555	57533
22	Picardie	02	4	24	693	Saint-Rémy-Blanzy	234	2	236
22	Picardie	02	3	29	694	Saint-Simon	621	10	631
22	Picardie	02	4	04	695	Saint-Thibaut	63	0	63
22	Picardie	02	2	12	696	Saint-Thomas	97	4	101
22	Picardie	02	2	12	675	Sainte-Croix	139	4	143
22	Picardie	02	2	26	678	Sainte-Geneviève	77	1	78
22	Picardie	02	2	30	690	Sainte-Preuve	84	2	86
22	Picardie	02	2	38	697	Samoussy	338	15	353
22	Picardie	02	4	32	698	Sancy-les-Cheminots	112	2	114
22	Picardie	02	1	15	699	Saponay	259	5	264
22	Picardie	02	1	07	701	Saulchery	658	14	672
22	Picardie	02	3	33	702	Savy	614	17	631
22	Picardie	02	3	03	703	Seboncourt	1079	3	1082
22	Picardie	02	2	11	704	Selens	238	2	240
22	Picardie	02	2	30	705	La Selve	205	2	207
22	Picardie	02	4	41	706	Septmonts	580	27	607
22	Picardie	02	2	11	707	Septvaux	191	3	194
22	Picardie	02	3	06	708	Sequehart	227	5	232
22	Picardie	02	3	03	709	Serain	381	6	387
22	Picardie	02	3	29	710	Seraucourt-le-Grand	789	10	799
22	Picardie	02	4	04	711	Serches	313	7	320
22	Picardie	02	1	15	712	Sergy	164	4	168
22	Picardie	02	1	15	713	Seringes-et-Nesles	296	11	307
22	Picardie	02	4	04	714	Sermoise	319	9	328
22	Picardie	02	2	14	716	Servais	282	6	288
22	Picardie	02	4	04	715	Serval	44	0	44
22	Picardie	02	3	25	717	Séry-lès-Mézières	635	13	648
22	Picardie	02	1	22	718	Silly-la-Poterie	134	2	136
22	Picardie	02	2	09	719	Sinceny	2152	35	2187
22	Picardie	02	2	30	720	Sissonne	2072	100	2172
22	Picardie	02	3	25	721	Sissy	484	13	497
22	Picardie	02	4	99	722	Soissons	28646	1200	29846
22	Picardie	02	2	26	723	Soize	98	5	103
22	Picardie	02	1	22	724	Sommelans	57	2	59
22	Picardie	02	5	05	725	Sommeron	136	6	142
22	Picardie	02	3	29	726	Sommette-Eaucourt	158	2	160
22	Picardie	02	2	19	727	Sons-et-Ronchères	234	1	235
22	Picardie	02	5	05	728	Sorbais	272	5	277
22	Picardie	02	4	36	729	Soucy	88	3	91
22	Picardie	02	4	32	730	Soupir	305	3	308
22	Picardie	02	5	27	731	Le Sourd	162	7	169
22	Picardie	02	3	25	732	Surfontaine	103	0	103
22	Picardie	02	2	01	733	Suzy	307	6	313
22	Picardie	02	4	36	734	Taillefontaine	271	13	284
22	Picardie	02	4	04	735	Tannières	14	1	15
22	Picardie	02	4	35	736	Tartiers	190	0	190
22	Picardie	02	2	19	737	Tavaux-et-Pontséricourt	601	10	611
22	Picardie	02	2	42	738	Tergnier	14139	181	14320
22	Picardie	02	4	32	739	Terny-Sorny	304	7	311
22	Picardie	02	5	34	740	Thenailles	255	6	261
22	Picardie	02	3	25	741	Thenelles	568	2	570
22	Picardie	02	2	19	742	Thiernu	110	2	112
22	Picardie	02	2	26	743	Le Thuel	170	4	174
22	Picardie	02	1	22	744	Torcy-en-Valois	83	2	85
22	Picardie	02	2	19	745	Toulis-et-Attencourt	133	2	135
22	Picardie	02	2	14	746	Travecy	643	13	656
22	Picardie	02	3	33	747	Trefcon	83	0	83
22	Picardie	02	1	10	748	Trélou-sur-Marne	985	21	1006
22	Picardie	02	1	22	749	Troësnes	236	7	243
22	Picardie	02	2	11	750	Trosly-Loire	593	10	603
22	Picardie	02	2	12	751	Trucy	147	0	147
22	Picardie	02	3	29	752	Tugny-et-Pont	281	3	284
22	Picardie	02	5	37	753	Tupigny	364	3	367
22	Picardie	02	2	09	754	Ugny-le-Gay	163	2	165
22	Picardie	02	2	01	755	Urcel	549	10	559
22	Picardie	02	3	20	756	Urvillers	610	13	623
22	Picardie	02	5	16	757	Vadencourt	638	8	646
22	Picardie	02	4	32	758	Vailly-sur-Aisne	2081	40	2121
22	Picardie	02	5	34	759	La Vallée-au-Blé	347	4	351
22	Picardie	02	5	37	760	La Vallée-Mulâtre	146	1	147
22	Picardie	02	2	21	761	Variscourt	214	0	214
22	Picardie	02	2	11	762	Vassens	172	2	174
22	Picardie	02	4	04	763	Vasseny	212	7	219
22	Picardie	02	2	12	764	Vassogne	66	0	66
22	Picardie	02	2	01	765	Vaucelles-et-Beffecourt	210	6	216
22	Picardie	02	4	32	766	Vaudesson	260	2	262
22	Picardie	02	5	37	769	Vaux-Andigny	959	20	979
22	Picardie	02	3	33	772	Vaux-en-Vermandois	137	3	140
22	Picardie	02	2	01	768	Vauxaillon	490	5	495
22	Picardie	02	4	41	770	Vauxbuin	766	25	791
22	Picardie	02	4	04	771	Vauxcéré	112	0	112
22	Picardie	02	4	31	767	Vauxrezis	334	7	341
22	Picardie	02	4	04	773	Vauxtin	51	1	52
22	Picardie	02	3	33	774	Vendelles	110	6	116
22	Picardie	02	3	20	775	Vendeuil	918	22	940
22	Picardie	02	3	06	776	Vendhuile	531	14	545
22	Picardie	02	1	07	777	Vendières	153	3	156
22	Picardie	02	2	12	778	Vendresse-Beaulne	117	1	118
22	Picardie	02	5	37	779	Vénérolles	216	4	220
22	Picardie	02	4	31	780	Venizel	1356	25	1381
22	Picardie	02	1	08	781	Verdilly	436	13	449
22	Picardie	02	3	33	782	Le Verguier	224	3	227
22	Picardie	02	3	33	785	Vermand	1032	21	1053
22	Picardie	02	2	11	786	Verneuil-sous-Coucy	130	4	134
22	Picardie	02	2	13	787	Verneuil-sur-Serre	271	4	275
22	Picardie	02	2	14	788	Versigny	467	3	470
22	Picardie	02	5	34	789	Vervins	2666	160	2826
22	Picardie	02	2	19	790	Vesles-et-Caumont	234	6	240
22	Picardie	02	2	38	791	Veslud	257	5	262
22	Picardie	02	1	22	792	Veuilly-la-Poterie	138	3	141
22	Picardie	02	4	35	793	Vézaponin	131	2	133
22	Picardie	02	1	15	794	Vézilly	181	1	182
22	Picardie	02	4	35	795	Vic-sur-Aisne	1760	23	1783
22	Picardie	02	1	22	796	Vichel-Nanteuil	95	3	98
22	Picardie	02	4	04	797	Viel-Arcy	181	0	181
22	Picardie	02	1	07	798	Viels-Maisons	1052	15	1067
22	Picardie	02	4	24	799	Vierzy	440	15	455
22	Picardie	02	1	10	800	Viffort	333	4	337
22	Picardie	02	2	26	801	Vigneux-Hocquet	283	9	292
22	Picardie	02	2	26	802	La Ville-aux-Bois-lès-Dizy	180	6	186
22	Picardie	02	2	21	803	La Ville-aux-Bois-lès-Pontavert	114	3	117
22	Picardie	02	4	04	817	Ville-Savoye	58	0	58
22	Picardie	02	4	24	804	Villemontoire	210	4	214
22	Picardie	02	4	31	805	Villeneuve-Saint-Germain	2438	50	2488
22	Picardie	02	1	15	806	Villeneuve-sur-Fère	286	3	289
22	Picardie	02	2	09	807	Villequier-Aumont	631	19	650
22	Picardie	02	3	06	808	Villeret	314	3	317
22	Picardie	02	1	15	809	Villers-Agron-Aiguizy	100	3	103
22	Picardie	02	4	36	810	Villers-Cotterêts	10317	374	10691
22	Picardie	02	4	04	811	Villers-en-Prayères	122	2	124
22	Picardie	02	4	36	812	Villers-Hélon	222	1	223
22	Picardie	02	3	25	813	Villers-le-Sec	277	5	282
22	Picardie	02	5	16	814	Villers-lès-Guise	165	10	175
22	Picardie	02	3	29	815	Villers-Saint-Christophe	472	7	479
22	Picardie	02	1	15	816	Villers-sur-Fère	486	6	492
22	Picardie	02	1	07	818	Villiers-Saint-Denis	1051	22	1073
22	Picardie	02	2	26	819	Vincy-Reuil-et-Magny	123	2	125
22	Picardie	02	2	09	820	Viry-Noureuil	1829	46	1875
22	Picardie	02	2	18	821	Vivaise	768	15	783
22	Picardie	02	4	36	822	Vivières	400	9	409
22	Picardie	02	5	27	823	Voharies	68	3	71
22	Picardie	02	2	38	824	Vorges	378	16	394
22	Picardie	02	5	34	826	Voulpaix	405	15	420
22	Picardie	02	2	19	827	Voyenne	288	6	294
22	Picardie	02	4	32	828	Vregny	91	0	91
22	Picardie	02	4	32	829	Vuillery	32	0	32
22	Picardie	02	5	37	830	Wassigny	973	15	988
22	Picardie	02	5	17	831	Watigny	369	14	383
22	Picardie	02	5	27	832	Wiège-Faty	231	6	237
22	Picardie	02	5	17	833	Wimy	468	8	476
22	Picardie	02	2	01	834	Wissignicourt	150	4	154
83	Auvergne	03	3	35	001	Abrest	2732	75	2807
83	Auvergne	03	2	27	002	Agonges	342	15	357
83	Auvergne	03	1	02	003	Ainay-le-Château	1050	15	1065
83	Auvergne	03	3	15	004	Andelaroche	277	7	284
83	Auvergne	03	1	13	005	Archignat	353	8	361
83	Auvergne	03	3	15	006	Arfeuilles	677	5	682
83	Auvergne	03	1	17	007	Arpheuilles-Saint-Priest	343	9	352
83	Auvergne	03	3	18	008	Arronnes	361	6	367
83	Auvergne	03	2	24	009	Aubigny	138	57	195
83	Auvergne	03	1	12	010	Audes	452	8	460
83	Auvergne	03	2	33	011	Aurouër	370	11	381
83	Auvergne	03	2	27	012	Autry-Issards	356	16	372
83	Auvergne	03	2	24	013	Avermes	3808	159	3967
83	Auvergne	03	3	08	014	Avrilly	153	7	160
83	Auvergne	03	2	24	015	Bagneux	311	9	320
83	Auvergne	03	2	03	016	Barberier	131	2	133
83	Auvergne	03	3	15	017	Barrais-Bussolles	213	11	224
83	Auvergne	03	2	26	018	Bayet	677	10	687
83	Auvergne	03	2	04	019	Beaulon	1622	21	1643
83	Auvergne	03	1	22	020	Beaune-d;Allier	285	11	296
83	Auvergne	03	3	11	021	Bègues	230	7	237
83	Auvergne	03	1	09	022	Bellenaves	1015	22	1037
83	Auvergne	03	3	10	023	Bellerive-sur-Allier	8546	381	8927
83	Auvergne	03	3	14	024	Bert	267	3	270
83	Auvergne	03	2	25	025	Bessay-sur-Allier	1388	39	1427
83	Auvergne	03	2	27	026	Besson	792	29	821
83	Auvergne	03	1	22	027	Bézenet	987	21	1008
83	Auvergne	03	3	15	028	Billezois	392	8	400
83	Auvergne	03	3	28	029	Billy	837	22	859
83	Auvergne	03	3	11	030	Biozat	744	18	762
83	Auvergne	03	1	12	031	Bizeneuille	283	7	290
83	Auvergne	03	1	22	032	Blomard	207	8	215
83	Auvergne	03	3	06	033	Bost	192	2	194
83	Auvergne	03	3	28	034	Boucé	560	8	568
83	Auvergne	03	3	08	035	Le Bouchaud	208	5	213
83	Auvergne	03	2	01	036	Bourbon-l;Archambault	2571	51	2622
83	Auvergne	03	1	02	037	Braize	288	4	292
83	Auvergne	03	2	26	038	Bransat	503	22	525
83	Auvergne	03	2	27	039	Bresnay	395	9	404
83	Auvergne	03	2	23	040	Bressolles	1026	42	1068
83	Auvergne	03	1	12	041	Le Brethon	342	10	352
83	Auvergne	03	3	15	042	Le Breuil	542	13	555
83	Auvergne	03	3	10	043	Broût-Vernet	1182	77	1259
83	Auvergne	03	3	10	044	Brugheas	1352	60	1412
83	Auvergne	03	3	35	045	Busset	829	22	851
83	Auvergne	03	2	01	046	Buxières-les-Mines	1076	28	1104
83	Auvergne	03	1	17	047	La Celle	416	6	422
83	Auvergne	03	1	02	048	Cérilly	1351	25	1376
83	Auvergne	03	2	26	049	Cesset	378	8	386
83	Auvergne	03	3	18	050	La Chabanne	189	0	189
83	Auvergne	03	1	13	051	Chambérat	311	7	318
83	Auvergne	03	1	20	052	Chamblet	1073	15	1088
83	Auvergne	03	2	03	053	Chantelle	1072	30	1102
83	Auvergne	03	2	25	054	Chapeau	224	2	226
83	Auvergne	03	1	13	055	La Chapelaude	981	16	997
83	Auvergne	03	3	35	056	La Chapelle	382	12	394
83	Auvergne	03	2	04	057	La Chapelle-aux-Chasses	213	3	216
83	Auvergne	03	1	22	058	Chappes	193	7	200
83	Auvergne	03	2	03	059	Chareil-Cintrat	348	9	357
83	Auvergne	03	3	10	060	Charmeil	746	23	769
83	Auvergne	03	3	11	061	Charmes	369	2	371
83	Auvergne	03	2	03	062	Charroux	386	13	399
83	Auvergne	03	3	08	063	Chassenard	961	27	988
83	Auvergne	03	2	16	064	Château-sur-Allier	175	5	180
83	Auvergne	03	2	19	065	Châtel-de-Neuvre	549	10	559
83	Auvergne	03	3	18	066	Châtel-Montagne	412	5	417
83	Auvergne	03	3	14	067	Châtelperron	149	5	154
83	Auvergne	03	3	15	068	Châtelus	131	1	132
83	Auvergne	03	2	19	069	Châtillon	322	4	326
83	Auvergne	03	1	22	070	Chavenon	137	5	142
83	Auvergne	03	3	14	071	Chavroches	277	1	278
83	Auvergne	03	1	13	072	Chazemais	482	11	493
83	Auvergne	03	2	27	073	Chemilly	633	15	648
83	Auvergne	03	2	04	074	Chevagnes	701	16	717
83	Auvergne	03	2	03	075	Chezelle	161	3	164
83	Auvergne	03	2	04	076	Chézy	212	4	216
83	Auvergne	03	1	09	077	Chirat-l;Église	137	2	139
83	Auvergne	03	1	09	078	Chouvigny	235	8	243
83	Auvergne	03	3	14	079	Cindré	322	10	332
83	Auvergne	03	3	10	080	Cognat-Lyonne	655	14	669
83	Auvergne	03	1	05	081	Colombier	316	8	324
83	Auvergne	03	1	05	082	Commentry	6651	218	6869
83	Auvergne	03	2	26	083	Contigny	611	17	628
83	Auvergne	03	1	12	084	Cosne-d;Allier	2213	53	2266
83	Auvergne	03	2	24	085	Coulandon	702	81	783
83	Auvergne	03	2	07	086	Coulanges	305	6	311
83	Auvergne	03	2	16	087	Couleuvre	581	12	593
83	Auvergne	03	1	13	088	Courçais	322	11	333
83	Auvergne	03	1	09	089	Coutansouze	131	1	132
83	Auvergne	03	2	16	090	Couzon	298	11	309
83	Auvergne	03	3	28	091	Créchy	487	7	494
83	Auvergne	03	2	19	092	Cressanges	670	15	685
83	Auvergne	03	3	06	093	Creuzier-le-Neuf	1033	27	1060
83	Auvergne	03	3	06	094	Creuzier-le-Vieux	3333	137	3470
83	Auvergne	03	3	96	095	Cusset	13370	503	13873
83	Auvergne	03	2	03	096	Deneuille-lès-Chantelle	91	1	92
83	Auvergne	03	1	20	097	Deneuille-les-Mines	347	2	349
83	Auvergne	03	1	20	098	Désertines	4348	100	4448
83	Auvergne	03	2	19	099	Deux-Chaises	413	10	423
83	Auvergne	03	2	07	100	Diou	1502	29	1531
83	Auvergne	03	1	34	101	Domérat	8990	185	9175
83	Auvergne	03	2	07	102	Dompierre-sur-Besbre	3152	80	3232
83	Auvergne	03	3	08	103	Le Donjon	1080	21	1101
83	Auvergne	03	1	22	104	Doyet	1218	23	1241
83	Auvergne	03	3	15	105	Droiturier	357	10	367
83	Auvergne	03	1	17	106	Durdat-Larequille	1286	102	1388
83	Auvergne	03	1	09	107	Ébreuil	1277	23	1300
83	Auvergne	03	1	09	108	Échassières	404	4	408
83	Auvergne	03	3	10	109	Escurolles	729	27	756
83	Auvergne	03	3	10	110	Espinasse-Vozelle	905	17	922
83	Auvergne	03	1	12	111	Estivareilles	1124	37	1161
83	Auvergne	03	2	03	112	Étroussat	718	14	732
83	Auvergne	03	3	18	113	Ferrières-sur-Sichon	560	7	567
83	Auvergne	03	2	25	114	La Ferté-Hauterive	298	8	306
83	Auvergne	03	2	03	115	Fleuriel	348	8	356
83	Auvergne	03	2	03	116	Fourilles	213	5	218
83	Auvergne	03	2	01	117	Franchesse	446	10	456
83	Auvergne	03	3	11	118	Gannat	5806	225	6031
83	Auvergne	03	2	04	119	Gannay-sur-Loire	415	7	422
83	Auvergne	03	2	04	120	Garnat-sur-Engièvre	718	11	729
83	Auvergne	03	2	33	121	Gennetines	669	12	681
83	Auvergne	03	2	27	122	Gipcy	224	7	231
83	Auvergne	03	1	12	123	Givarlais	244	7	251
83	Auvergne	03	2	25	124	Gouise	233	5	238
83	Auvergne	03	3	18	125	La Guillermie	143	3	146
83	Auvergne	03	3	10	126	Hauterive	1135	18	1153
83	Auvergne	03	1	12	127	Hérisson	648	20	668
83	Auvergne	03	1	13	128	Huriel	2556	51	2607
83	Auvergne	03	1	05	129	Hyds	317	9	326
83	Auvergne	03	1	02	130	Isle-et-Bardais	272	5	277
83	Auvergne	03	3	15	131	Isserpent	503	26	529
83	Auvergne	03	3	14	132	Jaligny-sur-Besbre	618	19	637
83	Auvergne	03	3	11	133	Jenzat	517	19	536
83	Auvergne	03	2	26	134	Laféline	191	11	202
83	Auvergne	03	1	09	135	Lalizolle	376	9	385
83	Auvergne	03	1	21	136	Lamaids	175	2	177
83	Auvergne	03	3	28	137	Langy	239	3	242
83	Auvergne	03	3	15	138	Lapalisse	3150	135	3285
83	Auvergne	03	3	18	139	Laprugne	362	9	371
83	Auvergne	03	1	32	140	Lavault-Sainte-Anne	1200	51	1251
83	Auvergne	03	3	18	141	Lavoine	153	5	158
83	Auvergne	03	3	08	142	Lenax	242	2	244
83	Auvergne	03	1	02	143	Lételon	120	3	123
83	Auvergne	03	3	14	144	Liernolles	246	9	255
83	Auvergne	03	1	32	145	Lignerolles	697	11	708
83	Auvergne	03	2	16	146	Limoise	179	93	272
83	Auvergne	03	3	08	147	Loddes	146	5	151
83	Auvergne	03	2	26	148	Loriges	342	5	347
83	Auvergne	03	2	26	149	Louchy-Montfand	442	26	468
83	Auvergne	03	1	12	150	Louroux-Bourbonnais	238	6	244
83	Auvergne	03	1	22	151	Louroux-de-Beaune	182	3	185
83	Auvergne	03	1	09	152	Louroux-de-Bouble	280	3	283
83	Auvergne	03	1	12	153	Louroux-Hodement	346	10	356
83	Auvergne	03	3	08	154	Luneau	287	7	294
83	Auvergne	03	2	16	155	Lurcy-Lévis	2147	29	2176
83	Auvergne	03	2	04	156	Lusigny	1665	45	1710
83	Auvergne	03	3	28	157	Magnet	860	18	878
83	Auvergne	03	1	12	158	Maillet	368	1	369
83	Auvergne	03	1	05	159	Malicorne	830	16	846
83	Auvergne	03	2	26	160	Marcenat	375	13	388
83	Auvergne	03	1	17	161	Marcillat-en-Combraille	901	22	923
83	Auvergne	03	2	27	162	Marigny	189	7	196
83	Auvergne	03	3	35	163	Mariol	762	10	772
83	Auvergne	03	3	11	164	Le Mayet-d;École	272	3	275
83	Auvergne	03	3	18	165	Le Mayet-de-Montagne	1573	144	1717
83	Auvergne	03	3	11	166	Mazerier	287	5	292
83	Auvergne	03	1	17	167	Mazirat	287	6	293
83	Auvergne	03	1	02	168	Meaulne	763	17	780
83	Auvergne	03	2	19	169	Meillard	279	10	289
83	Auvergne	03	2	27	170	Meillers	151	3	154
83	Auvergne	03	2	25	171	Mercy	262	7	269
83	Auvergne	03	1	13	172	Mesples	132	3	135
83	Auvergne	03	2	07	173	Molinet	1160	20	1180
83	Auvergne	03	3	35	174	Molles	819	26	845
83	Auvergne	03	2	03	175	Monestier	266	3	269
83	Auvergne	03	2	26	176	Monétay-sur-Allier	549	21	570
83	Auvergne	03	2	07	177	Monétay-sur-Loire	285	9	294
83	Auvergne	03	3	28	179	Montaigu-le-Blin	308	8	316
83	Auvergne	03	3	08	178	Montaiguët-en-Forez	320	5	325
83	Auvergne	03	2	25	180	Montbeugny	681	14	695
83	Auvergne	03	3	08	181	Montcombroux-les-Mines	371	7	378
83	Auvergne	03	3	11	182	Monteignet-sur-l;Andelot	238	3	241
83	Auvergne	03	2	19	183	Le Montet	514	9	523
83	Auvergne	03	2	24	184	Montilly	553	7	560
83	Auvergne	03	1	98	185	Montluçon	38402	1310	39712
83	Auvergne	03	1	22	186	Montmarault	1530	36	1566
83	Auvergne	03	3	28	187	Montoldre	641	8	649
83	Auvergne	03	2	26	188	Montord	233	6	239
83	Auvergne	03	1	22	189	Montvicq	743	8	751
83	Auvergne	03	2	99	190	Moulins	19590	639	20229
83	Auvergne	03	1	22	191	Murat	291	3	294
83	Auvergne	03	1	09	192	Nades	129	1	130
83	Auvergne	03	1	12	193	Nassigny	195	1	196
83	Auvergne	03	1	09	194	Naves	120	2	122
83	Auvergne	03	1	32	195	Néris-les-Bains	2667	114	2781
83	Auvergne	03	3	08	196	Neuilly-en-Donjon	224	6	230
83	Auvergne	03	2	25	197	Neuilly-le-Réal	1434	33	1467
83	Auvergne	03	2	16	198	Neure	171	1	172
83	Auvergne	03	2	24	200	Neuvy	1510	172	1682
83	Auvergne	03	3	18	201	Nizerolles	333	7	340
83	Auvergne	03	2	27	202	Noyant-d;Allier	687	12	699
83	Auvergne	03	2	04	203	Paray-le-Frésil	418	4	422
83	Auvergne	03	2	26	204	Paray-sous-Briailles	641	16	657
83	Auvergne	03	3	15	205	Périgny	461	5	466
83	Auvergne	03	1	17	206	La Petite-Marche	185	3	188
83	Auvergne	03	2	07	207	Pierrefitte-sur-Loire	513	7	520
83	Auvergne	03	3	08	208	Le Pin	393	8	401
83	Auvergne	03	3	11	209	Poëzat	123	1	124
83	Auvergne	03	2	16	210	Pouzy-Mésangy	415	13	428
83	Auvergne	03	1	21	211	Prémilhat	2315	69	2384
83	Auvergne	03	1	21	212	Quinssaines	1360	29	1389
83	Auvergne	03	1	12	213	Reugny	264	3	267
83	Auvergne	03	2	19	214	Rocles	377	3	380
83	Auvergne	03	3	28	215	Rongères	582	13	595
83	Auvergne	03	1	17	216	Ronnet	185	8	193
83	Auvergne	03	1	20	217	Saint-Angel	755	42	797
83	Auvergne	03	2	01	218	Saint-Aubin-le-Monial	284	10	294
83	Auvergne	03	1	22	219	Saint-Bonnet-de-Four	199	6	205
83	Auvergne	03	3	11	220	Saint-Bonnet-de-Rochefort	640	11	651
83	Auvergne	03	1	02	221	Saint-Bonnet-Tronçais	742	8	750
83	Auvergne	03	1	12	222	Saint-Caprais	92	5	97
83	Auvergne	03	3	15	223	Saint-Christophe	494	6	500
83	Auvergne	03	3	18	224	Saint-Clément	363	7	370
83	Auvergne	03	1	13	225	Saint-Désiré	470	15	485
83	Auvergne	03	3	08	226	Saint-Didier-en-Donjon	268	9	277
83	Auvergne	03	3	10	227	Saint-Didier-la-Forêt	380	14	394
83	Auvergne	03	1	13	228	Saint-Éloy-d;Allier	55	1	56
83	Auvergne	03	2	33	229	Saint-Ennemond	654	11	665
83	Auvergne	03	3	15	230	Saint-Étienne-de-Vicq	513	9	522
83	Auvergne	03	1	17	231	Saint-Fargeol	206	5	211
83	Auvergne	03	3	28	232	Saint-Félix	347	5	352
83	Auvergne	03	1	17	233	Saint-Genest	342	11	353
83	Auvergne	03	2	25	234	Saint-Gérand-de-Vaux	417	11	428
83	Auvergne	03	3	28	235	Saint-Gérand-le-Puy	996	16	1012
83	Auvergne	03	2	03	237	Saint-Germain-de-Salles	442	3	445
83	Auvergne	03	3	28	236	Saint-Germain-des-Fossés	3658	69	3727
83	Auvergne	03	2	01	238	Saint-Hilaire	500	5	505
83	Auvergne	03	3	08	239	Saint-Léger-sur-Vouzance	281	6	287
83	Auvergne	03	3	14	240	Saint-Léon	602	7	609
83	Auvergne	03	2	16	241	Saint-Léopardin-d;Augy	365	28	393
83	Auvergne	03	3	28	242	Saint-Loup	570	15	585
83	Auvergne	03	1	17	244	Saint-Marcel-en-Marcillat	150	6	156
83	Auvergne	03	1	22	243	Saint-Marcel-en-Murat	139	7	146
83	Auvergne	03	2	04	245	Saint-Martin-des-Lais	145	4	149
83	Auvergne	03	1	13	246	Saint-Martinien	622	18	640
83	Auvergne	03	2	27	247	Saint-Menoux	1021	31	1052
83	Auvergne	03	3	18	248	Saint-Nicolas-des-Biefs	181	2	183
83	Auvergne	03	1	13	249	Saint-Palais	190	3	193
83	Auvergne	03	3	15	250	Saint-Pierre-Laval	369	5	374
83	Auvergne	03	2	01	251	Saint-Plaisir	403	8	411
83	Auvergne	03	3	10	252	Saint-Pont	578	13	591
83	Auvergne	03	2	07	253	Saint-Pourçain-sur-Besbre	411	5	416
83	Auvergne	03	2	26	254	Saint-Pourçain-sur-Sioule	4987	151	5138
83	Auvergne	03	3	11	255	Saint-Priest-d;Andelot	140	5	145
83	Auvergne	03	1	22	256	Saint-Priest-en-Murat	222	12	234
83	Auvergne	03	3	15	257	Saint-Prix	797	16	813
83	Auvergne	03	3	10	258	Saint-Rémy-en-Rollat	1619	50	1669
83	Auvergne	03	1	13	259	Saint-Sauvier	340	4	344
83	Auvergne	03	2	19	260	Saint-Sornin	230	3	233
83	Auvergne	03	1	31	262	Saint-Victor	2032	57	2089
83	Auvergne	03	2	25	263	Saint-Voir	197	9	206
83	Auvergne	03	3	35	264	Saint-Yorre	2757	66	2823
83	Auvergne	03	1	17	261	Sainte-Thérence	202	4	206
83	Auvergne	03	2	07	265	Saligny-sur-Roudon	777	93	870
83	Auvergne	03	3	28	266	Sanssat	253	2	255
83	Auvergne	03	2	26	267	Saulcet	644	24	668
83	Auvergne	03	3	11	268	Saulzet	349	6	355
83	Auvergne	03	1	12	269	Sauvagny	94	4	98
83	Auvergne	03	1	22	270	Sazeret	160	5	165
83	Auvergne	03	3	10	271	Serbannes	743	22	765
83	Auvergne	03	3	15	272	Servilly	275	4	279
83	Auvergne	03	3	28	273	Seuillet	494	12	506
83	Auvergne	03	3	14	274	Sorbier	292	9	301
83	Auvergne	03	2	27	275	Souvigny	1989	70	2059
83	Auvergne	03	1	09	276	Sussat	98	1	99
83	Auvergne	03	2	03	277	Target	267	13	280
83	Auvergne	03	2	03	278	Taxat-Senat	223	6	229
83	Auvergne	03	1	32	279	Teillet-Argenty	542	12	554
83	Auvergne	03	1	17	280	Terjat	207	2	209
83	Auvergne	03	2	19	281	Le Theil	411	13	424
83	Auvergne	03	1	02	282	Theneuille	388	18	406
83	Auvergne	03	2	04	283	Thiel-sur-Acolin	1001	22	1023
83	Auvergne	03	3	14	284	Thionne	326	10	336
83	Auvergne	03	1	12	285	Tortezais	177	6	183
83	Auvergne	03	2	23	286	Toulon-sur-Allier	1137	20	1157
83	Auvergne	03	2	19	287	Treban	394	9	403
83	Auvergne	03	1	13	288	Treignat	447	18	465
83	Auvergne	03	3	14	289	Treteau	558	11	569
83	Auvergne	03	2	33	290	Trévol	1635	64	1699
83	Auvergne	03	3	14	291	Trézelles	387	11	398
83	Auvergne	03	2	19	292	Tronget	926	27	953
83	Auvergne	03	1	02	293	Urçay	295	9	304
83	Auvergne	03	2	03	294	Ussel-d;Allier	145	6	151
83	Auvergne	03	1	09	295	Valignat	75	0	75
83	Auvergne	03	1	02	296	Valigny	388	6	394
83	Auvergne	03	1	12	297	Vallon-en-Sully	1674	26	1700
83	Auvergne	03	3	28	298	Varennes-sur-Allier	3600	71	3671
83	Auvergne	03	3	14	299	Varennes-sur-Tèche	254	3	257
83	Auvergne	03	2	07	300	Vaumas	549	16	565
83	Auvergne	03	1	31	301	Vaux	1057	31	1088
83	Auvergne	03	1	09	302	Veauce	40	0	40
83	Auvergne	03	1	12	303	Venas	238	2	240
83	Auvergne	03	3	10	304	Vendat	2227	51	2278
83	Auvergne	03	1	20	305	Verneix	601	8	609
83	Auvergne	03	3	35	306	Le Vernet	1909	65	1974
83	Auvergne	03	2	26	307	Verneuil-en-Bourbonnais	238	8	246
83	Auvergne	03	1	22	308	Vernusse	171	5	176
83	Auvergne	03	2	16	309	Le Veurdre	516	42	558
83	Auvergne	03	3	97	310	Vichy	24774	461	25235
83	Auvergne	03	1	09	311	Vicq	328	5	333
83	Auvergne	03	2	01	312	Vieure	267	5	272
83	Auvergne	03	1	02	313	Le Vilhain	265	14	279
83	Auvergne	03	1	17	314	Villebret	1276	47	1323
83	Auvergne	03	1	22	315	Villefranche-d;Allier	1331	60	1391
83	Auvergne	03	2	33	316	Villeneuve-sur-Allier	985	22	1007
83	Auvergne	03	1	13	317	Viplaix	291	8	299
83	Auvergne	03	1	02	318	Vitray	115	2	117
83	Auvergne	03	2	03	319	Voussac	464	6	470
83	Auvergne	03	2	01	320	Ygrande	773	20	793
83	Auvergne	03	2	33	321	Yzeure	13074	471	13545
93	Provence-Alpes-Côte d;Azur	04	3	31	001	Aiglun	1276	29	1305
93	Provence-Alpes-Côte d;Azur	04	3	21	004	Allemagne-en-Provence	514	9	523
93	Provence-Alpes-Côte d;Azur	04	2	22	005	Allons	135	1	136
93	Provence-Alpes-Côte d;Azur	04	2	07	006	Allos	691	11	702
93	Provence-Alpes-Côte d;Azur	04	2	22	007	Angles	71	0	71
93	Provence-Alpes-Côte d;Azur	04	2	02	008	Annot	1058	42	1100
93	Provence-Alpes-Côte d;Azur	04	3	11	009	Archail	17	0	17
93	Provence-Alpes-Côte d;Azur	04	4	20	012	Aubenas-les-Alpes	105	0	105
93	Provence-Alpes-Côte d;Azur	04	4	30	013	Aubignosc	553	14	567
93	Provence-Alpes-Côte d;Azur	04	4	27	016	Authon	45	2	47
93	Provence-Alpes-Côte d;Azur	04	3	26	017	Auzet	79	3	82
93	Provence-Alpes-Côte d;Azur	04	4	03	018	Banon	1070	30	1100
93	Provence-Alpes-Côte d;Azur	04	1	04	019	Barcelonnette	2700	183	2883
93	Provence-Alpes-Côte d;Azur	04	3	26	020	Barles	156	4	160
93	Provence-Alpes-Côte d;Azur	04	3	31	021	Barras	158	4	162
93	Provence-Alpes-Côte d;Azur	04	3	05	022	Barrême	474	5	479
93	Provence-Alpes-Côte d;Azur	04	4	28	023	Bayons	255	8	263
93	Provence-Alpes-Côte d;Azur	04	3	11	024	Beaujeu	150	2	152
93	Provence-Alpes-Côte d;Azur	04	2	07	025	Beauvezer	336	5	341
93	Provence-Alpes-Côte d;Azur	04	4	28	026	Bellaffaire	143	3	146
93	Provence-Alpes-Côte d;Azur	04	4	18	027	Bevons	202	53	255
93	Provence-Alpes-Côte d;Azur	04	3	15	028	Beynes	123	2	125
93	Provence-Alpes-Côte d;Azur	04	3	05	030	Blieux	55	1	56
93	Provence-Alpes-Côte d;Azur	04	3	15	031	Bras-d;Asse	531	4	535
93	Provence-Alpes-Côte d;Azur	04	2	02	032	Braux	131	2	133
93	Provence-Alpes-Côte d;Azur	04	1	12	033	La Bréole	409	6	415
93	Provence-Alpes-Côte d;Azur	04	4	19	034	La Brillanne	943	21	964
93	Provence-Alpes-Côte d;Azur	04	3	29	035	Brunet	256	2	258
93	Provence-Alpes-Côte d;Azur	04	3	11	036	Le Brusquet	968	38	1006
93	Provence-Alpes-Côte d;Azur	04	4	16	037	Le Caire	66	2	68
93	Provence-Alpes-Côte d;Azur	04	2	06	039	Castellane	1537	54	1591
93	Provence-Alpes-Côte d;Azur	04	3	31	040	Le Castellard-Mélan	50	4	54
93	Provence-Alpes-Côte d;Azur	04	3	14	041	Le Castellet	278	7	285
93	Provence-Alpes-Côte d;Azur	04	2	09	042	Castellet-lès-Sausses	109	3	112
93	Provence-Alpes-Côte d;Azur	04	4	20	045	Céreste	1264	20	1284
93	Provence-Alpes-Côte d;Azur	04	3	31	046	Le Chaffaut-Saint-Jurson	741	119	860
93	Provence-Alpes-Côte d;Azur	04	3	31	047	Champtercier	794	42	836
93	Provence-Alpes-Côte d;Azur	04	4	30	049	Château-Arnoux-Saint-Auban	5266	123	5389
93	Provence-Alpes-Côte d;Azur	04	4	16	050	Châteaufort	23	1	24
93	Provence-Alpes-Côte d;Azur	04	4	18	051	Châteauneuf-Miravail	77	2	79
93	Provence-Alpes-Côte d;Azur	04	4	30	053	Châteauneuf-Val-Saint-Donat	503	17	520
93	Provence-Alpes-Côte d;Azur	04	3	15	054	Châteauredon	93	0	93
93	Provence-Alpes-Côte d;Azur	04	3	05	055	Chaudon-Norante	156	1	157
93	Provence-Alpes-Côte d;Azur	04	4	16	057	Clamensane	172	6	178
93	Provence-Alpes-Côte d;Azur	04	4	16	058	Claret	240	13	253
93	Provence-Alpes-Côte d;Azur	04	3	05	059	Clumanc	182	3	185
93	Provence-Alpes-Côte d;Azur	04	2	07	061	Colmars	388	2	390
93	Provence-Alpes-Côte d;Azur	04	1	04	062	La Condamine-Châtelard	173	2	175
93	Provence-Alpes-Côte d;Azur	04	4	32	063	Corbières	987	16	1003
93	Provence-Alpes-Côte d;Azur	04	4	23	065	Cruis	615	15	630
93	Provence-Alpes-Côte d;Azur	04	4	16	066	Curbans	442	11	453
93	Provence-Alpes-Côte d;Azur	04	4	18	067	Curel	47	4	51
93	Provence-Alpes-Côte d;Azur	04	4	10	068	Dauphin	796	18	814
93	Provence-Alpes-Côte d;Azur	04	2	06	069	Demandolx	122	0	122
93	Provence-Alpes-Côte d;Azur	04	3	97	070	Digne-les-Bains	16922	1047	17969
93	Provence-Alpes-Côte d;Azur	04	3	11	072	Draix	80	5	85
93	Provence-Alpes-Côte d;Azur	04	1	04	073	Enchastrayes	420	18	438
93	Provence-Alpes-Côte d;Azur	04	3	08	074	Entrages	116	2	118
93	Provence-Alpes-Côte d;Azur	04	4	27	075	Entrepierres	390	19	409
93	Provence-Alpes-Côte d;Azur	04	2	09	076	Entrevaux	947	10	957
93	Provence-Alpes-Côte d;Azur	04	3	14	077	Entrevennes	168	4	172
93	Provence-Alpes-Côte d;Azur	04	4	30	079	L; Escale	1311	28	1339
93	Provence-Alpes-Côte d;Azur	04	3	21	081	Esparron-de-Verdon	429	8	437
93	Provence-Alpes-Côte d;Azur	04	3	15	084	Estoublon	466	5	471
93	Provence-Alpes-Côte d;Azur	04	1	04	086	Faucon-de-Barcelonnette	303	16	319
93	Provence-Alpes-Côte d;Azur	04	4	28	085	Faucon-du-Caire	57	1	58
93	Provence-Alpes-Côte d;Azur	04	4	23	087	Fontienne	132	2	134
93	Provence-Alpes-Côte d;Azur	04	4	10	088	Forcalquier	4680	81	4761
93	Provence-Alpes-Côte d;Azur	04	2	02	090	Le Fugeret	232	2	234
93	Provence-Alpes-Côte d;Azur	04	4	19	091	Ganagobie	102	1	103
93	Provence-Alpes-Côte d;Azur	04	2	06	092	La Garde	90	0	90
93	Provence-Alpes-Côte d;Azur	04	4	28	093	Gigors	61	1	62
93	Provence-Alpes-Côte d;Azur	04	3	29	094	Gréoux-les-Bains	2545	49	2594
93	Provence-Alpes-Côte d;Azur	04	3	31	177	Hautes-Duyes	35	0	35
93	Provence-Alpes-Côte d;Azur	04	4	03	095	L; Hospitalet	89	4	93
93	Provence-Alpes-Côte d;Azur	04	1	04	096	Jausiers	1115	48	1163
93	Provence-Alpes-Côte d;Azur	04	3	11	097	La Javie	392	9	401
93	Provence-Alpes-Côte d;Azur	04	2	22	099	Lambruisse	90	0	90
93	Provence-Alpes-Côte d;Azur	04	1	04	100	Larche	74	2	76
93	Provence-Alpes-Côte d;Azur	04	4	23	101	Lardiers	114	2	116
93	Provence-Alpes-Côte d;Azur	04	1	12	102	Le Lauzet-Ubaye	231	8	239
93	Provence-Alpes-Côte d;Azur	04	4	10	104	Limans	337	5	342
93	Provence-Alpes-Côte d;Azur	04	4	19	106	Lurs	375	4	379
93	Provence-Alpes-Côte d;Azur	04	3	15	107	Majastres	2	0	2
93	Provence-Alpes-Côte d;Azur	04	3	14	108	Malijai	1960	42	2002
93	Provence-Alpes-Côte d;Azur	04	4	23	109	Mallefougasse-Augès	239	9	248
93	Provence-Alpes-Côte d;Azur	04	3	31	110	Mallemoisson	993	32	1025
93	Provence-Alpes-Côte d;Azur	04	4	10	111	Mane	1373	21	1394
93	Provence-Alpes-Côte d;Azur	04	4	98	112	Manosque	22105	747	22852
93	Provence-Alpes-Côte d;Azur	04	3	08	113	Marcoux	517	11	528
93	Provence-Alpes-Côte d;Azur	04	2	02	115	Méailles	117	3	120
93	Provence-Alpes-Côte d;Azur	04	3	14	116	Les Mées	3630	51	3681
93	Provence-Alpes-Côte d;Azur	04	4	16	118	Melve	103	2	105
93	Provence-Alpes-Côte d;Azur	04	1	12	161	Méolans-Revel	336	12	348
93	Provence-Alpes-Côte d;Azur	04	1	04	120	Meyronnes	72	2	74
93	Provence-Alpes-Côte d;Azur	04	3	15	121	Mézel	700	15	715
93	Provence-Alpes-Côte d;Azur	04	3	31	122	Mirabeau	494	4	498
93	Provence-Alpes-Côte d;Azur	04	4	27	123	Mison	1005	37	1042
93	Provence-Alpes-Côte d;Azur	04	3	21	124	Montagnac-Montpezat	421	8	429
93	Provence-Alpes-Côte d;Azur	04	3	26	126	Montclar	461	14	475
93	Provence-Alpes-Côte d;Azur	04	4	30	127	Montfort	377	2	379
93	Provence-Alpes-Côte d;Azur	04	4	33	128	Montfuron	196	1	197
93	Provence-Alpes-Côte d;Azur	04	4	20	129	Montjustin	48	1	49
93	Provence-Alpes-Côte d;Azur	04	4	23	130	Montlaux	137	2	139
93	Provence-Alpes-Côte d;Azur	04	4	03	132	Montsalier	109	4	113
93	Provence-Alpes-Côte d;Azur	04	2	22	133	Moriez	194	6	200
93	Provence-Alpes-Côte d;Azur	04	4	16	134	La Motte-du-Caire	525	9	534
93	Provence-Alpes-Côte d;Azur	04	3	17	135	Moustiers-Sainte-Marie	706	20	726
93	Provence-Alpes-Côte d;Azur	04	2	22	136	La Mure-Argens	327	3	330
93	Provence-Alpes-Côte d;Azur	04	4	16	137	Nibles	44	2	46
93	Provence-Alpes-Côte d;Azur	04	4	10	138	Niozelles	248	7	255
93	Provence-Alpes-Côte d;Azur	04	4	18	139	Noyers-sur-Jabron	464	19	483
93	Provence-Alpes-Côte d;Azur	04	4	18	140	Les Omergues	126	2	128
93	Provence-Alpes-Côte d;Azur	04	4	23	141	Ongles	344	14	358
93	Provence-Alpes-Côte d;Azur	04	4	20	142	Oppedette	61	1	62
93	Provence-Alpes-Côte d;Azur	04	3	14	143	Oraison	5392	128	5520
93	Provence-Alpes-Côte d;Azur	04	3	17	144	La Palud-sur-Verdon	322	9	331
93	Provence-Alpes-Côte d;Azur	04	4	30	145	Peipin	1351	31	1382
93	Provence-Alpes-Côte d;Azur	04	2	06	148	Peyroules	226	6	232
93	Provence-Alpes-Côte d;Azur	04	4	19	149	Peyruis	2689	54	2743
93	Provence-Alpes-Côte d;Azur	04	4	28	150	Piégut	145	3	148
93	Provence-Alpes-Côte d;Azur	04	4	10	151	Pierrerue	532	13	545
93	Provence-Alpes-Côte d;Azur	04	4	33	152	Pierrevert	3682	154	3836
93	Provence-Alpes-Côte d;Azur	04	1	12	154	Pontis	81	6	87
93	Provence-Alpes-Côte d;Azur	04	3	11	155	Prads-Haute-Bléone	179	6	185
93	Provence-Alpes-Côte d;Azur	04	3	14	156	Puimichel	242	3	245
93	Provence-Alpes-Côte d;Azur	04	3	21	157	Puimoisson	743	17	760
93	Provence-Alpes-Côte d;Azur	04	3	21	158	Quinson	447	14	461
93	Provence-Alpes-Côte d;Azur	04	4	03	159	Redortiers	75	6	81
93	Provence-Alpes-Côte d;Azur	04	4	20	160	Reillanne	1521	36	1557
93	Provence-Alpes-Côte d;Azur	04	4	03	162	Revest-des-Brousses	258	7	265
93	Provence-Alpes-Côte d;Azur	04	4	03	163	Revest-du-Bion	578	7	585
93	Provence-Alpes-Côte d;Azur	04	4	23	164	Revest-Saint-Martin	82	2	84
93	Provence-Alpes-Côte d;Azur	04	3	21	166	Riez	1805	28	1833
93	Provence-Alpes-Côte d;Azur	04	3	08	167	La Robine-sur-Galabre	331	7	338
93	Provence-Alpes-Côte d;Azur	04	4	03	169	La Rochegiron	106	3	109
93	Provence-Alpes-Côte d;Azur	04	2	09	170	La Rochette	58	0	58
93	Provence-Alpes-Côte d;Azur	04	2	06	171	Rougon	104	1	105
93	Provence-Alpes-Côte d;Azur	04	3	21	172	Roumoules	700	17	717
93	Provence-Alpes-Côte d;Azur	04	2	22	173	Saint-André-les-Alpes	923	14	937
93	Provence-Alpes-Côte d;Azur	04	2	02	174	Saint-Benoît	127	4	131
93	Provence-Alpes-Côte d;Azur	04	4	23	178	Saint-Étienne-les-Orgues	1228	26	1254
93	Provence-Alpes-Côte d;Azur	04	4	27	179	Saint-Geniez	87	4	91
93	Provence-Alpes-Côte d;Azur	04	3	05	180	Saint-Jacques	56	1	57
93	Provence-Alpes-Côte d;Azur	04	3	15	181	Saint-Jeannet	52	3	55
93	Provence-Alpes-Côte d;Azur	04	3	15	182	Saint-Julien-d;Asse	165	4	169
93	Provence-Alpes-Côte d;Azur	04	2	06	183	Saint-Julien-du-Verdon	150	4	154
93	Provence-Alpes-Côte d;Azur	04	3	17	184	Saint-Jurs	155	2	157
93	Provence-Alpes-Côte d;Azur	04	3	21	186	Saint-Laurent-du-Verdon	92	4	96
93	Provence-Alpes-Côte d;Azur	04	3	05	187	Saint-Lions	34	1	35
93	Provence-Alpes-Côte d;Azur	04	4	10	188	Saint-Maime	833	24	857
93	Provence-Alpes-Côte d;Azur	04	3	29	189	Saint-Martin-de-Brômes	535	10	545
93	Provence-Alpes-Côte d;Azur	04	4	13	190	Saint-Martin-les-Eaux	100	3	103
93	Provence-Alpes-Côte d;Azur	04	3	26	191	Saint-Martin-lès-Seyne	18	3	21
93	Provence-Alpes-Côte d;Azur	04	4	10	192	Saint-Michel-l;Observatoire	1160	22	1182
93	Provence-Alpes-Côte d;Azur	04	1	04	193	Saint-Paul-sur-Ubaye	226	4	230
93	Provence-Alpes-Côte d;Azur	04	2	09	194	Saint-Pierre	111	4	115
93	Provence-Alpes-Côte d;Azur	04	1	04	195	Saint-Pons	762	29	791
93	Provence-Alpes-Côte d;Azur	04	1	12	198	Saint-Vincent-les-Forts	300	3	303
93	Provence-Alpes-Côte d;Azur	04	4	18	199	Saint-Vincent-sur-Jabron	218	6	224
93	Provence-Alpes-Côte d;Azur	04	4	20	175	Sainte-Croix-à-Lauze	79	0	79
93	Provence-Alpes-Côte d;Azur	04	3	21	176	Sainte-Croix-du-Verdon	123	3	126
93	Provence-Alpes-Côte d;Azur	04	4	32	197	Sainte-Tulle	3344	59	3403
93	Provence-Alpes-Côte d;Azur	04	4	30	200	Salignac	546	18	564
93	Provence-Alpes-Côte d;Azur	04	4	03	201	Saumane	108	4	112
93	Provence-Alpes-Côte d;Azur	04	2	09	202	Sausses	120	1	121
93	Provence-Alpes-Côte d;Azur	04	3	26	203	Selonnet	432	13	445
93	Provence-Alpes-Côte d;Azur	04	3	05	204	Senez	170	3	173
93	Provence-Alpes-Côte d;Azur	04	3	26	205	Seyne	1439	32	1471
93	Provence-Alpes-Côte d;Azur	04	4	10	206	Sigonce	411	12	423
93	Provence-Alpes-Côte d;Azur	04	4	16	207	Sigoyer	92	5	97
93	Provence-Alpes-Côte d;Azur	04	4	03	208	Simiane-la-Rotonde	584	11	595
93	Provence-Alpes-Côte d;Azur	04	4	27	209	Sisteron	7450	299	7749
93	Provence-Alpes-Côte d;Azur	04	2	06	210	Soleilhas	111	0	111
93	Provence-Alpes-Côte d;Azur	04	4	30	211	Sourribes	173	2	175
93	Provence-Alpes-Côte d;Azur	04	3	05	214	Tartonne	132	3	135
93	Provence-Alpes-Côte d;Azur	04	4	16	216	Thèze	218	5	223
93	Provence-Alpes-Côte d;Azur	04	3	31	217	Thoard	737	16	753
93	Provence-Alpes-Côte d;Azur	04	2	07	218	Thorame-Basse	214	11	225
93	Provence-Alpes-Côte d;Azur	04	2	07	219	Thorame-Haute	232	5	237
93	Provence-Alpes-Côte d;Azur	04	1	04	220	Les Thuiles	368	10	378
93	Provence-Alpes-Côte d;Azur	04	4	28	222	Turriers	379	11	390
93	Provence-Alpes-Côte d;Azur	04	2	02	224	Ubraye	105	3	108
93	Provence-Alpes-Côte d;Azur	04	1	04	226	Uvernet-Fours	609	24	633
93	Provence-Alpes-Côte d;Azur	04	4	20	227	Vachères	293	6	299
93	Provence-Alpes-Côte d;Azur	04	2	09	043	Val-de-Chalvagne	69	2	71
93	Provence-Alpes-Côte d;Azur	04	4	16	228	Valavoire	35	2	37
93	Provence-Alpes-Côte d;Azur	04	4	18	229	Valbelle	240	8	248
93	Provence-Alpes-Côte d;Azur	04	3	29	230	Valensole	3224	45	3269
93	Provence-Alpes-Côte d;Azur	04	4	16	231	Valernes	237	4	241
93	Provence-Alpes-Côte d;Azur	04	4	16	233	Vaumeilh	268	8	276
93	Provence-Alpes-Côte d;Azur	04	4	28	234	Venterol	248	4	252
93	Provence-Alpes-Côte d;Azur	04	3	26	235	Verdaches	57	1	58
93	Provence-Alpes-Côte d;Azur	04	2	02	236	Vergons	120	0	120
93	Provence-Alpes-Côte d;Azur	04	3	26	237	Le Vernet	121	3	124
93	Provence-Alpes-Côte d;Azur	04	2	07	240	Villars-Colmars	253	5	258
93	Provence-Alpes-Côte d;Azur	04	4	20	241	Villemus	166	5	171
93	Provence-Alpes-Côte d;Azur	04	4	10	242	Villeneuve	3514	53	3567
93	Provence-Alpes-Côte d;Azur	04	4	30	244	Volonne	1668	41	1709
93	Provence-Alpes-Côte d;Azur	04	4	13	245	Volx	3017	83	3100
93	Provence-Alpes-Côte d;Azur	05	1	01	001	Abriès	365	12	377
93	Provence-Alpes-Côte d;Azur	05	2	19	002	Agnières-en-Dévoluy	270	5	275
93	Provence-Alpes-Côte d;Azur	05	1	01	003	Aiguilles	433	9	442
93	Provence-Alpes-Côte d;Azur	05	2	18	004	Ancelle	858	15	873
93	Provence-Alpes-Côte d;Azur	05	2	16	005	Antonaves	179	4	183
93	Provence-Alpes-Côte d;Azur	05	1	02	006	L; Argentière-la-Bessée	2326	76	2402
93	Provence-Alpes-Côte d;Azur	05	1	01	007	Arvieux	375	15	390
93	Provence-Alpes-Côte d;Azur	05	2	03	008	Aspremont	320	8	328
93	Provence-Alpes-Côte d;Azur	05	2	20	009	Aspres-lès-Corps	139	3	142
93	Provence-Alpes-Côte d;Azur	05	2	03	010	Aspres-sur-Buëch	819	19	838
93	Provence-Alpes-Côte d;Azur	05	2	05	011	Avançon	391	4	395
93	Provence-Alpes-Côte d;Azur	05	2	08	012	Baratier	510	19	529
93	Provence-Alpes-Côte d;Azur	05	2	04	013	Barcillonnette	136	5	141
93	Provence-Alpes-Côte d;Azur	05	2	16	014	Barret-sur-Méouge	227	8	235
93	Provence-Alpes-Côte d;Azur	05	2	22	016	La Bâtie-Montsaléon	210	2	212
93	Provence-Alpes-Côte d;Azur	05	2	05	017	La Bâtie-Neuve	2325	75	2400
93	Provence-Alpes-Côte d;Azur	05	2	05	018	La Bâtie-Vieille	278	20	298
93	Provence-Alpes-Côte d;Azur	05	2	03	019	La Beaume	164	4	168
93	Provence-Alpes-Côte d;Azur	05	2	18	020	Bénévent-et-Charbillac	270	9	279
93	Provence-Alpes-Côte d;Azur	05	2	22	021	Le Bersac	152	3	155
93	Provence-Alpes-Côte d;Azur	05	2	07	022	Bréziers	164	6	170
93	Provence-Alpes-Côte d;Azur	05	1	98	023	Briançon	11627	467	12094
93	Provence-Alpes-Côte d;Azur	05	2	17	024	Bruis	66	1	67
93	Provence-Alpes-Côte d;Azur	05	2	18	025	Buissard	182	7	189
93	Provence-Alpes-Côte d;Azur	05	1	11	026	Ceillac	304	16	320
93	Provence-Alpes-Côte d;Azur	05	1	25	027	Cervières	174	4	178
93	Provence-Alpes-Côte d;Azur	05	2	24	028	Chabestan	153	6	159
93	Provence-Alpes-Côte d;Azur	05	2	18	029	Chabottes	757	24	781
93	Provence-Alpes-Côte d;Azur	05	1	02	031	Champcella	174	1	175
93	Provence-Alpes-Côte d;Azur	05	2	14	032	Champoléon	127	5	132
93	Provence-Alpes-Côte d;Azur	05	2	17	033	Chanousse	58	0	58
93	Provence-Alpes-Côte d;Azur	05	2	20	064	La Chapelle-en-Valgaudémar	121	4	125
93	Provence-Alpes-Côte d;Azur	05	1	01	038	Château-Ville-Vieille	337	11	348
93	Provence-Alpes-Côte d;Azur	05	2	24	035	Châteauneuf-d;Oze	27	0	27
93	Provence-Alpes-Côte d;Azur	05	2	16	034	Châteauneuf-de-Chabre	315	8	323
93	Provence-Alpes-Côte d;Azur	05	2	08	036	Châteauroux-les-Alpes	1117	27	1144
93	Provence-Alpes-Côte d;Azur	05	2	23	037	Châteauvieux	447	17	464
93	Provence-Alpes-Côte d;Azur	05	2	20	039	Chauffayer	391	5	396
93	Provence-Alpes-Côte d;Azur	05	2	07	040	Chorges	2599	56	2655
93	Provence-Alpes-Côte d;Azur	05	2	19	042	La Cluse	53	1	54
93	Provence-Alpes-Côte d;Azur	05	2	18	043	Les Costes	153	1	154
93	Provence-Alpes-Côte d;Azur	05	2	08	044	Crévoux	142	4	146
93	Provence-Alpes-Côte d;Azur	05	2	08	045	Crots	933	30	963
93	Provence-Alpes-Côte d;Azur	05	2	08	046	Embrun	6110	371	6481
93	Provence-Alpes-Côte d;Azur	05	2	16	047	Éourres	151	3	154
93	Provence-Alpes-Côte d;Azur	05	2	22	048	L; Épine	182	13	195
93	Provence-Alpes-Côte d;Azur	05	2	04	049	Esparron	38	2	40
93	Provence-Alpes-Côte d;Azur	05	2	07	050	Espinasses	675	18	693
93	Provence-Alpes-Côte d;Azur	05	2	15	051	Étoile-Saint-Cyrice	34	4	38
93	Provence-Alpes-Côte d;Azur	05	1	11	052	Eygliers	730	10	740
93	Provence-Alpes-Côte d;Azur	05	2	12	053	Eyguians	232	4	236
93	Provence-Alpes-Côte d;Azur	05	2	18	054	La Fare-en-Champsaur	449	6	455
93	Provence-Alpes-Côte d;Azur	05	2	03	055	La Faurie	316	8	324
93	Provence-Alpes-Côte d;Azur	05	2	18	056	Forest-Saint-Julien	283	1	284
93	Provence-Alpes-Côte d;Azur	05	2	23	057	Fouillouse	198	5	203
93	Provence-Alpes-Côte d;Azur	05	1	02	058	Freissinières	198	7	205
93	Provence-Alpes-Côte d;Azur	05	2	09	059	La Freissinouse	536	11	547
93	Provence-Alpes-Côte d;Azur	05	2	24	060	Furmeyer	142	5	147
93	Provence-Alpes-Côte d;Azur	05	2	99	061	Gap	39744	1915	41659
93	Provence-Alpes-Côte d;Azur	05	2	20	062	Le Glaizil	180	4	184
93	Provence-Alpes-Côte d;Azur	05	1	10	063	La Grave	488	13	501
93	Provence-Alpes-Côte d;Azur	05	1	11	065	Guillestre	2325	86	2411
93	Provence-Alpes-Côte d;Azur	05	2	03	066	La Haute-Beaume	10	0	10
93	Provence-Alpes-Côte d;Azur	05	2	18	067	Les Infournas	28	1	29
93	Provence-Alpes-Côte d;Azur	05	2	23	068	Jarjayes	433	14	447
93	Provence-Alpes-Côte d;Azur	05	2	15	069	Lagrand	268	13	281
93	Provence-Alpes-Côte d;Azur	05	2	12	070	Laragne-Montéglin	3756	107	3863
93	Provence-Alpes-Côte d;Azur	05	2	23	071	Lardier-et-Valença	293	5	298
93	Provence-Alpes-Côte d;Azur	05	2	18	072	Laye	246	7	253
93	Provence-Alpes-Côte d;Azur	05	2	12	073	Lazer	329	13	342
93	Provence-Alpes-Côte d;Azur	05	2	23	074	Lettret	184	1	185
93	Provence-Alpes-Côte d;Azur	05	2	09	075	Manteyer	421	11	432
93	Provence-Alpes-Côte d;Azur	05	2	22	076	Méreuil	89	2	91
93	Provence-Alpes-Côte d;Azur	05	1	01	077	Molines-en-Queyras	315	5	320
93	Provence-Alpes-Côte d;Azur	05	2	12	078	Monêtier-Allemont	318	13	331
93	Provence-Alpes-Côte d;Azur	05	1	13	079	Le Monêtier-les-Bains	1035	38	1073
93	Provence-Alpes-Côte d;Azur	05	1	11	082	Mont-Dauphin	147	5	152
93	Provence-Alpes-Côte d;Azur	05	2	03	080	Montbrand	61	0	61
93	Provence-Alpes-Côte d;Azur	05	2	22	081	Montclus	55	2	57
93	Provence-Alpes-Côte d;Azur	05	2	05	084	Montgardin	452	7	459
93	Provence-Alpes-Côte d;Azur	05	1	06	085	Montgenèvre	511	18	529
93	Provence-Alpes-Côte d;Azur	05	2	17	086	Montjay	104	0	104
93	Provence-Alpes-Côte d;Azur	05	2	24	087	Montmaur	519	15	534
93	Provence-Alpes-Côte d;Azur	05	2	22	088	Montmorin	90	1	91
93	Provence-Alpes-Côte d;Azur	05	2	22	089	Montrond	54	1	55
93	Provence-Alpes-Côte d;Azur	05	2	18	090	La Motte-en-Champsaur	204	6	210
93	Provence-Alpes-Côte d;Azur	05	2	17	091	Moydans	56	1	57
93	Provence-Alpes-Côte d;Azur	05	2	23	092	Neffes	747	18	765
93	Provence-Alpes-Côte d;Azur	05	1	06	093	Névache	348	10	358
93	Provence-Alpes-Côte d;Azur	05	2	15	094	Nossage-et-Bénévent	12	0	12
93	Provence-Alpes-Côte d;Azur	05	2	18	095	Le Noyer	267	5	272
93	Provence-Alpes-Côte d;Azur	05	2	14	096	Orcières	718	9	727
93	Provence-Alpes-Côte d;Azur	05	2	15	097	Orpierre	328	47	375
93	Provence-Alpes-Côte d;Azur	05	2	08	098	Les Orres	507	9	516
93	Provence-Alpes-Côte d;Azur	05	2	24	099	Oze	94	2	96
93	Provence-Alpes-Côte d;Azur	05	2	09	100	Pelleautier	606	21	627
93	Provence-Alpes-Côte d;Azur	05	1	02	101	Pelvoux	467	7	474
93	Provence-Alpes-Côte d;Azur	05	2	22	102	La Piarre	97	1	98
93	Provence-Alpes-Côte d;Azur	05	2	12	103	Le Poët	728	26	754
93	Provence-Alpes-Côte d;Azur	05	2	18	104	Poligny	327	4	331
93	Provence-Alpes-Côte d;Azur	05	2	07	106	Prunières	289	9	298
93	Provence-Alpes-Côte d;Azur	05	1	25	107	Puy-Saint-André	468	17	485
93	Provence-Alpes-Côte d;Azur	05	2	21	108	Puy-Saint-Eusèbe	128	4	132
93	Provence-Alpes-Côte d;Azur	05	1	25	109	Puy-Saint-Pierre	507	26	533
93	Provence-Alpes-Côte d;Azur	05	1	02	110	Puy-Saint-Vincent	299	5	304
93	Provence-Alpes-Côte d;Azur	05	2	21	111	Puy-Sanières	236	11	247
93	Provence-Alpes-Côte d;Azur	05	2	09	112	Rabou	79	6	85
93	Provence-Alpes-Côte d;Azur	05	2	05	113	Rambaud	367	18	385
93	Provence-Alpes-Côte d;Azur	05	2	21	114	Réallon	253	1	254
93	Provence-Alpes-Côte d;Azur	05	2	07	115	Remollon	431	16	447
93	Provence-Alpes-Côte d;Azur	05	1	11	116	Réotier	207	6	213
93	Provence-Alpes-Côte d;Azur	05	2	17	117	Ribeyret	105	3	108
93	Provence-Alpes-Côte d;Azur	05	2	16	118	Ribiers	794	31	825
93	Provence-Alpes-Côte d;Azur	05	1	11	119	Risoul	644	30	674
93	Provence-Alpes-Côte d;Azur	05	1	01	120	Ristolas	90	9	99
93	Provence-Alpes-Côte d;Azur	05	1	02	122	La Roche-de-Rame	839	26	865
93	Provence-Alpes-Côte d;Azur	05	2	09	123	La Roche-des-Arnauds	1398	44	1442
93	Provence-Alpes-Côte d;Azur	05	2	07	121	Rochebrune	161	3	164
93	Provence-Alpes-Côte d;Azur	05	2	05	124	La Rochette	423	15	438
93	Provence-Alpes-Côte d;Azur	05	2	17	126	Rosans	519	8	527
93	Provence-Alpes-Côte d;Azur	05	2	07	127	Rousset	163	1	164
93	Provence-Alpes-Côte d;Azur	05	2	08	128	Saint-André-d;Embrun	620	25	645
93	Provence-Alpes-Côte d;Azur	05	2	17	129	Saint-André-de-Rosans	146	7	153
93	Provence-Alpes-Côte d;Azur	05	2	21	130	Saint-Apollinaire	120	4	124
93	Provence-Alpes-Côte d;Azur	05	2	24	131	Saint-Auban-d;Oze	71	3	74
93	Provence-Alpes-Côte d;Azur	05	2	18	132	Saint-Bonnet-en-Champsaur	1700	55	1755
93	Provence-Alpes-Côte d;Azur	05	1	13	133	Saint-Chaffrey	1668	67	1735
93	Provence-Alpes-Côte d;Azur	05	1	11	134	Saint-Clément-sur-Durance	294	12	306
93	Provence-Alpes-Côte d;Azur	05	1	11	136	Saint-Crépin	624	15	639
93	Provence-Alpes-Côte d;Azur	05	2	19	138	Saint-Disdier	136	3	139
93	Provence-Alpes-Côte d;Azur	05	2	19	139	Saint-Étienne-en-Dévoluy	558	20	578
93	Provence-Alpes-Côte d;Azur	05	2	05	140	Saint-Étienne-le-Laus	301	2	303
93	Provence-Alpes-Côte d;Azur	05	2	18	141	Saint-Eusèbe-en-Champsaur	142	4	146
93	Provence-Alpes-Côte d;Azur	05	2	20	142	Saint-Firmin	477	11	488
93	Provence-Alpes-Côte d;Azur	05	2	22	143	Saint-Genis	52	0	52
93	Provence-Alpes-Côte d;Azur	05	2	20	144	Saint-Jacques-en-Valgodemard	150	2	152
93	Provence-Alpes-Côte d;Azur	05	2	14	145	Saint-Jean-Saint-Nicolas	1010	96	1106
93	Provence-Alpes-Côte d;Azur	05	2	03	146	Saint-Julien-en-Beauchêne	128	2	130
93	Provence-Alpes-Côte d;Azur	05	2	18	147	Saint-Julien-en-Champsaur	306	8	314
93	Provence-Alpes-Côte d;Azur	05	2	18	148	Saint-Laurent-du-Cros	518	16	534
93	Provence-Alpes-Côte d;Azur	05	2	18	149	Saint-Léger-les-Mélèzes	323	3	326
93	Provence-Alpes-Côte d;Azur	05	1	02	151	Saint-Martin-de-Queyrières	1086	30	1116
93	Provence-Alpes-Côte d;Azur	05	2	20	152	Saint-Maurice-en-Valgodemard	137	3	140
93	Provence-Alpes-Côte d;Azur	05	2	18	153	Saint-Michel-de-Chaillol	328	10	338
93	Provence-Alpes-Côte d;Azur	05	2	16	155	Saint-Pierre-Avez	24	1	25
93	Provence-Alpes-Côte d;Azur	05	2	03	154	Saint-Pierre-d;Argençon	158	0	158
93	Provence-Alpes-Côte d;Azur	05	2	08	156	Saint-Sauveur	440	14	454
93	Provence-Alpes-Côte d;Azur	05	1	01	157	Saint-Véran	257	5	262
93	Provence-Alpes-Côte d;Azur	05	2	15	135	Sainte-Colombe	59	0	59
93	Provence-Alpes-Côte d;Azur	05	2	17	150	Sainte-Marie	42	0	42
93	Provence-Alpes-Côte d;Azur	05	2	24	158	Le Saix	98	2	100
93	Provence-Alpes-Côte d;Azur	05	2	15	159	Saléon	92	4	96
93	Provence-Alpes-Côte d;Azur	05	2	16	160	Salérans	85	4	89
93	Provence-Alpes-Côte d;Azur	05	1	13	161	La Salle-les-Alpes	906	42	948
93	Provence-Alpes-Côte d;Azur	05	2	23	162	La Saulce	1302	36	1338
93	Provence-Alpes-Côte d;Azur	05	2	21	163	Le Sauze-du-Lac	134	4	138
93	Provence-Alpes-Côte d;Azur	05	2	21	164	Savines-le-Lac	1088	44	1132
93	Provence-Alpes-Côte d;Azur	05	2	22	165	Savournon	241	11	252
93	Provence-Alpes-Côte d;Azur	05	2	22	166	Serres	1283	40	1323
93	Provence-Alpes-Côte d;Azur	05	2	22	167	Sigottier	79	5	84
93	Provence-Alpes-Côte d;Azur	05	2	23	168	Sigoyer	640	22	662
93	Provence-Alpes-Côte d;Azur	05	2	17	169	Sorbiers	41	2	43
93	Provence-Alpes-Côte d;Azur	05	2	23	170	Tallard	1988	54	2042
93	Provence-Alpes-Côte d;Azur	05	2	07	171	Théus	216	4	220
93	Provence-Alpes-Côte d;Azur	05	2	15	172	Trescléoux	311	8	319
93	Provence-Alpes-Côte d;Azur	05	2	12	173	Upaix	423	10	433
93	Provence-Alpes-Côte d;Azur	05	1	06	174	Val-des-Prés	541	26	567
93	Provence-Alpes-Côte d;Azur	05	1	02	175	Vallouise	742	25	767
93	Provence-Alpes-Côte d;Azur	05	2	05	176	Valserres	229	9	238
93	Provence-Alpes-Côte d;Azur	05	1	11	177	Vars	677	16	693
93	Provence-Alpes-Côte d;Azur	05	2	12	178	Ventavon	512	80	592
93	Provence-Alpes-Côte d;Azur	05	2	24	179	Veynes	3186	157	3343
93	Provence-Alpes-Côte d;Azur	05	1	02	180	Les Vigneaux	480	19	499
93	Provence-Alpes-Côte d;Azur	05	1	10	181	Villar-d;Arêne	287	3	290
93	Provence-Alpes-Côte d;Azur	05	2	20	182	Villar-Loubière	46	2	48
93	Provence-Alpes-Côte d;Azur	05	1	25	183	Villar-Saint-Pancrace	1457	47	1504
93	Provence-Alpes-Côte d;Azur	05	2	04	184	Vitrolles	209	11	220
93	Provence-Alpes-Côte d;Azur	06	1	21	001	Aiglun	94	1	95
93	Provence-Alpes-Côte d;Azur	06	1	21	002	Amirat	55	0	55
93	Provence-Alpes-Côte d;Azur	06	1	21	003	Andon	579	8	587
93	Provence-Alpes-Côte d;Azur	06	1	97	004	Antibes	74120	1054	75174
93	Provence-Alpes-Côte d;Azur	06	2	18	005	Ascros	143	4	147
93	Provence-Alpes-Côte d;Azur	06	2	12	006	Aspremont	2187	25	2212
93	Provence-Alpes-Côte d;Azur	06	1	10	007	Auribeau-sur-Siagne	3042	54	3096
93	Provence-Alpes-Côte d;Azur	06	2	18	008	Auvare	49	1	50
93	Provence-Alpes-Côte d;Azur	06	2	29	009	Bairols	107	1	108
93	Provence-Alpes-Côte d;Azur	06	1	02	010	Le Bar-sur-Loup	2795	50	2845
93	Provence-Alpes-Côte d;Azur	06	2	30	011	Beaulieu-sur-Mer	3761	31	3792
93	Provence-Alpes-Côte d;Azur	06	2	03	012	Beausoleil	13515	169	13684
93	Provence-Alpes-Côte d;Azur	06	2	19	013	Belvédère	656	5	661
93	Provence-Alpes-Côte d;Azur	06	2	07	014	Bendejun	930	12	942
93	Provence-Alpes-Côte d;Azur	06	2	07	015	Berre-les-Alpes	1279	13	1292
93	Provence-Alpes-Côte d;Azur	06	2	11	016	Beuil	495	5	500
93	Provence-Alpes-Côte d;Azur	06	1	08	017	Bézaudun-les-Alpes	204	3	207
93	Provence-Alpes-Côte d;Azur	06	1	01	018	Biot	9449	238	9687
93	Provence-Alpes-Côte d;Azur	06	2	09	019	Blausasc	1469	13	1482
93	Provence-Alpes-Côte d;Azur	06	2	19	020	La Bollène-Vésubie	560	8	568
93	Provence-Alpes-Côte d;Azur	06	2	20	021	Bonson	665	14	679
93	Provence-Alpes-Côte d;Azur	06	1	08	022	Bouyon	482	4	486
93	Provence-Alpes-Côte d;Azur	06	2	04	023	Breil-sur-Roya	2313	54	2367
93	Provence-Alpes-Côte d;Azur	06	1	21	024	Briançonnet	217	6	223
93	Provence-Alpes-Côte d;Azur	06	2	31	162	La Brigue	700	16	716
93	Provence-Alpes-Côte d;Azur	06	1	50	025	Le Broc	1317	14	1331
93	Provence-Alpes-Côte d;Azur	06	1	25	026	Cabris	1410	49	1459
93	Provence-Alpes-Côte d;Azur	06	1	96	027	Cagnes-sur-Mer	47141	570	47711
93	Provence-Alpes-Côte d;Azur	06	1	21	028	Caille	336	7	343
93	Provence-Alpes-Côte d;Azur	06	1	98	029	Cannes	73234	1039	74273
93	Provence-Alpes-Côte d;Azur	06	1	95	030	Le Cannet	42320	460	42780
93	Provence-Alpes-Côte d;Azur	06	2	07	031	Cantaron	1239	14	1253
93	Provence-Alpes-Côte d;Azur	06	2	30	032	Cap-d;Ail	5022	67	5089
93	Provence-Alpes-Côte d;Azur	06	1	50	033	Carros	11508	131	11639
93	Provence-Alpes-Côte d;Azur	06	2	12	034	Castagniers	1542	24	1566
93	Provence-Alpes-Côte d;Azur	06	2	13	035	Castellar	974	24	998
93	Provence-Alpes-Côte d;Azur	06	2	26	036	Castillon	372	3	375
93	Provence-Alpes-Côte d;Azur	06	1	02	037	Caussols	242	6	248
93	Provence-Alpes-Côte d;Azur	06	2	11	040	Châteauneuf-d;Entraunes	63	0	63
93	Provence-Alpes-Côte d;Azur	06	1	02	038	Châteauneuf-Grasse	3245	86	3331
93	Provence-Alpes-Côte d;Azur	06	2	07	039	Châteauneuf-Villevieille	872	3	875
93	Provence-Alpes-Côte d;Azur	06	1	08	041	Cipières	373	11	384
93	Provence-Alpes-Côte d;Azur	06	2	24	042	Clans	562	9	571
93	Provence-Alpes-Côte d;Azur	06	2	07	043	Coaraze	736	10	746
93	Provence-Alpes-Côte d;Azur	06	1	45	044	La Colle-sur-Loup	7676	142	7818
93	Provence-Alpes-Côte d;Azur	06	1	21	045	Collongues	100	0	100
93	Provence-Alpes-Côte d;Azur	06	2	12	046	Colomars	3290	38	3328
93	Provence-Alpes-Côte d;Azur	06	1	08	047	Conségudes	82	0	82
93	Provence-Alpes-Côte d;Azur	06	2	07	048	Contes	7010	89	7099
93	Provence-Alpes-Côte d;Azur	06	1	02	049	Courmes	100	1	101
93	Provence-Alpes-Côte d;Azur	06	1	08	050	Coursegoules	473	9	482
93	Provence-Alpes-Côte d;Azur	06	2	18	051	La Croix-sur-Roudoule	87	1	88
93	Provence-Alpes-Côte d;Azur	06	2	20	052	Cuébris	150	4	154
93	Provence-Alpes-Côte d;Azur	06	2	11	053	Daluis	148	3	151
93	Provence-Alpes-Côte d;Azur	06	2	07	054	Drap	4385	27	4412
93	Provence-Alpes-Côte d;Azur	06	2	12	055	Duranus	181	1	182
93	Provence-Alpes-Côte d;Azur	06	2	11	056	Entraunes	123	10	133
93	Provence-Alpes-Côte d;Azur	06	2	09	057	L; Escarène	2399	17	2416
93	Provence-Alpes-Côte d;Azur	06	1	25	058	Escragnolles	596	4	600
93	Provence-Alpes-Côte d;Azur	06	2	30	059	Èze	2686	41	2727
93	Provence-Alpes-Côte d;Azur	06	2	43	060	Falicon	1913	25	1938
93	Provence-Alpes-Côte d;Azur	06	1	08	061	Les Ferres	97	0	97
93	Provence-Alpes-Côte d;Azur	06	2	04	062	Fontan	255	5	260
93	Provence-Alpes-Côte d;Azur	06	1	21	063	Gars	60	0	60
93	Provence-Alpes-Côte d;Azur	06	1	50	064	Gattières	4052	50	4102
93	Provence-Alpes-Côte d;Azur	06	1	28	065	La Gaude	6821	136	6957
93	Provence-Alpes-Côte d;Azur	06	2	20	066	Gilette	1494	13	1507
93	Provence-Alpes-Côte d;Azur	06	2	52	067	Gorbio	1284	30	1314
93	Provence-Alpes-Côte d;Azur	06	1	02	068	Gourdon	426	5	431
93	Provence-Alpes-Côte d;Azur	06	1	94	069	Grasse	51036	1149	52185
93	Provence-Alpes-Côte d;Azur	06	1	08	070	Gréolières	559	8	567
93	Provence-Alpes-Côte d;Azur	06	2	11	071	Guillaumes	689	15	704
93	Provence-Alpes-Côte d;Azur	06	2	24	072	Ilonse	167	2	169
93	Provence-Alpes-Côte d;Azur	06	2	22	073	Isola	752	23	775
93	Provence-Alpes-Côte d;Azur	06	2	27	074	Lantosque	1343	11	1354
93	Provence-Alpes-Côte d;Azur	06	2	12	075	Levens	4683	62	4745
93	Provence-Alpes-Côte d;Azur	06	2	29	076	Lieuche	40	4	44
93	Provence-Alpes-Côte d;Azur	06	2	09	077	Lucéram	1237	19	1256
93	Provence-Alpes-Côte d;Azur	06	2	29	078	Malaussène	267	3	270
93	Provence-Alpes-Côte d;Azur	06	1	36	079	Mandelieu-la-Napoule	22203	295	22498
93	Provence-Alpes-Côte d;Azur	06	2	24	080	Marie	84	1	85
93	Provence-Alpes-Côte d;Azur	06	1	21	081	Le Mas	169	0	169
93	Provence-Alpes-Côte d;Azur	06	2	29	082	Massoins	125	2	127
93	Provence-Alpes-Côte d;Azur	06	2	93	083	Menton	28858	531	29389
93	Provence-Alpes-Côte d;Azur	06	1	46	084	Mouans-Sartoux	10198	245	10443
93	Provence-Alpes-Côte d;Azur	06	1	46	085	Mougins	18917	350	19267
93	Provence-Alpes-Côte d;Azur	06	2	26	086	Moulinet	207	6	213
93	Provence-Alpes-Côte d;Azur	06	1	21	087	Les Mujouls	44	0	44
93	Provence-Alpes-Côte d;Azur	06	2	99	088	Nice	343304	3801	347105
93	Provence-Alpes-Côte d;Azur	06	1	02	089	Opio	2115	72	2187
93	Provence-Alpes-Côte d;Azur	06	1	10	090	Pégomas	6809	115	6924
93	Provence-Alpes-Côte d;Azur	06	2	09	091	Peille	2291	24	2315
93	Provence-Alpes-Côte d;Azur	06	2	09	092	Peillon	1382	10	1392
93	Provence-Alpes-Côte d;Azur	06	2	18	093	La Penne	313	1	314
93	Provence-Alpes-Côte d;Azur	06	2	11	094	Péone	908	24	932
93	Provence-Alpes-Côte d;Azur	06	1	25	095	Peymeinade	7867	202	8069
93	Provence-Alpes-Côte d;Azur	06	2	29	096	Pierlas	97	0	97
93	Provence-Alpes-Côte d;Azur	06	2	20	097	Pierrefeu	254	6	260
93	Provence-Alpes-Côte d;Azur	06	2	18	098	Puget-Rostang	107	2	109
93	Provence-Alpes-Côte d;Azur	06	2	18	099	Puget-Théniers	1805	83	1888
93	Provence-Alpes-Côte d;Azur	06	2	20	100	Revest-les-Roches	212	4	216
93	Provence-Alpes-Côte d;Azur	06	2	18	101	Rigaud	219	1	220
93	Provence-Alpes-Côte d;Azur	06	2	24	102	Rimplas	128	0	128
93	Provence-Alpes-Côte d;Azur	06	2	19	103	Roquebillière	1672	66	1738
93	Provence-Alpes-Côte d;Azur	06	2	52	104	Roquebrune-Cap-Martin	12532	168	12700
93	Provence-Alpes-Côte d;Azur	06	1	02	105	Roquefort-les-Pins	6355	214	6569
93	Provence-Alpes-Côte d;Azur	06	2	20	106	Roquesteron	550	2	552
93	Provence-Alpes-Côte d;Azur	06	1	08	107	Roquestéron-Grasse	79	2	81
93	Provence-Alpes-Côte d;Azur	06	1	46	108	La Roquette-sur-Siagne	4962	97	5059
93	Provence-Alpes-Côte d;Azur	06	2	12	109	La Roquette-sur-Var	931	10	941
93	Provence-Alpes-Côte d;Azur	06	2	24	110	Roubion	124	0	124
93	Provence-Alpes-Côte d;Azur	06	2	24	111	Roure	212	3	215
93	Provence-Alpes-Côte d;Azur	06	1	02	112	Le Rouret	3857	162	4019
93	Provence-Alpes-Côte d;Azur	06	2	43	114	Saint-André-de-la-Roche	5004	48	5052
93	Provence-Alpes-Côte d;Azur	06	2	18	115	Saint-Antonin	109	3	112
93	Provence-Alpes-Côte d;Azur	06	1	21	116	Saint-Auban	222	4	226
93	Provence-Alpes-Côte d;Azur	06	2	12	117	Saint-Blaise	959	16	975
93	Provence-Alpes-Côte d;Azur	06	1	25	118	Saint-Cézaire-sur-Siagne	3670	68	3738
93	Provence-Alpes-Côte d;Azur	06	2	22	119	Saint-Dalmas-le-Selvage	126	8	134
93	Provence-Alpes-Côte d;Azur	06	2	22	120	Saint-Étienne-de-Tinée	1304	165	1469
93	Provence-Alpes-Côte d;Azur	06	2	30	121	Saint-Jean-Cap-Ferrat	2030	13	2043
93	Provence-Alpes-Côte d;Azur	06	1	28	122	Saint-Jeannet	3682	71	3753
93	Provence-Alpes-Côte d;Azur	06	1	05	123	Saint-Laurent-du-Var	29963	272	30235
93	Provence-Alpes-Côte d;Azur	06	2	18	124	Saint-Léger	67	1	68
93	Provence-Alpes-Côte d;Azur	06	2	11	125	Saint-Martin-d;Entraunes	83	0	83
93	Provence-Alpes-Côte d;Azur	06	2	12	126	Saint-Martin-du-Var	2576	23	2599
93	Provence-Alpes-Côte d;Azur	06	2	23	127	Saint-Martin-Vésubie	1324	5	1329
93	Provence-Alpes-Côte d;Azur	06	1	45	128	Saint-Paul-de-Vence	3486	59	3545
93	Provence-Alpes-Côte d;Azur	06	2	24	129	Saint-Sauveur-sur-Tinée	343	89	432
93	Provence-Alpes-Côte d;Azur	06	1	25	130	Saint-Vallier-de-Thiey	3321	103	3424
93	Provence-Alpes-Côte d;Azur	06	2	52	113	Sainte-Agnès	1197	26	1223
93	Provence-Alpes-Côte d;Azur	06	1	21	131	Sallagriffon	50	1	51
93	Provence-Alpes-Côte d;Azur	06	2	04	132	Saorge	442	9	451
93	Provence-Alpes-Côte d;Azur	06	2	11	133	Sauze	98	2	100
93	Provence-Alpes-Côte d;Azur	06	1	21	134	Séranon	477	0	477
93	Provence-Alpes-Côte d;Azur	06	2	20	135	Sigale	209	9	218
93	Provence-Alpes-Côte d;Azur	06	2	26	136	Sospel	3527	82	3609
93	Provence-Alpes-Côte d;Azur	06	1	25	137	Spéracèdes	1266	30	1296
93	Provence-Alpes-Côte d;Azur	06	2	31	163	Tende	2084	49	2133
93	Provence-Alpes-Côte d;Azur	06	1	36	138	Théoule-sur-Mer	1551	22	1573
93	Provence-Alpes-Côte d;Azur	06	2	29	139	Thiéry	103	0	103
93	Provence-Alpes-Côte d;Azur	06	1	25	140	Le Tignet	3140	86	3226
93	Provence-Alpes-Côte d;Azur	06	2	20	141	Toudon	286	2	288
93	Provence-Alpes-Côte d;Azur	06	2	09	142	Touët-de-l;Escarène	325	1	326
93	Provence-Alpes-Côte d;Azur	06	2	29	143	Touët-sur-Var	661	10	671
93	Provence-Alpes-Côte d;Azur	06	2	29	144	La Tour	465	4	469
93	Provence-Alpes-Côte d;Azur	06	2	20	145	Tourette-du-Château	117	1	118
93	Provence-Alpes-Côte d;Azur	06	2	29	146	Tournefort	138	0	138
93	Provence-Alpes-Côte d;Azur	06	2	12	147	Tourrette-Levens	4729	46	4775
93	Provence-Alpes-Côte d;Azur	06	1	02	148	Tourrettes-sur-Loup	4007	95	4102
93	Provence-Alpes-Côte d;Azur	06	2	43	149	La Trinité	10332	121	10453
93	Provence-Alpes-Côte d;Azur	06	2	30	150	La Turbie	3180	44	3224
93	Provence-Alpes-Côte d;Azur	06	2	27	151	Utelle	720	4	724
93	Provence-Alpes-Côte d;Azur	06	1	02	152	Valbonne	12275	528	12803
93	Provence-Alpes-Côte d;Azur	06	2	24	153	Valdeblore	882	252	1134
93	Provence-Alpes-Côte d;Azur	06	1	21	154	Valderoure	397	3	400
93	Provence-Alpes-Côte d;Azur	06	1	35	155	Vallauris	28252	198	28450
93	Provence-Alpes-Côte d;Azur	06	2	23	156	Venanson	149	1	150
93	Provence-Alpes-Côte d;Azur	06	1	28	157	Vence	19281	208	19489
93	Provence-Alpes-Côte d;Azur	06	2	29	158	Villars-sur-Var	671	14	685
93	Provence-Alpes-Côte d;Azur	06	2	30	159	Villefranche-sur-Mer	5419	52	5471
93	Provence-Alpes-Côte d;Azur	06	2	11	160	Villeneuve-d;Entraunes	85	2	87
93	Provence-Alpes-Côte d;Azur	06	1	45	161	Villeneuve-Loubet	15020	238	15258
82	Rhône-Alpes	07	3	06	001	Accons	428	23	451
82	Rhône-Alpes	07	1	03	002	Ailhon	502	8	510
82	Rhône-Alpes	07	1	02	003	Aizac	154	3	157
82	Rhône-Alpes	07	2	13	004	Ajoux	95	2	97
82	Rhône-Alpes	07	2	30	005	Alba-la-Romaine	1407	48	1455
82	Rhône-Alpes	07	2	20	006	Albon-d;Ardèche	156	3	159
82	Rhône-Alpes	07	3	19	007	Alboussière	938	26	964
82	Rhône-Alpes	07	2	13	008	Alissas	1371	52	1423
82	Rhône-Alpes	07	3	22	009	Andance	1129	15	1144
82	Rhône-Alpes	07	3	99	010	Annonay	16660	615	17275
82	Rhône-Alpes	07	1	02	011	Antraigues-sur-Volane	544	13	557
82	Rhône-Alpes	07	3	18	012	Arcens	398	19	417
82	Rhône-Alpes	07	3	21	013	Ardoix	1082	18	1100
82	Rhône-Alpes	07	3	17	014	Arlebosc	348	12	360
82	Rhône-Alpes	07	3	24	015	Arras-sur-Rhône	527	18	545
82	Rhône-Alpes	07	1	02	016	Asperjoc	393	7	400
82	Rhône-Alpes	07	1	27	017	Les Assions	654	16	670
82	Rhône-Alpes	07	1	23	018	Astet	41	0	41
82	Rhône-Alpes	07	1	03	019	Aubenas	11323	882	12205
82	Rhône-Alpes	07	2	30	020	Aubignas	418	7	425
82	Rhône-Alpes	07	2	07	022	Baix	1034	31	1065
82	Rhône-Alpes	07	1	26	023	Balazuc	341	11	352
82	Rhône-Alpes	07	1	27	024	Banne	687	17	704
82	Rhône-Alpes	07	1	23	025	Barnas	229	3	232
82	Rhône-Alpes	07	1	12	026	Le Béage	301	9	310
82	Rhône-Alpes	07	2	31	027	Beauchastel	1666	26	1692
82	Rhône-Alpes	07	1	09	028	Beaulieu	455	12	467
82	Rhône-Alpes	07	1	25	029	Beaumont	212	7	219
82	Rhône-Alpes	07	2	20	030	Beauvène	246	4	250
82	Rhône-Alpes	07	1	27	031	Berrias-et-Casteljau	663	20	683
82	Rhône-Alpes	07	1	29	032	Berzème	154	6	160
82	Rhône-Alpes	07	1	26	033	Bessas	202	7	209
82	Rhône-Alpes	07	2	04	034	Bidon	192	2	194
82	Rhône-Alpes	07	3	28	035	Boffres	608	17	625
82	Rhône-Alpes	07	3	22	036	Bogy	359	5	364
82	Rhône-Alpes	07	3	18	037	Borée	167	0	167
82	Rhône-Alpes	07	1	16	038	Borne	40	0	40
82	Rhône-Alpes	07	3	24	040	Boucieu-le-Roi	282	3	285
82	Rhône-Alpes	07	3	01	041	Boulieu-lès-Annonay	2122	53	2175
82	Rhône-Alpes	07	2	04	042	Bourg-Saint-Andéol	7264	219	7483
82	Rhône-Alpes	07	3	17	039	Bozas	246	9	255
82	Rhône-Alpes	07	3	22	044	Brossainc	217	6	223
82	Rhône-Alpes	07	1	05	045	Burzet	455	7	462
82	Rhône-Alpes	07	1	16	047	Cellier-du-Luc	109	0	109
82	Rhône-Alpes	07	3	28	048	Chalencon	314	5	319
82	Rhône-Alpes	07	3	06	049	Le Chambon	56	2	58
82	Rhône-Alpes	07	1	27	050	Chambonas	635	14	649
82	Rhône-Alpes	07	3	22	051	Champagne	610	14	624
82	Rhône-Alpes	07	3	19	052	Champis	586	13	599
82	Rhône-Alpes	07	1	09	053	Chandolas	469	16	485
82	Rhône-Alpes	07	3	18	054	Chanéac	267	10	277
82	Rhône-Alpes	07	2	31	055	Charmes-sur-Rhône	2419	59	2478
82	Rhône-Alpes	07	3	22	056	Charnas	779	8	787
82	Rhône-Alpes	07	1	11	058	Chassiers	1006	56	1062
82	Rhône-Alpes	07	3	19	059	Châteaubourg	218	9	227
82	Rhône-Alpes	07	3	28	060	Châteauneuf-de-Vernoux	187	5	192
82	Rhône-Alpes	07	1	11	061	Chauzon	342	5	347
82	Rhône-Alpes	07	1	11	062	Chazeaux	107	7	114
82	Rhône-Alpes	07	3	24	063	Cheminas	297	5	302
82	Rhône-Alpes	07	3	06	064	Le Cheylard	3218	146	3364
82	Rhône-Alpes	07	1	23	065	Chirols	256	13	269
82	Rhône-Alpes	07	2	07	066	Chomérac	2849	204	3053
82	Rhône-Alpes	07	3	22	067	Colombier-le-Cardinal	278	3	281
82	Rhône-Alpes	07	3	24	068	Colombier-le-Jeune	563	14	577
82	Rhône-Alpes	07	3	17	069	Colombier-le-Vieux	648	14	662
82	Rhône-Alpes	07	3	19	070	Cornas	2253	56	2309
82	Rhône-Alpes	07	1	08	071	Coucouron	841	1	842
82	Rhône-Alpes	07	2	13	072	Coux	1679	52	1731
82	Rhône-Alpes	07	3	10	073	Le Crestet	534	13	547
82	Rhône-Alpes	07	2	13	074	Creysseilles	123	2	125
82	Rhône-Alpes	07	1	12	075	Cros-de-Géorand	175	2	177
82	Rhône-Alpes	07	2	14	076	Cruas	2740	58	2798
82	Rhône-Alpes	07	1	29	077	Darbres	244	9	253
82	Rhône-Alpes	07	3	01	078	Davézieux	2950	79	3029
82	Rhône-Alpes	07	3	10	079	Désaignes	1193	13	1206
82	Rhône-Alpes	07	3	15	080	Devesset	287	12	299
82	Rhône-Alpes	07	1	25	081	Dompnac	81	0	81
82	Rhône-Alpes	07	3	06	082	Dornas	286	13	299
82	Rhône-Alpes	07	2	13	083	Dunière-sur-Eyrieux	416	8	424
82	Rhône-Alpes	07	3	24	084	Eclassan	933	26	959
82	Rhône-Alpes	07	3	10	085	Empurany	544	20	564
82	Rhône-Alpes	07	3	24	086	Étables	801	8	809
82	Rhône-Alpes	07	1	23	087	Fabras	383	4	387
82	Rhône-Alpes	07	1	09	088	Faugères	97	4	101
82	Rhône-Alpes	07	3	22	089	Félines	1481	46	1527
82	Rhône-Alpes	07	2	13	090	Flaviac	1113	35	1148
82	Rhône-Alpes	07	1	03	091	Fons	310	14	324
82	Rhône-Alpes	07	2	13	092	Freyssenet	53	2	55
82	Rhône-Alpes	07	1	02	093	Genestelle	279	4	283
82	Rhône-Alpes	07	2	31	094	Gilhac-et-Bruzac	157	1	158
82	Rhône-Alpes	07	3	10	095	Gilhoc-sur-Ormèze	413	5	418
82	Rhône-Alpes	07	2	20	096	Gluiras	375	8	383
82	Rhône-Alpes	07	3	24	097	Glun	686	10	696
82	Rhône-Alpes	07	2	13	098	Gourdon	97	2	99
82	Rhône-Alpes	07	2	04	099	Gras	562	18	580
82	Rhône-Alpes	07	1	27	100	Gravières	411	11	422
82	Rhône-Alpes	07	1	09	101	Grospierres	866	18	884
82	Rhône-Alpes	07	3	19	102	Guilherand-Granges	11044	247	11291
82	Rhône-Alpes	07	3	18	103	Intres	114	1	115
82	Rhône-Alpes	07	2	20	104	Issamoulenc	108	2	110
82	Rhône-Alpes	07	1	08	105	Issanlas	117	1	118
82	Rhône-Alpes	07	1	08	106	Issarlès	166	5	171
82	Rhône-Alpes	07	1	23	107	Jaujac	1198	24	1222
82	Rhône-Alpes	07	3	06	108	Jaunac	143	11	154
82	Rhône-Alpes	07	1	11	109	Joannas	333	12	345
82	Rhône-Alpes	07	1	09	110	Joyeuse	1657	40	1697
82	Rhône-Alpes	07	1	02	111	Juvinas	169	7	176
82	Rhône-Alpes	07	1	26	113	Labastide-de-Virac	232	4	236
82	Rhône-Alpes	07	1	02	112	Labastide-sur-Bésorgues	241	4	245
82	Rhône-Alpes	07	3	15	114	Labatie-d;Andaure	203	2	205
82	Rhône-Alpes	07	1	09	115	Labeaume	603	26	629
82	Rhône-Alpes	07	1	33	116	Labégude	1360	37	1397
82	Rhône-Alpes	07	1	09	117	Lablachère	1860	45	1905
82	Rhône-Alpes	07	1	25	118	Laboule	147	6	153
82	Rhône-Alpes	07	1	08	119	Le Lac-d;Issarlès	273	1	274
82	Rhône-Alpes	07	1	02	120	Lachamp-Raphaël	84	3	87
82	Rhône-Alpes	07	1	08	121	Lachapelle-Graillouse	257	2	259
82	Rhône-Alpes	07	1	03	122	Lachapelle-sous-Aubenas	1463	45	1508
82	Rhône-Alpes	07	3	18	123	Lachapelle-sous-Chanéac	186	2	188
82	Rhône-Alpes	07	3	17	124	Lafarre	37	4	41
82	Rhône-Alpes	07	1	26	126	Lagorce	1002	22	1024
82	Rhône-Alpes	07	1	23	127	Lalevade-d;Ardèche	1177	13	1190
82	Rhône-Alpes	07	3	21	128	Lalouvesc	460	3	463
82	Rhône-Alpes	07	3	10	129	Lamastre	2480	88	2568
82	Rhône-Alpes	07	1	08	130	Lanarce	164	7	171
82	Rhône-Alpes	07	1	29	131	Lanas	380	18	398
82	Rhône-Alpes	07	1	11	132	Largentière	1814	126	1940
82	Rhône-Alpes	07	2	04	133	Larnas	129	3	132
82	Rhône-Alpes	07	1	11	134	Laurac-en-Vivarais	895	23	918
82	Rhône-Alpes	07	1	16	135	Laval-d;Aurelle	56	3	59
82	Rhône-Alpes	07	1	16	136	Laveyrune	128	2	130
82	Rhône-Alpes	07	1	08	137	Lavillatte	71	0	71
82	Rhône-Alpes	07	1	29	138	Lavilledieu	1923	50	1973
82	Rhône-Alpes	07	1	02	139	Laviolle	120	4	124
82	Rhône-Alpes	07	3	24	140	Lemps	769	14	783
82	Rhône-Alpes	07	1	03	141	Lentillères	217	6	223
82	Rhône-Alpes	07	1	08	142	Lespéron	320	13	333
82	Rhône-Alpes	07	3	22	143	Limony	762	12	774
82	Rhône-Alpes	07	1	25	144	Loubaresse	32	1	33
82	Rhône-Alpes	07	1	29	145	Lussas	1001	26	1027
82	Rhône-Alpes	07	2	13	146	Lyas	558	11	569
82	Rhône-Alpes	07	1	27	147	Malarce-sur-la-Thines	227	12	239
82	Rhône-Alpes	07	1	27	148	Malbosc	151	3	154
82	Rhône-Alpes	07	2	20	149	Marcols-les-Eaux	336	2	338
82	Rhône-Alpes	07	3	06	150	Mariac	660	17	677
82	Rhône-Alpes	07	3	15	151	Mars	276	7	283
82	Rhône-Alpes	07	3	24	152	Mauves	1174	21	1195
82	Rhône-Alpes	07	1	23	153	Mayres	267	4	271
82	Rhône-Alpes	07	1	12	154	Mazan-l;Abbaye	137	7	144
82	Rhône-Alpes	07	1	03	155	Mercuer	1165	27	1192
82	Rhône-Alpes	07	1	23	156	Meyras	846	24	870
82	Rhône-Alpes	07	2	14	157	Meysse	1380	37	1417
82	Rhône-Alpes	07	1	02	158	Mézilhac	102	2	104
82	Rhône-Alpes	07	1	29	159	Mirabel	444	14	458
82	Rhône-Alpes	07	3	32	160	Monestier	51	1	52
82	Rhône-Alpes	07	1	12	161	Montpezat-sous-Bauzon	807	34	841
82	Rhône-Alpes	07	1	11	162	Montréal	539	15	554
82	Rhône-Alpes	07	1	25	163	Montselgues	91	3	94
82	Rhône-Alpes	07	3	06	165	Nonières	213	2	215
82	Rhône-Alpes	07	3	10	166	Nozières	271	3	274
82	Rhône-Alpes	07	2	13	167	Les Ollières-sur-Eyrieux	935	24	959
82	Rhône-Alpes	07	1	26	168	Orgnac-l;Aven	534	18	552
82	Rhône-Alpes	07	3	24	169	Ozon	359	10	369
82	Rhône-Alpes	07	3	17	170	Pailharès	284	4	288
82	Rhône-Alpes	07	1	09	171	Payzac	525	10	535
82	Rhône-Alpes	07	3	22	172	Peaugres	1959	66	2025
82	Rhône-Alpes	07	1	05	173	Péreyres	51	1	52
82	Rhône-Alpes	07	3	22	174	Peyraud	524	5	529
82	Rhône-Alpes	07	1	16	175	Le Plagnal	61	0	61
82	Rhône-Alpes	07	1	09	176	Planzolles	137	1	138
82	Rhône-Alpes	07	3	24	177	Plats	793	13	806
82	Rhône-Alpes	07	1	23	178	Pont-de-Labeaume	568	4	572
82	Rhône-Alpes	07	2	13	179	Pourchères	140	3	143
82	Rhône-Alpes	07	2	07	181	Le Pouzin	2828	42	2870
82	Rhône-Alpes	07	1	23	182	Prades	1152	20	1172
82	Rhône-Alpes	07	1	26	183	Pradons	426	8	434
82	Rhône-Alpes	07	2	13	184	Pranles	468	13	481
82	Rhône-Alpes	07	3	21	185	Préaux	643	11	654
82	Rhône-Alpes	07	2	13	186	Privas	8369	385	8754
82	Rhône-Alpes	07	1	11	187	Prunet	137	5	142
82	Rhône-Alpes	07	3	21	188	Quintenas	1424	28	1452
82	Rhône-Alpes	07	1	09	189	Ribes	272	3	275
82	Rhône-Alpes	07	1	29	190	Rochecolombe	229	3	232
82	Rhône-Alpes	07	2	14	191	Rochemaure	2153	47	2200
82	Rhône-Alpes	07	3	15	192	Rochepaule	285	10	295
82	Rhône-Alpes	07	1	11	193	Rocher	279	3	282
82	Rhône-Alpes	07	2	07	194	Rochessauve	397	9	406
82	Rhône-Alpes	07	3	18	195	La Rochette	59	1	60
82	Rhône-Alpes	07	1	11	196	Rocles	241	8	249
82	Rhône-Alpes	07	3	32	197	Roiffieux	2758	93	2851
82	Rhône-Alpes	07	2	31	198	Rompon	979	39	1018
82	Rhône-Alpes	07	1	09	199	Rosières	1145	35	1180
82	Rhône-Alpes	07	1	12	200	Le Roux	43	1	44
82	Rhône-Alpes	07	1	26	201	Ruoms	2253	36	2289
82	Rhône-Alpes	07	1	09	202	Sablières	142	5	147
82	Rhône-Alpes	07	1	05	203	Sagnes-et-Goudoulet	130	2	132
82	Rhône-Alpes	07	3	15	204	Saint-Agrève	2534	52	2586
82	Rhône-Alpes	07	1	09	207	Saint-Alban-Auriolles	1005	33	1038
82	Rhône-Alpes	07	3	21	205	Saint-Alban-d;Ay	1332	35	1367
82	Rhône-Alpes	07	1	16	206	Saint-Alban-en-Montagne	78	1	79
82	Rhône-Alpes	07	1	29	208	Saint-Andéol-de-Berg	131	3	134
82	Rhône-Alpes	07	3	06	209	Saint-Andéol-de-Fourchades	54	3	57
82	Rhône-Alpes	07	1	02	210	Saint-Andéol-de-Vals	542	14	556
82	Rhône-Alpes	07	1	27	211	Saint-André-de-Cruzières	485	12	497
82	Rhône-Alpes	07	3	15	212	Saint-André-en-Vivarais	227	9	236
82	Rhône-Alpes	07	1	09	213	Saint-André-Lachamp	133	7	140
82	Rhône-Alpes	07	3	28	214	Saint-Apollinaire-de-Rias	164	3	167
82	Rhône-Alpes	07	3	10	216	Saint-Barthélemy-Grozon	497	28	525
82	Rhône-Alpes	07	3	06	215	Saint-Barthélemy-le-Meil	214	6	220
82	Rhône-Alpes	07	3	24	217	Saint-Barthélemy-le-Plain	795	14	809
82	Rhône-Alpes	07	3	10	218	Saint-Basile	326	4	330
82	Rhône-Alpes	07	2	07	219	Saint-Bauzile	270	13	283
82	Rhône-Alpes	07	3	06	220	Saint-Christol	111	4	115
82	Rhône-Alpes	07	2	31	221	Saint-Cierge-la-Serre	259	3	262
82	Rhône-Alpes	07	3	06	222	Saint-Cierge-sous-le-Cheylard	191	11	202
82	Rhône-Alpes	07	1	23	223	Saint-Cirgues-de-Prades	128	1	129
82	Rhône-Alpes	07	1	12	224	Saint-Cirgues-en-Montagne	246	10	256
82	Rhône-Alpes	07	3	01	225	Saint-Clair	1071	39	1110
82	Rhône-Alpes	07	3	18	226	Saint-Clément	110	3	113
82	Rhône-Alpes	07	3	01	227	Saint-Cyr	1288	23	1311
82	Rhône-Alpes	07	3	22	228	Saint-Désirat	809	27	836
82	Rhône-Alpes	07	1	03	229	Saint-Didier-sous-Aubenas	814	11	825
82	Rhône-Alpes	07	1	33	230	Saint-Étienne-de-Boulogne	365	8	373
82	Rhône-Alpes	07	1	03	231	Saint-Étienne-de-Fontbellon	2480	90	2570
82	Rhône-Alpes	07	1	16	232	Saint-Étienne-de-Lugdarès	445	6	451
82	Rhône-Alpes	07	2	20	233	Saint-Étienne-de-Serre	208	9	217
82	Rhône-Alpes	07	3	22	234	Saint-Étienne-de-Valoux	298	5	303
82	Rhône-Alpes	07	3	17	236	Saint-Félicien	1184	39	1223
82	Rhône-Alpes	07	2	31	237	Saint-Fortunat-sur-Eyrieux	727	16	743
82	Rhône-Alpes	07	1	09	238	Saint-Genest-de-Beauzon	265	6	271
82	Rhône-Alpes	07	3	06	239	Saint-Genest-Lachamp	99	2	101
82	Rhône-Alpes	07	2	31	240	Saint-Georges-les-Bains	2046	45	2091
82	Rhône-Alpes	07	1	29	241	Saint-Germain	635	15	650
82	Rhône-Alpes	07	1	29	242	Saint-Gineis-en-Coiron	102	3	105
82	Rhône-Alpes	07	3	22	243	Saint-Jacques-d;Atticieux	255	0	255
82	Rhône-Alpes	07	3	28	244	Saint-Jean-Chambre	253	10	263
82	Rhône-Alpes	07	3	24	245	Saint-Jean-de-Muzols	2436	68	2504
82	Rhône-Alpes	07	1	29	247	Saint-Jean-le-Centenier	673	7	680
82	Rhône-Alpes	07	3	18	248	Saint-Jean-Roure	266	1	267
82	Rhône-Alpes	07	3	15	249	Saint-Jeure-d;Andaure	97	1	98
82	Rhône-Alpes	07	3	21	250	Saint-Jeure-d;Ay	486	3	489
82	Rhône-Alpes	07	1	02	251	Saint-Joseph-des-Bancs	187	7	194
82	Rhône-Alpes	07	3	18	252	Saint-Julien-Boutières	209	5	214
82	Rhône-Alpes	07	2	20	253	Saint-Julien-du-Gua	160	2	162
82	Rhône-Alpes	07	1	33	254	Saint-Julien-du-Serre	823	14	837
82	Rhône-Alpes	07	2	07	255	Saint-Julien-en-Saint-Alban	1344	17	1361
82	Rhône-Alpes	07	3	06	256	Saint-Julien-Labrousse	356	8	364
82	Rhône-Alpes	07	3	28	257	Saint-Julien-le-Roux	92	3	95
82	Rhône-Alpes	07	3	32	258	Saint-Julien-Vocance	244	1	245
82	Rhône-Alpes	07	2	04	259	Saint-Just-d;Ardèche	1601	56	1657
82	Rhône-Alpes	07	2	07	260	Saint-Lager-Bressac	865	9	874
82	Rhône-Alpes	07	2	31	261	Saint-Laurent-du-Pape	1571	40	1611
82	Rhône-Alpes	07	1	16	262	Saint-Laurent-les-Bains	149	1	150
82	Rhône-Alpes	07	1	29	263	Saint-Laurent-sous-Coiron	110	3	113
82	Rhône-Alpes	07	2	04	264	Saint-Marcel-d;Ardèche	2403	95	2498
82	Rhône-Alpes	07	3	01	265	Saint-Marcel-lès-Annonay	1366	33	1399
82	Rhône-Alpes	07	3	18	267	Saint-Martial	245	6	251
82	Rhône-Alpes	07	2	04	268	Saint-Martin-d;Ardèche	906	20	926
82	Rhône-Alpes	07	3	18	269	Saint-Martin-de-Valamas	1264	20	1284
82	Rhône-Alpes	07	2	14	270	Saint-Martin-sur-Lavezon	448	8	456
82	Rhône-Alpes	07	1	29	272	Saint-Maurice-d;Ardèche	322	9	331
82	Rhône-Alpes	07	1	29	273	Saint-Maurice-d;Ibie	208	4	212
82	Rhône-Alpes	07	3	28	274	Saint-Maurice-en-Chalencon	197	5	202
82	Rhône-Alpes	07	1	25	275	Saint-Mélany	128	1	129
82	Rhône-Alpes	07	3	06	276	Saint-Michel-d;Aurance	255	11	266
82	Rhône-Alpes	07	1	33	277	Saint-Michel-de-Boulogne	146	11	157
82	Rhône-Alpes	07	2	31	278	Saint-Michel-de-Chabrillanoux	364	7	371
82	Rhône-Alpes	07	2	04	279	Saint-Montan	1804	49	1853
82	Rhône-Alpes	07	1	27	280	Saint-Paul-le-Jeune	871	19	890
82	Rhône-Alpes	07	3	19	281	Saint-Péray	7294	221	7515
82	Rhône-Alpes	07	1	05	282	Saint-Pierre-de-Colombier	410	64	474
82	Rhône-Alpes	07	2	14	283	Saint-Pierre-la-Roche	52	2	54
82	Rhône-Alpes	07	1	27	284	Saint-Pierre-Saint-Jean	146	3	149
82	Rhône-Alpes	07	3	21	285	Saint-Pierre-sur-Doux	105	1	106
82	Rhône-Alpes	07	2	20	286	Saint-Pierreville	543	10	553
82	Rhône-Alpes	07	1	29	287	Saint-Pons	264	13	277
82	Rhône-Alpes	07	2	13	288	Saint-Priest	1275	58	1333
82	Rhône-Alpes	07	1	33	289	Saint-Privat	1597	31	1628
82	Rhône-Alpes	07	3	10	290	Saint-Prix	253	12	265
82	Rhône-Alpes	07	2	04	291	Saint-Remèze	882	13	895
82	Rhône-Alpes	07	3	21	292	Saint-Romain-d;Ay	1022	20	1042
82	Rhône-Alpes	07	3	19	293	Saint-Romain-de-Lerps	734	22	756
82	Rhône-Alpes	07	1	27	294	Saint-Sauveur-de-Cruzières	529	15	544
82	Rhône-Alpes	07	2	20	295	Saint-Sauveur-de-Montagut	1139	44	1183
82	Rhône-Alpes	07	1	03	296	Saint-Sernin	1580	53	1633
82	Rhône-Alpes	07	3	19	297	Saint-Sylvestre	497	12	509
82	Rhône-Alpes	07	3	21	299	Saint-Symphorien-de-Mahun	134	10	144
82	Rhône-Alpes	07	2	07	298	Saint-Symphorien-sous-Chomérac	708	28	736
82	Rhône-Alpes	07	2	30	300	Saint-Thomé	400	7	407
82	Rhône-Alpes	07	3	17	301	Saint-Victor	949	15	964
82	Rhône-Alpes	07	2	14	302	Saint-Vincent-de-Barrès	807	25	832
82	Rhône-Alpes	07	2	13	303	Saint-Vincent-de-Durfort	244	3	247
82	Rhône-Alpes	07	1	05	235	Sainte-Eulalie	233	7	240
82	Rhône-Alpes	07	1	27	266	Sainte-Marguerite-Lafigère	79	1	80
82	Rhône-Alpes	07	1	26	304	Salavas	555	14	569
82	Rhône-Alpes	07	1	27	305	Les Salelles	319	15	334
82	Rhône-Alpes	07	1	26	306	Sampzon	228	3	231
82	Rhône-Alpes	07	1	11	307	Sanilhac	396	12	408
82	Rhône-Alpes	07	3	24	308	Sarras	2067	37	2104
82	Rhône-Alpes	07	3	21	309	Satillieu	1609	30	1639
82	Rhône-Alpes	07	3	22	310	Savas	817	24	841
82	Rhône-Alpes	07	2	14	311	Sceautres	146	3	149
82	Rhône-Alpes	07	3	24	312	Sécheras	489	8	497
82	Rhône-Alpes	07	3	22	313	Serrières	1132	9	1141
82	Rhône-Alpes	07	3	28	314	Silhac	353	15	368
82	Rhône-Alpes	07	1	23	315	La Souche	349	9	358
82	Rhône-Alpes	07	3	19	316	Soyons	1921	65	1986
82	Rhône-Alpes	07	3	32	317	Talencieux	995	25	1020
82	Rhône-Alpes	07	1	11	318	Tauriers	174	10	184
82	Rhône-Alpes	07	2	30	319	Le Teil	8010	262	8272
82	Rhône-Alpes	07	3	22	321	Thorrenc	235	9	244
82	Rhône-Alpes	07	1	23	322	Thueyts	1212	16	1228
82	Rhône-Alpes	07	3	19	323	Toulaud	1685	51	1736
82	Rhône-Alpes	07	3	24	324	Tournon-sur-Rhône	10676	611	11287
82	Rhône-Alpes	07	1	33	325	Ucel	1963	92	2055
82	Rhône-Alpes	07	1	12	326	Usclades-et-Rieutord	126	1	127
82	Rhône-Alpes	07	1	11	327	Uzer	435	10	445
82	Rhône-Alpes	07	1	26	328	Vagnas	524	11	535
82	Rhône-Alpes	07	1	25	329	Valgorge	472	6	478
82	Rhône-Alpes	07	1	26	330	Vallon-Pont-d;Arc	2328	89	2417
82	Rhône-Alpes	07	1	33	331	Vals-les-Bains	3649	83	3732
82	Rhône-Alpes	07	2	30	332	Valvignères	445	16	461
82	Rhône-Alpes	07	3	32	333	Vanosc	886	18	904
82	Rhône-Alpes	07	1	27	334	Les Vans	2816	59	2875
82	Rhône-Alpes	07	3	17	335	Vaudevant	204	3	207
82	Rhône-Alpes	07	1	09	336	Vernon	220	4	224
82	Rhône-Alpes	07	3	32	337	Vernosc-lès-Annonay	2287	53	2340
82	Rhône-Alpes	07	3	28	338	Vernoux-en-Vivarais	1886	113	1999
82	Rhône-Alpes	07	1	33	339	Vesseaux	1643	53	1696
82	Rhône-Alpes	07	2	13	340	Veyras	1539	77	1616
82	Rhône-Alpes	07	1	29	341	Villeneuve-de-Berg	2825	113	2938
82	Rhône-Alpes	07	3	32	342	Villevocance	1255	24	1279
82	Rhône-Alpes	07	1	11	343	Vinezac	1245	35	1280
82	Rhône-Alpes	07	3	22	344	Vinzieux	395	6	401
82	Rhône-Alpes	07	3	24	345	Vion	924	34	958
82	Rhône-Alpes	07	2	30	346	Viviers	3861	96	3957
82	Rhône-Alpes	07	3	32	347	Vocance	595	8	603
82	Rhône-Alpes	07	1	29	348	Vogüé	929	23	952
82	Rhône-Alpes	07	2	31	349	La Voulte-sur-Rhône	5064	69	5133
21	Champagne-Ardenne	08	2	23	001	Acy-Romance	441	5	446
21	Champagne-Ardenne	08	1	05	003	Aiglemont	1593	36	1629
21	Champagne-Ardenne	08	2	01	004	Aire	212	12	224
21	Champagne-Ardenne	08	2	13	005	Alincourt	142	2	144
21	Champagne-Ardenne	08	4	02	006	Alland;Huy-et-Sausseuil	253	1	254
21	Champagne-Ardenne	08	4	08	007	Les Alleux	85	0	85
21	Champagne-Ardenne	08	2	23	008	Amagne	704	15	719
21	Champagne-Ardenne	08	3	18	009	Amblimont	149	3	152
21	Champagne-Ardenne	08	2	23	010	Ambly-Fleury	133	8	141
21	Champagne-Ardenne	08	1	35	011	Anchamps	231	4	235
21	Champagne-Ardenne	08	3	21	013	Angecourt	371	9	380
21	Champagne-Ardenne	08	2	13	014	Annelles	139	8	147
21	Champagne-Ardenne	08	1	25	015	Antheny	103	2	105
21	Champagne-Ardenne	08	1	25	016	Aouste	198	15	213
21	Champagne-Ardenne	08	4	12	017	Apremont	129	3	132
21	Champagne-Ardenne	08	4	17	018	Ardeuil-et-Montfauxelles	85	1	86
21	Champagne-Ardenne	08	2	23	021	Arnicourt	164	8	172
21	Champagne-Ardenne	08	1	22	022	Arreux	364	20	384
21	Champagne-Ardenne	08	3	21	023	Artaise-le-Vivier	59	2	61
21	Champagne-Ardenne	08	2	01	024	Asfeld	1077	15	1092
21	Champagne-Ardenne	08	4	02	025	Attigny	1226	12	1238
21	Champagne-Ardenne	08	1	25	026	Aubigny-les-Pothées	349	10	359
21	Champagne-Ardenne	08	2	19	027	Auboncourt-Vauzelles	102	2	104
21	Champagne-Ardenne	08	1	11	028	Aubrives	868	23	891
21	Champagne-Ardenne	08	3	04	029	Auflance	85	3	88
21	Champagne-Ardenne	08	1	29	030	Auge	52	4	56
21	Champagne-Ardenne	08	4	17	031	Aure	49	0	49
21	Champagne-Ardenne	08	2	13	032	Aussonce	188	2	190
21	Champagne-Ardenne	08	4	08	033	Authe	92	3	95
21	Champagne-Ardenne	08	3	18	034	Autrecourt-et-Pourron	356	7	363
21	Champagne-Ardenne	08	4	08	035	Autruche	63	3	66
21	Champagne-Ardenne	08	4	17	036	Autry	140	1	141
21	Champagne-Ardenne	08	1	29	037	Auvillers-les-Forges	897	10	907
21	Champagne-Ardenne	08	2	06	038	Avançon	328	9	337
21	Champagne-Ardenne	08	2	01	039	Avaux	464	12	476
21	Champagne-Ardenne	08	1	09	040	Les Ayvelles	927	17	944
21	Champagne-Ardenne	08	1	20	041	Baâlons	213	10	223
21	Champagne-Ardenne	08	1	09	042	Balaives-et-Butz	241	4	245
21	Champagne-Ardenne	08	3	27	043	Balan	1616	54	1670
21	Champagne-Ardenne	08	2	01	044	Balham	135	2	137
21	Champagne-Ardenne	08	4	31	045	Ballay	248	2	250
21	Champagne-Ardenne	08	2	06	046	Banogne-Recouvrance	160	9	169
21	Champagne-Ardenne	08	4	03	049	Bar-lès-Buzancy	118	1	119
21	Champagne-Ardenne	08	1	28	047	Barbaise	105	1	106
21	Champagne-Ardenne	08	2	23	048	Barby	375	3	378
21	Champagne-Ardenne	08	4	03	052	Bayonville	103	4	107
21	Champagne-Ardenne	08	3	27	053	Bazeilles	1978	209	2187
21	Champagne-Ardenne	08	3	18	055	Beaumont-en-Argonne	465	8	473
21	Champagne-Ardenne	08	4	12	056	Beffu-et-le-Morthomme	74	0	74
21	Champagne-Ardenne	08	4	08	057	Belleville-et-Châtillon-sur-Bar	316	40	356
21	Champagne-Ardenne	08	1	15	058	Belval	245	6	251
21	Champagne-Ardenne	08	4	03	059	Belval-Bois-des-Dames	38	3	41
21	Champagne-Ardenne	08	2	01	060	Bergnicourt	203	6	209
21	Champagne-Ardenne	08	4	03	061	La Berlière	50	0	50
21	Champagne-Ardenne	08	2	23	062	Bertoncourt	135	6	141
21	Champagne-Ardenne	08	3	21	063	La Besace	110	8	118
21	Champagne-Ardenne	08	2	23	064	Biermes	273	4	277
21	Champagne-Ardenne	08	3	04	065	Bièvres	61	1	62
21	Champagne-Ardenne	08	2	13	066	Bignicourt	65	4	69
21	Champagne-Ardenne	08	3	04	067	Blagny	1197	29	1226
21	Champagne-Ardenne	08	1	25	069	Blanchefosse-et-Bay	155	1	156
21	Champagne-Ardenne	08	2	01	070	Blanzy-la-Salonnaise	335	4	339
21	Champagne-Ardenne	08	1	24	071	Blombay	121	2	123
21	Champagne-Ardenne	08	1	16	081	Bogny-sur-Meuse	5478	83	5561
21	Champagne-Ardenne	08	3	36	072	Bosseval-et-Briancourt	416	12	428
21	Champagne-Ardenne	08	1	25	073	Bossus-lès-Rumigny	102	0	102
21	Champagne-Ardenne	08	4	17	074	Bouconville	51	2	53
21	Champagne-Ardenne	08	4	08	075	Boult-aux-Bois	146	5	151
21	Champagne-Ardenne	08	1	09	076	Boulzicourt	938	25	963
21	Champagne-Ardenne	08	4	31	077	Bourcq	60	6	66
21	Champagne-Ardenne	08	1	24	078	Bourg-Fidèle	844	11	855
21	Champagne-Ardenne	08	1	09	079	Boutancourt	277	18	295
21	Champagne-Ardenne	08	1	20	080	Bouvellemont	95	2	97
21	Champagne-Ardenne	08	4	17	082	Brécy-Brières	77	10	87
21	Champagne-Ardenne	08	3	18	083	Brévilly	397	3	400
21	Champagne-Ardenne	08	2	01	084	Brienne-sur-Aisne	181	1	182
21	Champagne-Ardenne	08	4	08	085	Brieulles-sur-Bar	199	4	203
21	Champagne-Ardenne	08	4	03	086	Briquenay	129	3	132
21	Champagne-Ardenne	08	1	29	087	Brognon	150	3	153
21	Champagne-Ardenne	08	3	21	088	Bulson	139	3	142
21	Champagne-Ardenne	08	4	03	089	Buzancy	375	12	387
21	Champagne-Ardenne	08	3	04	090	Carignan	3107	67	3174
21	Champagne-Ardenne	08	4	14	092	Cauroy	183	4	187
21	Champagne-Ardenne	08	1	25	094	Cernion	57	0	57
21	Champagne-Ardenne	08	1	20	095	Chagny	176	3	179
21	Champagne-Ardenne	08	1	09	096	Chalandry-Elaire	579	22	601
21	Champagne-Ardenne	08	4	17	097	Challerange	465	8	473
21	Champagne-Ardenne	08	1	09	099	Champigneul-sur-Vence	136	1	137
21	Champagne-Ardenne	08	4	12	098	Champigneulle	58	6	64
21	Champagne-Ardenne	08	1	25	100	Champlin	77	1	78
21	Champagne-Ardenne	08	3	26	101	La Chapelle	160	7	167
21	Champagne-Ardenne	08	2	07	102	Chappes	94	5	99
21	Champagne-Ardenne	08	4	02	103	Charbogne	206	5	211
21	Champagne-Ardenne	08	4	14	104	Chardeny	43	0	43
21	Champagne-Ardenne	08	1	98	105	Charleville-Mézières	49810	1837	51647
21	Champagne-Ardenne	08	1	11	106	Charnois	86	0	86
21	Champagne-Ardenne	08	2	06	107	Château-Porcien	1401	20	1421
21	Champagne-Ardenne	08	4	12	109	Chatel-Chéhéry	161	3	164
21	Champagne-Ardenne	08	2	13	111	Le Châtelet-sur-Retourne	667	10	677
21	Champagne-Ardenne	08	1	24	110	Le Châtelet-sur-Sormonne	169	2	171
21	Champagne-Ardenne	08	2	07	113	Chaumont-Porcien	449	6	455
21	Champagne-Ardenne	08	3	36	114	Chéhéry	132	6	138
21	Champagne-Ardenne	08	3	21	115	Chémery-sur-Bar	436	11	447
21	Champagne-Ardenne	08	4	08	116	Le Chesne	988	59	1047
21	Champagne-Ardenne	08	2	19	117	Chesnois-Auboncourt	173	1	174
21	Champagne-Ardenne	08	3	36	119	Cheveuges	439	18	457
21	Champagne-Ardenne	08	4	12	120	Chevières	50	3	53
21	Champagne-Ardenne	08	1	24	121	Chilly	162	2	164
21	Champagne-Ardenne	08	1	11	122	Chooz	773	24	797
21	Champagne-Ardenne	08	4	02	123	Chuffilly-Roche	93	1	94
21	Champagne-Ardenne	08	1	28	124	Clavy-Warby	351	6	357
21	Champagne-Ardenne	08	1	22	125	Cliron	289	10	299
21	Champagne-Ardenne	08	4	17	128	Condé-lès-Autry	73	1	74
21	Champagne-Ardenne	08	2	06	126	Condé-lès-Herpy	201	2	203
21	Champagne-Ardenne	08	4	31	130	Contreuve	65	2	67
21	Champagne-Ardenne	08	4	12	131	Cornay	83	4	87
21	Champagne-Ardenne	08	2	19	132	Corny-Machéroménil	175	2	177
21	Champagne-Ardenne	08	2	23	133	Coucy	530	6	536
21	Champagne-Ardenne	08	4	02	134	Coulommes-et-Marqueny	92	2	94
21	Champagne-Ardenne	08	4	31	135	La Croix-aux-Bois	114	2	116
21	Champagne-Ardenne	08	3	27	136	Daigny	351	7	358
21	Champagne-Ardenne	08	1	32	137	Damouzy	412	34	446
21	Champagne-Ardenne	08	3	04	138	Les Deux-Villes	265	1	266
21	Champagne-Ardenne	08	1	16	139	Deville	1131	13	1144
21	Champagne-Ardenne	08	1	09	140	Dom-le-Mesnil	1074	21	1095
21	Champagne-Ardenne	08	1	28	141	Dommery	188	4	192
21	Champagne-Ardenne	08	3	36	142	Donchery	2369	38	2407
21	Champagne-Ardenne	08	2	07	143	Doumely-Bégny	95	1	96
21	Champagne-Ardenne	08	2	23	144	Doux	71	0	71
21	Champagne-Ardenne	08	3	18	145	Douzy	1845	31	1876
21	Champagne-Ardenne	08	2	07	146	Draize	102	0	102
21	Champagne-Ardenne	08	4	14	147	Dricourt	83	11	94
21	Champagne-Ardenne	08	2	01	148	L; Écaille	202	0	202
21	Champagne-Ardenne	08	1	25	149	L; Échelle	138	1	139
21	Champagne-Ardenne	08	2	06	150	Écly	199	11	210
21	Champagne-Ardenne	08	4	30	151	Écordal	293	2	295
21	Champagne-Ardenne	08	1	09	152	Élan	77	2	79
21	Champagne-Ardenne	08	3	27	153	Escombres-et-le-Chesnois	346	5	351
21	Champagne-Ardenne	08	1	25	154	Estrebay	75	2	77
21	Champagne-Ardenne	08	1	24	155	Étalle	95	3	98
21	Champagne-Ardenne	08	1	29	156	Éteignières	492	3	495
21	Champagne-Ardenne	08	1	09	158	Étrépigny	260	10	270
21	Champagne-Ardenne	08	3	18	159	Euilly-et-Lombut	108	2	110
21	Champagne-Ardenne	08	1	15	160	Évigny	206	12	218
21	Champagne-Ardenne	08	4	12	161	Exermont	36	1	37
21	Champagne-Ardenne	08	1	15	162	Fagnon	350	10	360
21	Champagne-Ardenne	08	2	19	163	Faissault	208	9	217
21	Champagne-Ardenne	08	4	31	164	Falaise	346	8	354
21	Champagne-Ardenne	08	2	19	165	Faux	56	0	56
21	Champagne-Ardenne	08	1	10	166	Fépin	280	7	287
21	Champagne-Ardenne	08	1	25	167	La Férée	85	0	85
21	Champagne-Ardenne	08	3	04	168	La Ferté-sur-Chiers	181	3	184
21	Champagne-Ardenne	08	1	25	169	Flaignes-Havys	114	7	121
21	Champagne-Ardenne	08	3	26	170	Fleigneux	203	12	215
21	Champagne-Ardenne	08	4	12	171	Fléville	98	6	104
21	Champagne-Ardenne	08	1	29	172	Fligny	189	2	191
21	Champagne-Ardenne	08	1	09	173	Flize	1158	30	1188
21	Champagne-Ardenne	08	3	26	174	Floing	2468	57	2525
21	Champagne-Ardenne	08	1	11	175	Foisches	235	8	243
21	Champagne-Ardenne	08	4	03	176	Fossé	55	0	55
21	Champagne-Ardenne	08	2	07	178	Fraillicourt	207	3	210
21	Champagne-Ardenne	08	3	27	179	Francheval	624	15	639
21	Champagne-Ardenne	08	1	33	180	La Francheville	1587	37	1624
21	Champagne-Ardenne	08	1	25	182	Le Fréty	67	2	69
21	Champagne-Ardenne	08	1	11	183	Fromelennes	1065	29	1094
21	Champagne-Ardenne	08	3	04	184	Fromy	81	3	84
21	Champagne-Ardenne	08	1	10	185	Fumay	3697	73	3770
21	Champagne-Ardenne	08	4	08	186	Germont	46	0	46
21	Champagne-Ardenne	08	1	37	187	Gernelle	347	11	358
21	Champagne-Ardenne	08	1	34	188	Gespunsart	1100	18	1118
21	Champagne-Ardenne	08	1	25	189	Girondelle	153	5	158
21	Champagne-Ardenne	08	1	11	190	Givet	6663	176	6839
21	Champagne-Ardenne	08	3	26	191	Givonne	1134	22	1156
21	Champagne-Ardenne	08	2	07	192	Givron	86	1	87
21	Champagne-Ardenne	08	4	02	193	Givry	243	5	248
21	Champagne-Ardenne	08	3	26	194	Glaire	933	39	972
21	Champagne-Ardenne	08	2	01	195	Gomont	342	5	347
21	Champagne-Ardenne	08	2	19	196	Grandchamp	95	4	99
21	Champagne-Ardenne	08	4	08	019	Les Grandes-Armoises	54	1	55
21	Champagne-Ardenne	08	4	12	197	Grandham	57	2	59
21	Champagne-Ardenne	08	4	12	198	Grandpré	456	23	479
21	Champagne-Ardenne	08	1	37	199	La Grandville	818	10	828
21	Champagne-Ardenne	08	4	31	200	Grivy-Loisy	178	5	183
21	Champagne-Ardenne	08	1	28	201	Gruyères	72	1	73
21	Champagne-Ardenne	08	1	24	202	Gué-d;Hossus	526	1	527
21	Champagne-Ardenne	08	1	09	203	Guignicourt-sur-Vence	295	10	305
21	Champagne-Ardenne	08	4	30	204	Guincourt	96	2	98
21	Champagne-Ardenne	08	2	19	205	Hagnicourt	71	2	73
21	Champagne-Ardenne	08	1	22	206	Ham-les-Moines	376	5	381
21	Champagne-Ardenne	08	1	11	207	Ham-sur-Meuse	252	4	256
21	Champagne-Ardenne	08	1	25	208	Hannappes	156	0	156
21	Champagne-Ardenne	08	1	09	209	Hannogne-Saint-Martin	466	10	476
21	Champagne-Ardenne	08	2	06	210	Hannogne-Saint-Rémy	115	5	120
21	Champagne-Ardenne	08	3	21	211	Haraucourt	753	16	769
21	Champagne-Ardenne	08	1	22	212	Harcy	504	4	508
21	Champagne-Ardenne	08	1	10	214	Hargnies	487	16	503
21	Champagne-Ardenne	08	4	03	215	Harricourt	45	1	46
21	Champagne-Ardenne	08	1	22	216	Haudrecy	297	7	304
21	Champagne-Ardenne	08	1	16	217	Haulmé	110	2	112
21	Champagne-Ardenne	08	1	16	218	Les Hautes-Rivières	1647	35	1682
21	Champagne-Ardenne	08	2	06	219	Hauteville	111	3	114
21	Champagne-Ardenne	08	4	14	220	Hauviné	303	12	315
21	Champagne-Ardenne	08	1	10	222	Haybes	2051	55	2106
21	Champagne-Ardenne	08	3	04	223	Herbeuval	94	2	96
21	Champagne-Ardenne	08	2	06	225	Herpy-l;Arlésienne	207	5	212
21	Champagne-Ardenne	08	1	11	226	Hierges	217	6	223
21	Champagne-Ardenne	08	1	20	228	La Horgne	190	4	194
21	Champagne-Ardenne	08	2	01	229	Houdilcourt	146	0	146
21	Champagne-Ardenne	08	1	32	230	Houldizy	342	14	356
21	Champagne-Ardenne	08	3	26	232	Illy	404	8	412
21	Champagne-Ardenne	08	4	03	233	Imécourt	57	2	59
21	Champagne-Ardenne	08	2	06	234	Inaumont	81	1	82
21	Champagne-Ardenne	08	1	37	235	Issancourt-et-Rumel	411	18	429
21	Champagne-Ardenne	08	1	28	236	Jandun	287	8	295
21	Champagne-Ardenne	08	1	34	237	Joigny-sur-Meuse	700	20	720
21	Champagne-Ardenne	08	4	30	238	Jonval	84	1	85
21	Champagne-Ardenne	08	2	13	239	Juniville	1211	33	1244
21	Champagne-Ardenne	08	2	19	240	Justine-Herbigny	168	5	173
21	Champagne-Ardenne	08	1	16	242	Laifour	514	6	520
21	Champagne-Ardenne	08	1	28	243	Lalobbe	185	9	194
21	Champagne-Ardenne	08	4	30	244	Lametz	80	1	81
21	Champagne-Ardenne	08	4	03	246	Landres-et-Saint-Georges	103	4	107
21	Champagne-Ardenne	08	1	11	247	Landrichamps	140	4	144
21	Champagne-Ardenne	08	4	12	245	Lançon	38	5	43
21	Champagne-Ardenne	08	1	28	248	Launois-sur-Vence	651	48	699
21	Champagne-Ardenne	08	1	24	249	Laval-Morency	245	7	252
21	Champagne-Ardenne	08	4	14	250	Leffincourt	177	2	179
21	Champagne-Ardenne	08	1	25	251	Lépron-les-Vallées	91	0	91
21	Champagne-Ardenne	08	3	18	252	Létanne	142	3	145
21	Champagne-Ardenne	08	1	25	254	Liart	537	10	547
21	Champagne-Ardenne	08	3	04	255	Linay	243	2	245
21	Champagne-Ardenne	08	4	17	256	Liry	107	2	109
21	Champagne-Ardenne	08	1	25	257	Logny-Bogny	192	0	192
21	Champagne-Ardenne	08	4	31	259	Longwé	89	2	91
21	Champagne-Ardenne	08	1	22	260	Lonny	590	15	605
21	Champagne-Ardenne	08	4	08	261	Louvergny	80	4	84
21	Champagne-Ardenne	08	2	19	262	Lucquy	570	29	599
21	Champagne-Ardenne	08	1	37	263	Lumes	1138	43	1181
21	Champagne-Ardenne	08	4	14	264	Machault	505	16	521
21	Champagne-Ardenne	08	3	18	267	Mairy	258	3	261
21	Champagne-Ardenne	08	3	21	268	Maisoncelle-et-Villers	73	2	75
21	Champagne-Ardenne	08	3	04	269	Malandry	67	1	68
21	Champagne-Ardenne	08	4	17	271	Manre	106	1	107
21	Champagne-Ardenne	08	1	28	272	Maranwez	46	2	48
21	Champagne-Ardenne	08	1	25	273	Marby	66	3	69
21	Champagne-Ardenne	08	4	12	274	Marcq	106	6	112
21	Champagne-Ardenne	08	3	04	275	Margny	178	7	185
21	Champagne-Ardenne	08	3	04	276	Margut	789	21	810
21	Champagne-Ardenne	08	1	25	277	Marlemont	147	0	147
21	Champagne-Ardenne	08	4	30	278	Marquigny	73	0	73
21	Champagne-Ardenne	08	4	31	279	Mars-sous-Bourcq	55	1	56
21	Champagne-Ardenne	08	4	17	280	Marvaux-Vieux	70	1	71
21	Champagne-Ardenne	08	3	04	281	Matton-et-Clémency	462	11	473
21	Champagne-Ardenne	08	1	24	282	Maubert-Fontaine	1060	74	1134
21	Champagne-Ardenne	08	1	20	283	Mazerny	120	1	121
21	Champagne-Ardenne	08	1	22	284	Les Mazures	945	19	964
21	Champagne-Ardenne	08	2	13	286	Ménil-Annelles	96	4	100
21	Champagne-Ardenne	08	2	13	287	Ménil-Lépinois	127	2	129
21	Champagne-Ardenne	08	2	19	288	Mesmont	101	6	107
21	Champagne-Ardenne	08	3	04	289	Messincourt	610	11	621
21	Champagne-Ardenne	08	3	04	291	Mogues	154	2	156
21	Champagne-Ardenne	08	3	04	293	Moiry	191	2	193
21	Champagne-Ardenne	08	3	27	294	La Moncelle	135	1	136
21	Champagne-Ardenne	08	1	09	295	Mondigny	181	8	189
21	Champagne-Ardenne	08	3	21	300	Le Mont-Dieu	20	6	26
21	Champagne-Ardenne	08	2	23	306	Mont-Laurent	69	0	69
21	Champagne-Ardenne	08	4	17	308	Mont-Saint-Martin	84	1	85
21	Champagne-Ardenne	08	4	14	309	Mont-Saint-Remy	55	1	56
21	Champagne-Ardenne	08	4	17	296	Montcheutin	146	3	149
21	Champagne-Ardenne	08	1	22	297	Montcornet	326	9	335
21	Champagne-Ardenne	08	1	05	298	Montcy-Notre-Dame	1562	61	1623
21	Champagne-Ardenne	08	4	08	301	Montgon	69	4	73
21	Champagne-Ardenne	08	1	16	302	Monthermé	2459	87	2546
21	Champagne-Ardenne	08	4	17	303	Monthois	386	14	400
21	Champagne-Ardenne	08	1	10	304	Montigny-sur-Meuse	97	3	100
21	Champagne-Ardenne	08	1	20	305	Montigny-sur-Vence	223	1	224
21	Champagne-Ardenne	08	2	07	307	Montmeillant	94	8	102
21	Champagne-Ardenne	08	4	12	310	Mouron	81	5	86
21	Champagne-Ardenne	08	3	18	311	Mouzon	2303	80	2383
21	Champagne-Ardenne	08	1	22	312	Murtin-et-Bogny	180	6	186
21	Champagne-Ardenne	08	2	23	313	Nanteuil-sur-Aisne	118	5	123
21	Champagne-Ardenne	08	2	13	314	Neuflize	728	12	740
21	Champagne-Ardenne	08	1	28	315	Neufmaison	58	2	60
21	Champagne-Ardenne	08	1	34	316	Neufmanil	1172	21	1193
21	Champagne-Ardenne	08	3	21	317	La Neuville-à-Maire	108	2	110
21	Champagne-Ardenne	08	1	29	318	La Neuville-aux-Joûtes	353	14	367
21	Champagne-Ardenne	08	4	30	321	Neuville-Day	171	17	188
21	Champagne-Ardenne	08	2	13	320	La Neuville-en-Tourne-à-Fuy	542	9	551
21	Champagne-Ardenne	08	1	15	322	Neuville-lès-This	384	9	393
21	Champagne-Ardenne	08	2	19	323	La Neuville-lès-Wasigny	165	1	166
21	Champagne-Ardenne	08	1	29	319	Neuville-lez-Beaulieu	345	4	349
21	Champagne-Ardenne	08	2	19	324	Neuvizy	112	3	115
21	Champagne-Ardenne	08	4	08	325	Noirval	34	0	34
21	Champagne-Ardenne	08	4	03	326	Nouart	143	1	144
21	Champagne-Ardenne	08	1	09	327	Nouvion-sur-Meuse	2289	61	2350
21	Champagne-Ardenne	08	1	34	328	Nouzonville	6318	116	6434
21	Champagne-Ardenne	08	2	19	329	Novion-Porcien	502	14	516
21	Champagne-Ardenne	08	2	23	330	Novy-Chevrières	652	19	671
21	Champagne-Ardenne	08	3	36	331	Noyers-Pont-Maugis	735	15	750
21	Champagne-Ardenne	08	4	03	332	Oches	38	2	40
21	Champagne-Ardenne	08	4	12	333	Olizy-Primat	219	6	225
21	Champagne-Ardenne	08	1	09	334	Omicourt	44	2	46
21	Champagne-Ardenne	08	1	20	335	Omont	86	2	88
21	Champagne-Ardenne	08	3	04	336	Osnes	236	2	238
21	Champagne-Ardenne	08	4	14	338	Pauvres	187	4	191
21	Champagne-Ardenne	08	2	13	339	Perthes	302	16	318
21	Champagne-Ardenne	08	4	08	020	Les Petites-Armoises	63	1	64
21	Champagne-Ardenne	08	2	01	340	Poilcourt-Sydney	180	2	182
21	Champagne-Ardenne	08	1	20	341	Poix-Terron	852	28	880
21	Champagne-Ardenne	08	3	27	342	Pouru-aux-Bois	290	4	294
21	Champagne-Ardenne	08	3	27	343	Pouru-Saint-Remy	1263	30	1293
21	Champagne-Ardenne	08	1	25	344	Prez	146	5	151
21	Champagne-Ardenne	08	1	15	346	Prix-lès-Mézières	1367	32	1399
21	Champagne-Ardenne	08	3	04	347	Puilly-et-Charbeaux	258	13	271
21	Champagne-Ardenne	08	2	19	348	Puiseux	108	3	111
21	Champagne-Ardenne	08	3	04	349	Pure	643	6	649
21	Champagne-Ardenne	08	4	31	350	Quatre-Champs	187	8	195
21	Champagne-Ardenne	08	4	14	351	Quilly	84	3	87
21	Champagne-Ardenne	08	1	28	352	Raillicourt	221	5	226
21	Champagne-Ardenne	08	1	11	353	Rancennes	721	21	742
21	Champagne-Ardenne	08	3	21	354	Raucourt-et-Flaba	855	13	868
21	Champagne-Ardenne	08	1	24	355	Regniowez	387	16	403
21	Champagne-Ardenne	08	2	07	356	Remaucourt	154	3	157
21	Champagne-Ardenne	08	3	21	357	Remilly-Aillicourt	804	37	841
21	Champagne-Ardenne	08	1	22	358	Remilly-les-Pothées	253	3	256
21	Champagne-Ardenne	08	2	07	360	Renneville	203	5	208
21	Champagne-Ardenne	08	1	22	361	Renwez	1745	37	1782
21	Champagne-Ardenne	08	2	23	362	Rethel	7716	435	8151
21	Champagne-Ardenne	08	1	35	363	Revin	7214	190	7404
21	Champagne-Ardenne	08	4	02	364	Rilly-sur-Aisne	111	5	116
21	Champagne-Ardenne	08	1	24	365	Rimogne	1423	27	1450
21	Champagne-Ardenne	08	2	07	366	Rocquigny	717	11	728
21	Champagne-Ardenne	08	1	24	367	Rocroi	2408	46	2454
21	Champagne-Ardenne	08	2	01	368	Roizy	250	7	257
21	Champagne-Ardenne	08	2	07	369	La Romagne	132	1	133
21	Champagne-Ardenne	08	1	25	370	Rouvroy-sur-Audry	570	10	580
21	Champagne-Ardenne	08	3	27	371	Rubécourt-et-Lamécourt	149	4	153
21	Champagne-Ardenne	08	2	07	372	Rubigny	76	1	77
21	Champagne-Ardenne	08	1	25	373	Rumigny	383	4	387
21	Champagne-Ardenne	08	4	30	374	La Sabotterie	75	1	76
21	Champagne-Ardenne	08	3	04	375	Sachy	177	6	183
21	Champagne-Ardenne	08	3	04	376	Sailly	246	5	251
21	Champagne-Ardenne	08	3	36	377	Saint-Aignan	139	5	144
21	Champagne-Ardenne	08	4	14	378	Saint-Clément-à-Arnes	102	4	106
21	Champagne-Ardenne	08	4	14	379	Saint-Étienne-à-Arnes	219	4	223
21	Champagne-Ardenne	08	2	06	380	Saint-Fergeux	206	7	213
21	Champagne-Ardenne	08	2	01	381	Saint-Germainmont	809	11	820
21	Champagne-Ardenne	08	2	07	382	Saint-Jean-aux-Bois	141	1	142
21	Champagne-Ardenne	08	4	12	383	Saint-Juvin	112	6	118
21	Champagne-Ardenne	08	4	02	384	Saint-Lambert-et-Mont-de-Jeux	174	2	176
21	Champagne-Ardenne	08	1	37	385	Saint-Laurent	1209	158	1367
21	Champagne-Ardenne	08	2	06	386	Saint-Loup-en-Champagne	243	7	250
21	Champagne-Ardenne	08	4	30	387	Saint-Loup-Terrier	167	7	174
21	Champagne-Ardenne	08	1	09	388	Saint-Marceau	365	16	381
21	Champagne-Ardenne	08	1	22	389	Saint-Marcel	319	10	329
21	Champagne-Ardenne	08	3	36	391	Saint-Menges	1058	17	1075
21	Champagne-Ardenne	08	4	17	392	Saint-Morel	236	7	243
21	Champagne-Ardenne	08	4	14	393	Saint-Pierre-à-Arnes	65	1	66
21	Champagne-Ardenne	08	1	09	395	Saint-Pierre-sur-Vence	148	5	153
21	Champagne-Ardenne	08	4	03	394	Saint-Pierremont	91	8	99
21	Champagne-Ardenne	08	2	06	396	Saint-Quentin-le-Petit	147	9	156
21	Champagne-Ardenne	08	2	01	397	Saint-Remy-le-Petit	54	2	56
21	Champagne-Ardenne	08	4	31	390	Sainte-Marie	88	0	88
21	Champagne-Ardenne	08	4	02	398	Sainte-Vaubourg	94	1	95
21	Champagne-Ardenne	08	1	09	400	Sapogne-et-Feuchères	516	11	527
21	Champagne-Ardenne	08	3	04	399	Sapogne-sur-Marche	146	3	149
21	Champagne-Ardenne	08	4	02	401	Saulces-Champenoises	206	3	209
21	Champagne-Ardenne	08	2	19	402	Saulces-Monclin	677	16	693
21	Champagne-Ardenne	08	2	23	403	Sault-lès-Rethel	1882	33	1915
21	Champagne-Ardenne	08	2	01	404	Sault-Saint-Remy	171	2	173
21	Champagne-Ardenne	08	4	08	405	Sauville	270	6	276
21	Champagne-Ardenne	08	4	17	406	Savigny-sur-Aisne	366	21	387
21	Champagne-Ardenne	08	4	17	407	Séchault	67	3	70
21	Champagne-Ardenne	08	1	22	408	Sécheval	507	11	518
21	Champagne-Ardenne	08	3	99	409	Sedan	18577	522	19099
21	Champagne-Ardenne	08	4	14	410	Semide	206	19	225
21	Champagne-Ardenne	08	4	02	411	Semuy	87	2	89
21	Champagne-Ardenne	08	4	12	412	Senuc	149	10	159
21	Champagne-Ardenne	08	2	06	413	Seraincourt	242	8	250
21	Champagne-Ardenne	08	2	19	415	Sery	344	3	347
21	Champagne-Ardenne	08	2	23	416	Seuil	159	6	165
21	Champagne-Ardenne	08	1	24	417	Sévigny-la-Forêt	259	11	270
21	Champagne-Ardenne	08	2	06	418	Sévigny-Waleppe	250	3	253
21	Champagne-Ardenne	08	1	28	419	Signy-l;Abbaye	1358	35	1393
21	Champagne-Ardenne	08	1	29	420	Signy-le-Petit	1302	30	1332
21	Champagne-Ardenne	08	3	04	421	Signy-Montlibert	78	4	82
21	Champagne-Ardenne	08	1	20	422	Singly	125	6	131
21	Champagne-Ardenne	08	4	03	424	Sommauthe	119	3	122
21	Champagne-Ardenne	08	4	12	425	Sommerance	45	2	47
21	Champagne-Ardenne	08	2	06	426	Son	96	1	97
21	Champagne-Ardenne	08	2	23	427	Sorbon	203	9	212
21	Champagne-Ardenne	08	2	19	428	Sorcy-Bauthémont	143	4	147
21	Champagne-Ardenne	08	1	22	429	Sormonne	564	15	579
21	Champagne-Ardenne	08	3	21	430	Stonne	49	1	50
21	Champagne-Ardenne	08	4	17	431	Sugny	105	4	109
21	Champagne-Ardenne	08	1	15	432	Sury	97	4	101
21	Champagne-Ardenne	08	4	30	433	Suzanne	70	1	71
21	Champagne-Ardenne	08	4	08	434	Sy	48	4	52
21	Champagne-Ardenne	08	2	13	435	Tagnon	939	23	962
21	Champagne-Ardenne	08	1	24	436	Taillette	374	6	380
21	Champagne-Ardenne	08	4	03	437	Tailly	175	6	181
21	Champagne-Ardenne	08	2	06	438	Taizy	108	1	109
21	Champagne-Ardenne	08	4	08	439	Tannay	159	6	165
21	Champagne-Ardenne	08	1	29	440	Tarzy	141	1	142
21	Champagne-Ardenne	08	4	12	441	Termes	138	1	139
21	Champagne-Ardenne	08	4	31	443	Terron-sur-Aisne	116	3	119
21	Champagne-Ardenne	08	3	18	444	Tétaigne	81	7	88
21	Champagne-Ardenne	08	3	36	445	Thelonne	364	8	372
21	Champagne-Ardenne	08	4	03	446	Thénorgues	105	1	106
21	Champagne-Ardenne	08	1	16	448	Thilay	1053	22	1075
21	Champagne-Ardenne	08	1	28	449	Thin-le-Moutier	557	16	573
21	Champagne-Ardenne	08	1	15	450	This	213	7	220
21	Champagne-Ardenne	08	2	01	451	Le Thour	329	3	332
21	Champagne-Ardenne	08	2	23	452	Thugny-Trugny	232	2	234
21	Champagne-Ardenne	08	4	31	453	Toges	94	1	95
21	Champagne-Ardenne	08	1	20	454	Touligny	75	0	75
21	Champagne-Ardenne	08	4	14	455	Tourcelles-Chaumont	95	1	96
21	Champagne-Ardenne	08	1	16	456	Tournavaux	172	7	179
21	Champagne-Ardenne	08	1	22	457	Tournes	1014	42	1056
21	Champagne-Ardenne	08	4	30	458	Tourteron	177	5	182
21	Champagne-Ardenne	08	3	04	459	Tremblois-lès-Carignan	114	0	114
21	Champagne-Ardenne	08	1	24	460	Tremblois-lès-Rocroi	160	0	160
21	Champagne-Ardenne	08	4	31	461	Vandy	172	7	179
21	Champagne-Ardenne	08	4	02	462	Vaux-Champagne	132	4	136
21	Champagne-Ardenne	08	4	03	463	Vaux-en-Dieulet	69	0	69
21	Champagne-Ardenne	08	4	17	464	Vaux-lès-Mouron	84	1	85
21	Champagne-Ardenne	08	3	18	466	Vaux-lès-Mouzon	84	3	87
21	Champagne-Ardenne	08	2	07	465	Vaux-lès-Rubigny	46	1	47
21	Champagne-Ardenne	08	2	19	467	Vaux-Montreuil	108	4	112
21	Champagne-Ardenne	08	1	25	468	Vaux-Villaine	192	3	195
21	Champagne-Ardenne	08	1	20	469	Vendresse	494	8	502
21	Champagne-Ardenne	08	4	03	470	Verpel	81	3	84
21	Champagne-Ardenne	08	4	08	471	Verrières	33	1	34
21	Champagne-Ardenne	08	2	19	472	Viel-Saint-Remy	241	4	245
21	Champagne-Ardenne	08	2	01	473	Vieux-lès-Asfeld	257	8	265
21	Champagne-Ardenne	08	1	37	483	Ville-sur-Lumes	495	18	513
21	Champagne-Ardenne	08	2	13	484	Ville-sur-Retourne	76	6	82
21	Champagne-Ardenne	08	3	27	475	Villers-Cernay	328	6	334
21	Champagne-Ardenne	08	2	01	476	Villers-devant-le-Thour	390	5	395
21	Champagne-Ardenne	08	3	18	477	Villers-devant-Mouzon	105	0	105
21	Champagne-Ardenne	08	1	09	478	Villers-le-Tilleul	261	3	264
21	Champagne-Ardenne	08	2	19	479	Villers-le-Tourneur	178	1	179
21	Champagne-Ardenne	08	1	37	480	Villers-Semeuse	3405	106	3511
21	Champagne-Ardenne	08	3	36	481	Villers-sur-Bar	249	12	261
21	Champagne-Ardenne	08	1	09	482	Villers-sur-le-Mont	95	3	98
21	Champagne-Ardenne	08	3	04	485	Villy	183	7	190
21	Champagne-Ardenne	08	1	11	486	Vireux-Molhain	1680	37	1717
21	Champagne-Ardenne	08	1	11	487	Vireux-Wallerand	1933	45	1978
21	Champagne-Ardenne	08	1	37	488	Vivier-au-Court	3321	144	3465
21	Champagne-Ardenne	08	4	02	489	Voncq	227	5	232
21	Champagne-Ardenne	08	4	31	490	Vouziers	4141	208	4349
21	Champagne-Ardenne	08	3	36	491	Vrigne-aux-Bois	3433	72	3505
21	Champagne-Ardenne	08	1	09	492	Vrigne-Meuse	261	4	265
21	Champagne-Ardenne	08	4	31	493	Vrizy	341	14	355
21	Champagne-Ardenne	08	3	36	494	Wadelincourt	524	9	533
21	Champagne-Ardenne	08	2	19	496	Wagnon	113	4	117
21	Champagne-Ardenne	08	1	15	497	Warcq	1312	33	1345
21	Champagne-Ardenne	08	1	15	498	Warnécourt	378	13	391
21	Champagne-Ardenne	08	2	19	499	Wasigny	358	10	368
21	Champagne-Ardenne	08	2	19	500	Wignicourt	67	3	70
21	Champagne-Ardenne	08	3	04	501	Williers	48	0	48
21	Champagne-Ardenne	08	3	18	502	Yoncq	94	0	94
21	Champagne-Ardenne	08	1	09	503	Yvernaumont	134	2	136
73	Midi-Pyrénées	09	1	02	001	Aigues-Juntes	44	0	44
73	Midi-Pyrénées	09	2	10	002	Aigues-Vives	577	11	588
73	Midi-Pyrénées	09	1	07	003	L; Aiguillon	392	5	397
73	Midi-Pyrénées	09	1	03	004	Albiès	134	1	135
73	Midi-Pyrénées	09	3	09	005	Aleu	152	0	152
73	Midi-Pyrénées	09	1	18	006	Alliat	61	0	61
73	Midi-Pyrénées	09	1	02	007	Allières	61	3	64
73	Midi-Pyrénées	09	3	15	008	Alos	130	3	133
73	Midi-Pyrénées	09	1	02	009	Alzen	221	19	240
73	Midi-Pyrénées	09	3	04	011	Antras	62	1	63
73	Midi-Pyrénées	09	1	03	012	Appy	28	0	28
73	Midi-Pyrénées	09	1	21	013	Arabaux	59	2	61
73	Midi-Pyrénées	09	3	04	014	Argein	177	4	181
73	Midi-Pyrénées	09	1	18	015	Arignac	712	12	724
73	Midi-Pyrénées	09	1	18	016	Arnave	217	4	221
73	Midi-Pyrénées	09	3	04	017	Arrien-en-Bethmale	101	1	102
73	Midi-Pyrénées	09	3	04	018	Arrout	75	3	78
73	Midi-Pyrénées	09	2	06	019	Artigat	566	13	579
73	Midi-Pyrénées	09	1	13	020	Artigues	50	3	53
73	Midi-Pyrénées	09	2	19	021	Artix	118	1	119
73	Midi-Pyrénées	09	2	22	022	Arvigna	215	3	218
73	Midi-Pyrénées	09	1	01	023	Ascou	139	3	142
73	Midi-Pyrénées	09	1	03	024	Aston	218	9	227
73	Midi-Pyrénées	09	3	04	025	Aucazein	64	0	64
73	Midi-Pyrénées	09	3	04	026	Audressein	116	2	118
73	Midi-Pyrénées	09	3	04	027	Augirein	64	2	66
73	Midi-Pyrénées	09	1	03	028	Aulos	55	0	55
73	Midi-Pyrénées	09	3	11	029	Aulus-les-Bains	237	0	237
73	Midi-Pyrénées	09	1	20	030	Auzat	582	9	591
73	Midi-Pyrénées	09	1	01	032	Ax-les-Thermes	1363	78	1441
73	Midi-Pyrénées	09	1	03	031	Axiat	24	2	26
73	Midi-Pyrénées	09	3	14	033	Bagert	59	2	61
73	Midi-Pyrénées	09	3	04	034	Balacet	20	0	20
73	Midi-Pyrénées	09	3	04	035	Balaguères	199	9	208
73	Midi-Pyrénées	09	3	14	037	Barjac	36	3	39
73	Midi-Pyrénées	09	2	08	038	La Bastide-de-Besplas	390	7	397
73	Midi-Pyrénées	09	2	10	039	La Bastide-de-Bousignac	339	7	346
73	Midi-Pyrénées	09	2	17	040	La Bastide-de-Lordat	264	6	270
73	Midi-Pyrénées	09	1	02	042	La Bastide-de-Sérou	958	20	978
73	Midi-Pyrénées	09	3	16	041	La Bastide-du-Salat	204	3	207
73	Midi-Pyrénées	09	2	10	043	La Bastide-sur-l;Hers	724	23	747
73	Midi-Pyrénées	09	1	21	044	Baulou	160	3	163
73	Midi-Pyrénées	09	1	18	045	Bédeilhac-et-Aynat	203	1	204
73	Midi-Pyrénées	09	3	14	046	Bédeille	82	2	84
73	Midi-Pyrénées	09	1	07	047	Bélesta	1102	26	1128
73	Midi-Pyrénées	09	2	10	048	Belloc	65	2	67
73	Midi-Pyrénées	09	1	21	049	Bénac	172	5	177
73	Midi-Pyrénées	09	2	12	050	Benagues	456	9	465
73	Midi-Pyrénées	09	1	07	051	Bénaix	155	6	161
73	Midi-Pyrénées	09	2	10	052	Besset	145	3	148
73	Midi-Pyrénées	09	1	03	053	Bestiac	19	1	20
73	Midi-Pyrénées	09	3	16	054	Betchat	364	9	373
73	Midi-Pyrénées	09	3	04	055	Bethmale	98	0	98
73	Midi-Pyrénées	09	2	12	056	Bézac	303	9	312
73	Midi-Pyrénées	09	3	09	057	Biert	294	8	302
73	Midi-Pyrénées	09	1	18	058	Bompas	204	10	214
73	Midi-Pyrénées	09	3	04	059	Bonac-Irazein	135	6	141
73	Midi-Pyrénées	09	2	22	060	Bonnac	722	29	751
73	Midi-Pyrénées	09	2	08	061	Les Bordes-sur-Arize	517	10	527
73	Midi-Pyrénées	09	3	04	062	Les Bordes-sur-Lez	170	7	177
73	Midi-Pyrénées	09	1	21	063	Le Bosc	112	1	113
73	Midi-Pyrénées	09	1	03	064	Bouan	37	1	38
73	Midi-Pyrénées	09	3	09	065	Boussenac	192	12	204
73	Midi-Pyrénées	09	1	21	066	Brassac	638	63	701
73	Midi-Pyrénées	09	2	17	067	Brie	191	5	196
73	Midi-Pyrénées	09	1	21	068	Burret	42	0	42
73	Midi-Pyrénées	09	3	04	069	Buzan	24	0	24
73	Midi-Pyrénées	09	1	03	070	Les Cabannes	351	6	357
73	Midi-Pyrénées	09	1	02	071	Cadarcet	236	8	244
73	Midi-Pyrénées	09	2	19	072	Calzan	26	0	26
73	Midi-Pyrénées	09	2	08	073	Camarade	180	3	183
73	Midi-Pyrénées	09	2	10	074	Camon	166	3	169
73	Midi-Pyrénées	09	2	08	075	Campagne-sur-Arize	268	8	276
73	Midi-Pyrénées	09	2	17	076	Canté	207	2	209
73	Midi-Pyrénées	09	1	18	077	Capoulet-et-Junac	184	6	190
73	Midi-Pyrénées	09	1	13	078	Carcanières	72	0	72
73	Midi-Pyrénées	09	2	06	079	Carla-Bayle	770	18	788
73	Midi-Pyrénées	09	1	07	080	Carla-de-Roquefort	153	1	154
73	Midi-Pyrénées	09	2	22	081	Le Carlaret	235	3	238
73	Midi-Pyrénées	09	3	15	082	Castelnau-Durban	420	14	434
73	Midi-Pyrénées	09	2	06	083	Castéras	31	0	31
73	Midi-Pyrénées	09	2	08	084	Castex	95	3	98
73	Midi-Pyrénées	09	3	04	085	Castillon-en-Couserans	416	11	427
73	Midi-Pyrénées	09	3	16	086	Caumont	310	3	313
73	Midi-Pyrénées	09	1	03	087	Caussou	65	3	68
73	Midi-Pyrénées	09	1	03	088	Caychax	12	1	13
73	Midi-Pyrénées	09	2	10	089	Cazals-des-Baylès	43	1	44
73	Midi-Pyrénées	09	2	19	090	Cazaux	45	1	46
73	Midi-Pyrénées	09	3	16	091	Cazavet	216	3	219
73	Midi-Pyrénées	09	1	18	092	Cazenave-Serres-et-Allens	44	3	47
73	Midi-Pyrénées	09	1	21	093	Celles	119	2	121
73	Midi-Pyrénées	09	3	14	094	Cérizols	154	8	162
73	Midi-Pyrénées	09	3	04	095	Cescau	141	9	150
73	Midi-Pyrénées	09	1	03	096	Château-Verdun	49	5	54
73	Midi-Pyrénées	09	3	15	097	Clermont	95	0	95
73	Midi-Pyrénées	09	3	14	098	Contrazy	61	0	61
73	Midi-Pyrénées	09	1	21	099	Cos	375	4	379
73	Midi-Pyrénées	09	3	11	100	Couflens	82	2	84
73	Midi-Pyrénées	09	2	19	101	Coussa	223	3	226
73	Midi-Pyrénées	09	2	10	102	Coutens	158	8	166
73	Midi-Pyrénées	09	2	19	103	Crampagna	648	23	671
73	Midi-Pyrénées	09	2	19	104	Dalou	782	21	803
73	Midi-Pyrénées	09	2	08	105	Daumazan-sur-Arize	714	16	730
73	Midi-Pyrénées	09	1	07	106	Dreuilhe	365	6	371
73	Midi-Pyrénées	09	2	10	107	Dun	585	16	601
73	Midi-Pyrénées	09	1	02	108	Durban-sur-Arize	163	5	168
73	Midi-Pyrénées	09	2	06	109	Durfort	163	1	164
73	Midi-Pyrénées	09	3	15	110	Encourtiech	99	2	101
73	Midi-Pyrénées	09	3	04	111	Engomer	274	5	279
73	Midi-Pyrénées	09	3	11	113	Ercé	560	2	562
73	Midi-Pyrénées	09	3	15	114	Erp	144	1	145
73	Midi-Pyrénées	09	2	10	115	Esclagne	114	3	117
73	Midi-Pyrénées	09	2	12	116	Escosse	414	5	419
73	Midi-Pyrénées	09	2	17	117	Esplas	95	9	104
73	Midi-Pyrénées	09	3	15	118	Esplas-de-Sérou	159	2	161
73	Midi-Pyrénées	09	3	15	119	Eycheil	555	16	571
73	Midi-Pyrénées	09	3	14	120	Fabas	329	2	331
73	Midi-Pyrénées	09	1	21	121	Ferrières-sur-Ariège	822	105	927
73	Midi-Pyrénées	09	1	05	122	Foix	9885	473	10358
73	Midi-Pyrénées	09	2	08	123	Fornex	109	3	112
73	Midi-Pyrénées	09	2	06	124	Le Fossat	1063	12	1075
73	Midi-Pyrénées	09	1	07	125	Fougax-et-Barrineuf	522	6	528
73	Midi-Pyrénées	09	1	21	126	Freychenet	95	0	95
73	Midi-Pyrénées	09	2	08	127	Gabre	94	6	100
73	Midi-Pyrénées	09	3	16	128	Gajan	298	21	319
73	Midi-Pyrénées	09	3	04	129	Galey	112	1	113
73	Midi-Pyrénées	09	1	21	130	Ganac	692	19	711
73	Midi-Pyrénées	09	1	03	131	Garanou	168	6	174
73	Midi-Pyrénées	09	2	17	132	Gaudiès	218	3	221
73	Midi-Pyrénées	09	1	18	133	Génat	27	1	28
73	Midi-Pyrénées	09	1	20	134	Gestiès	9	0	9
73	Midi-Pyrénées	09	1	20	135	Goulier	40	2	42
73	Midi-Pyrénées	09	1	18	136	Gourbit	93	2	95
73	Midi-Pyrénées	09	2	19	137	Gudas	143	3	146
73	Midi-Pyrénées	09	1	21	138	L; Herm	215	38	253
73	Midi-Pyrénées	09	1	01	139	L; Hospitalet-près-l;Andorre	94	1	95
73	Midi-Pyrénées	09	1	01	140	Ignaux	104	1	105
73	Midi-Pyrénées	09	1	07	142	Ilhat	122	4	126
73	Midi-Pyrénées	09	3	04	141	Illartein	83	0	83
73	Midi-Pyrénées	09	1	20	143	Illier-et-Laramade	21	0	21
73	Midi-Pyrénées	09	2	22	145	Les Issards	252	5	257
73	Midi-Pyrénées	09	2	17	146	Justiniac	51	3	54
73	Midi-Pyrénées	09	2	17	147	Labatut	136	6	142
73	Midi-Pyrénées	09	3	16	148	Lacave	122	5	127
73	Midi-Pyrénées	09	3	15	149	Lacourt	198	5	203
73	Midi-Pyrénées	09	2	10	150	Lagarde	184	4	188
73	Midi-Pyrénées	09	2	06	151	Lanoux	51	1	52
73	Midi-Pyrénées	09	1	18	152	Lapège	27	0	27
73	Midi-Pyrénées	09	2	10	153	Lapenne	113	1	114
73	Midi-Pyrénées	09	1	02	154	Larbont	40	1	41
73	Midi-Pyrénées	09	1	03	155	Larcat	39	3	42
73	Midi-Pyrénées	09	1	03	156	Larnat	20	0	20
73	Midi-Pyrénées	09	2	10	157	Laroque-d;Olmes	2720	64	2784
73	Midi-Pyrénées	09	3	14	158	Lasserre	205	6	211
73	Midi-Pyrénées	09	1	03	159	Lassur	62	1	63
73	Midi-Pyrénées	09	1	07	160	Lavelanet	6525	291	6816
73	Midi-Pyrénées	09	2	10	161	Léran	596	19	615
73	Midi-Pyrénées	09	1	20	162	Lercoul	23	0	23
73	Midi-Pyrénées	09	2	12	163	Lescousse	81	1	82
73	Midi-Pyrénées	09	3	15	164	Lescure	507	16	523
73	Midi-Pyrénées	09	1	07	165	Lesparrou	238	5	243
73	Midi-Pyrénées	09	1	07	166	Leychert	106	0	106
73	Midi-Pyrénées	09	2	06	167	Lézat-sur-Lèze	2343	36	2379
73	Midi-Pyrénées	09	1	07	168	Lieurac	158	9	167
73	Midi-Pyrénées	09	2	10	169	Limbrassac	108	2	110
73	Midi-Pyrénées	09	2	17	170	Lissac	208	1	209
73	Midi-Pyrénées	09	1	03	171	Lordat	38	0	38
73	Midi-Pyrénées	09	3	16	289	Lorp-Sentaraille	1324	52	1376
73	Midi-Pyrénées	09	2	08	172	Loubaut	31	0	31
73	Midi-Pyrénées	09	2	19	173	Loubens	254	9	263
73	Midi-Pyrénées	09	1	21	174	Loubières	227	7	234
73	Midi-Pyrénées	09	2	22	175	Ludiès	75	3	78
73	Midi-Pyrénées	09	1	03	176	Luzenac	551	11	562
73	Midi-Pyrénées	09	2	12	177	Madière	214	9	223
73	Midi-Pyrénées	09	2	10	178	Malegoude	48	3	51
73	Midi-Pyrénées	09	2	19	179	Malléon	48	1	49
73	Midi-Pyrénées	09	2	10	180	Manses	124	6	130
73	Midi-Pyrénées	09	2	08	181	Le Mas-d;Azil	1215	9	1224
73	Midi-Pyrénées	09	3	09	182	Massat	693	11	704
73	Midi-Pyrénées	09	3	16	183	Mauvezin-de-Prat	89	2	91
73	Midi-Pyrénées	09	3	14	184	Mauvezin-de-Sainte-Croix	42	0	42
73	Midi-Pyrénées	09	2	17	185	Mazères	3707	114	3821
73	Midi-Pyrénées	09	2	08	186	Méras	97	2	99
73	Midi-Pyrénées	09	3	16	187	Mercenac	374	10	384
73	Midi-Pyrénées	09	1	18	188	Mercus-Garrabet	1150	32	1182
73	Midi-Pyrénées	09	1	01	189	Mérens-les-Vals	185	3	188
73	Midi-Pyrénées	09	3	14	190	Mérigon	117	3	120
73	Midi-Pyrénées	09	1	18	192	Miglos	111	2	113
73	Midi-Pyrénées	09	1	13	193	Mijanès	91	0	91
73	Midi-Pyrénées	09	2	10	194	Mirepoix	3137	156	3293
73	Midi-Pyrénées	09	2	06	195	Monesple	25	1	26
73	Midi-Pyrénées	09	1	02	196	Montagagne	49	0	49
73	Midi-Pyrénées	09	1	01	197	Montaillou	32	2	34
73	Midi-Pyrénées	09	3	14	198	Montardit	201	3	204
73	Midi-Pyrénées	09	2	17	199	Montaut	684	16	700
73	Midi-Pyrénées	09	2	10	200	Montbel	114	4	118
73	Midi-Pyrénées	09	3	15	201	Montégut-en-Couserans	69	2	71
73	Midi-Pyrénées	09	2	19	202	Montégut-Plantaurel	327	6	333
73	Midi-Pyrénées	09	1	02	203	Montels	161	1	162
73	Midi-Pyrénées	09	3	16	204	Montesquieu-Avantès	250	2	252
73	Midi-Pyrénées	09	2	08	205	Montfa	81	2	83
73	Midi-Pyrénées	09	1	07	206	Montferrier	638	21	659
73	Midi-Pyrénées	09	1	21	207	Montgaillard	1372	37	1409
73	Midi-Pyrénées	09	3	16	208	Montgauch	120	1	121
73	Midi-Pyrénées	09	3	16	209	Montjoie-en-Couserans	1047	31	1078
73	Midi-Pyrénées	09	1	21	210	Montoulieu	357	11	368
73	Midi-Pyrénées	09	1	07	211	Montségur	116	0	116
73	Midi-Pyrénées	09	1	02	212	Montseron	82	2	84
73	Midi-Pyrénées	09	2	10	213	Moulin-Neuf	210	3	213
73	Midi-Pyrénées	09	3	15	214	Moulis	789	15	804
73	Midi-Pyrénées	09	1	07	215	Nalzen	123	1	124
73	Midi-Pyrénées	09	1	02	216	Nescus	73	3	76
73	Midi-Pyrénées	09	1	18	217	Niaux	195	5	200
73	Midi-Pyrénées	09	1	01	218	Orgeix	88	3	91
73	Midi-Pyrénées	09	3	04	219	Orgibet	165	6	171
73	Midi-Pyrénées	09	1	01	220	Orlu	190	3	193
73	Midi-Pyrénées	09	1	18	221	Ornolac-Ussat-les-Bains	257	0	257
73	Midi-Pyrénées	09	1	20	222	Orus	28	0	28
73	Midi-Pyrénées	09	3	11	223	Oust	554	15	569
73	Midi-Pyrénées	09	2	06	224	Pailhès	396	9	405
73	Midi-Pyrénées	09	2	99	225	Pamiers	15372	1078	16450
73	Midi-Pyrénées	09	1	03	226	Pech	46	2	48
73	Midi-Pyrénées	09	1	07	227	Péreille	193	5	198
73	Midi-Pyrénées	09	1	01	228	Perles-et-Castelet	204	7	211
73	Midi-Pyrénées	09	2	10	229	Le Peyrat	479	9	488
73	Midi-Pyrénées	09	1	13	230	Le Pla	46	2	48
73	Midi-Pyrénées	09	3	09	231	Le Port	208	3	211
73	Midi-Pyrénées	09	1	01	232	Prades	47	0	47
73	Midi-Pyrénées	09	2	10	233	Pradettes	41	0	41
73	Midi-Pyrénées	09	1	21	234	Pradières	111	3	114
73	Midi-Pyrénées	09	3	16	235	Prat-Bonrepaux	834	23	857
73	Midi-Pyrénées	09	1	21	236	Prayols	361	20	381
73	Midi-Pyrénées	09	1	13	237	Le Puch	37	0	37
73	Midi-Pyrénées	09	2	22	238	Les Pujols	700	9	709
73	Midi-Pyrénées	09	1	13	239	Quérigut	141	2	143
73	Midi-Pyrénées	09	1	18	240	Quié	293	4	297
73	Midi-Pyrénées	09	1	18	241	Rabat-les-Trois-Seigneurs	323	8	331
73	Midi-Pyrénées	09	1	07	242	Raissac	39	2	41
73	Midi-Pyrénées	09	2	10	243	Régat	83	2	85
73	Midi-Pyrénées	09	2	10	244	Rieucros	620	22	642
73	Midi-Pyrénées	09	2	19	245	Rieux-de-Pelleport	1248	52	1300
73	Midi-Pyrénées	09	3	15	246	Rimont	584	15	599
73	Midi-Pyrénées	09	3	15	247	Rivèrenert	188	4	192
73	Midi-Pyrénées	09	1	07	249	Roquefixade	153	2	155
73	Midi-Pyrénées	09	1	07	250	Roquefort-les-Cascades	97	4	101
73	Midi-Pyrénées	09	2	10	251	Roumengoux	154	4	158
73	Midi-Pyrénées	09	1	13	252	Rouze	91	8	99
73	Midi-Pyrénées	09	2	08	253	Sabarat	360	6	366
73	Midi-Pyrénées	09	2	22	254	Saint-Amadou	231	5	236
73	Midi-Pyrénées	09	2	12	255	Saint-Amans	44	0	44
73	Midi-Pyrénées	09	2	19	256	Saint-Bauzeil	64	0	64
73	Midi-Pyrénées	09	2	19	258	Saint-Félix-de-Rieutord	435	11	446
73	Midi-Pyrénées	09	2	10	259	Saint-Félix-de-Tournegat	144	4	148
73	Midi-Pyrénées	09	3	15	261	Saint-Girons	6500	469	6969
73	Midi-Pyrénées	09	1	07	262	Saint-Jean-d;Aigues-Vives	403	4	407
73	Midi-Pyrénées	09	1	21	264	Saint-Jean-de-Verges	1145	40	1185
73	Midi-Pyrénées	09	3	04	263	Saint-Jean-du-Castillonnais	29	0	29
73	Midi-Pyrénées	09	2	12	265	Saint-Jean-du-Falga	2719	81	2800
73	Midi-Pyrénées	09	2	10	266	Saint-Julien-de-Gras-Capou	62	1	63
73	Midi-Pyrénées	09	3	04	267	Saint-Lary	148	1	149
73	Midi-Pyrénées	09	3	16	268	Saint-Lizier	1453	39	1492
73	Midi-Pyrénées	09	2	12	270	Saint-Martin-d;Oydes	261	4	265
73	Midi-Pyrénées	09	1	21	269	Saint-Martin-de-Caralp	359	9	368
73	Midi-Pyrénées	09	2	12	271	Saint-Michel	73	0	73
73	Midi-Pyrénées	09	1	21	272	Saint-Paul-de-Jarrat	1260	40	1300
73	Midi-Pyrénées	09	1	21	273	Saint-Pierre-de-Rivière	692	39	731
73	Midi-Pyrénées	09	2	10	274	Saint-Quentin-la-Tour	327	11	338
73	Midi-Pyrénées	09	2	17	275	Saint-Quirc	374	6	380
73	Midi-Pyrénées	09	2	12	276	Saint-Victor-Rouzaud	237	2	239
73	Midi-Pyrénées	09	2	06	277	Saint-Ybars	665	17	682
73	Midi-Pyrénées	09	3	14	257	Sainte-Croix-Volvestre	650	13	663
73	Midi-Pyrénées	09	2	10	260	Sainte-Foi	27	1	28
73	Midi-Pyrénées	09	2	06	342	Sainte-Suzanne	252	8	260
73	Midi-Pyrénées	09	3	04	279	Salsein	45	1	46
73	Midi-Pyrénées	09	1	18	280	Saurat	645	11	656
73	Midi-Pyrénées	09	1	07	281	Sautel	129	3	132
73	Midi-Pyrénées	09	2	17	282	Saverdun	4528	143	4671
73	Midi-Pyrénées	09	1	01	283	Savignac-les-Ormeaux	423	10	433
73	Midi-Pyrénées	09	2	19	284	Ségura	173	5	178
73	Midi-Pyrénées	09	3	11	285	Seix	790	10	800
73	Midi-Pyrénées	09	1	20	286	Sem	27	1	28
73	Midi-Pyrénées	09	1	03	287	Senconac	8	0	8
73	Midi-Pyrénées	09	3	04	290	Sentein	150	3	153
73	Midi-Pyrénées	09	3	11	291	Sentenac-d;Oust	93	7	100
73	Midi-Pyrénées	09	1	02	292	Sentenac-de-Sérou	36	1	37
73	Midi-Pyrénées	09	1	21	293	Serres-sur-Arget	787	26	813
73	Midi-Pyrénées	09	2	06	294	Sieuras	73	8	81
73	Midi-Pyrénées	09	1	20	295	Siguer	99	4	103
73	Midi-Pyrénées	09	1	03	296	Sinsat	104	2	106
73	Midi-Pyrénées	09	3	04	297	Sor	35	1	36
73	Midi-Pyrénées	09	1	01	298	Sorgeat	95	4	99
73	Midi-Pyrénées	09	3	11	299	Soueix-Rogalle	406	10	416
73	Midi-Pyrénées	09	1	21	300	Soula	206	0	206
73	Midi-Pyrénées	09	3	09	301	Soulan	352	13	365
73	Midi-Pyrénées	09	1	20	302	Suc-et-Sentenac	55	1	56
73	Midi-Pyrénées	09	1	18	303	Surba	352	5	357
73	Midi-Pyrénées	09	1	02	304	Suzan	23	2	25
73	Midi-Pyrénées	09	2	10	305	Tabre	348	12	360
73	Midi-Pyrénées	09	1	18	306	Tarascon-sur-Ariège	3468	68	3536
73	Midi-Pyrénées	09	3	16	307	Taurignan-Castet	167	0	167
73	Midi-Pyrénées	09	3	16	308	Taurignan-Vieux	217	7	224
73	Midi-Pyrénées	09	2	10	309	Teilhet	172	7	179
73	Midi-Pyrénées	09	2	08	310	Thouars-sur-Arize	53	0	53
73	Midi-Pyrénées	09	1	01	311	Tignac	19	1	20
73	Midi-Pyrénées	09	2	22	312	La Tour-du-Crieu	2671	90	2761
73	Midi-Pyrénées	09	3	14	313	Tourtouse	156	9	165
73	Midi-Pyrénées	09	2	10	314	Tourtrol	243	6	249
73	Midi-Pyrénées	09	2	17	315	Trémoulet	101	0	101
73	Midi-Pyrénées	09	2	10	316	Troye-d;Ariège	95	5	100
73	Midi-Pyrénées	09	3	04	317	Uchentein	24	0	24
73	Midi-Pyrénées	09	1	03	318	Unac	121	3	124
73	Midi-Pyrénées	09	2	12	319	Unzent	123	3	126
73	Midi-Pyrénées	09	1	03	320	Urs	46	0	46
73	Midi-Pyrénées	09	1	18	321	Ussat	325	6	331
73	Midi-Pyrénées	09	3	11	322	Ustou	334	7	341
73	Midi-Pyrénées	09	2	10	323	Vals	91	1	92
73	Midi-Pyrénées	09	2	19	324	Varilhes	3036	87	3123
73	Midi-Pyrénées	09	1	01	325	Vaychis	31	0	31
73	Midi-Pyrénées	09	1	03	326	Vèbre	134	3	137
73	Midi-Pyrénées	09	2	19	327	Ventenac	226	5	231
73	Midi-Pyrénées	09	1	03	328	Verdun	231	7	238
73	Midi-Pyrénées	09	1	21	329	Vernajoul	691	32	723
73	Midi-Pyrénées	09	1	03	330	Vernaux	33	0	33
73	Midi-Pyrénées	09	2	17	331	Le Vernet	648	21	669
73	Midi-Pyrénées	09	2	19	332	Verniolle	2317	73	2390
73	Midi-Pyrénées	09	1	20	334	Vicdessos	556	53	609
73	Midi-Pyrénées	09	3	04	335	Villeneuve	42	0	42
73	Midi-Pyrénées	09	1	07	336	Villeneuve-d;Olmes	1125	24	1149
73	Midi-Pyrénées	09	2	06	338	Villeneuve-du-Latou	132	2	134
73	Midi-Pyrénées	09	2	22	339	Villeneuve-du-Paréage	669	13	682
73	Midi-Pyrénées	09	2	19	340	Vira	172	2	174
73	Midi-Pyrénées	09	2	10	341	Viviès	129	4	133
21	Champagne-Ardenne	10	1	03	002	Ailleville	276	6	282
21	Champagne-Ardenne	10	3	01	003	Aix-en-Othe	2434	42	2476
21	Champagne-Ardenne	10	3	02	004	Allibaudières	268	30	298
21	Champagne-Ardenne	10	1	25	005	Amance	275	5	280
21	Champagne-Ardenne	10	3	02	006	Arcis-sur-Aube	3011	87	3098
21	Champagne-Ardenne	10	1	03	007	Arconville	113	2	115
21	Champagne-Ardenne	10	1	25	008	Argançon	100	5	105
21	Champagne-Ardenne	10	3	19	009	Arrelles	87	1	88
21	Champagne-Ardenne	10	1	08	010	Arrembécourt	46	1	47
21	Champagne-Ardenne	10	1	03	011	Arrentières	214	5	219
21	Champagne-Ardenne	10	1	03	012	Arsonval	341	8	349
21	Champagne-Ardenne	10	3	05	013	Assenay	151	5	156
21	Champagne-Ardenne	10	3	17	014	Assencières	201	4	205
21	Champagne-Ardenne	10	3	02	015	Aubeterre	254	10	264
21	Champagne-Ardenne	10	1	08	017	Aulnay	126	5	131
21	Champagne-Ardenne	10	3	09	018	Auxon	965	17	982
21	Champagne-Ardenne	10	2	13	020	Avant-lès-Marcilly	499	4	503
21	Champagne-Ardenne	10	3	18	021	Avant-lès-Ramerupt	149	2	151
21	Champagne-Ardenne	10	3	19	022	Avirey-Lingey	220	3	223
21	Champagne-Ardenne	10	2	13	023	Avon-la-Pèze	188	4	192
21	Champagne-Ardenne	10	3	07	024	Avreuil	160	3	163
21	Champagne-Ardenne	10	3	19	025	Bagneux-la-Fosse	175	4	179
21	Champagne-Ardenne	10	1	08	026	Bailly-le-Franc	28	0	28
21	Champagne-Ardenne	10	1	08	027	Balignicourt	77	3	80
21	Champagne-Ardenne	10	3	07	028	Balnot-la-Grange	139	6	145
21	Champagne-Ardenne	10	3	19	029	Balnot-sur-Laignes	159	2	161
21	Champagne-Ardenne	10	1	03	033	Bar-sur-Aube	5259	209	5468
21	Champagne-Ardenne	10	3	04	034	Bar-sur-Seine	3233	201	3434
21	Champagne-Ardenne	10	3	29	030	Barberey-Saint-Sulpice	1220	27	1247
21	Champagne-Ardenne	10	2	26	031	Barbuise	416	12	428
21	Champagne-Ardenne	10	1	03	032	Baroville	342	15	357
21	Champagne-Ardenne	10	1	03	035	Bayel	854	14	868
21	Champagne-Ardenne	10	3	11	037	Bercenay-en-Othe	437	12	449
21	Champagne-Ardenne	10	2	13	038	Bercenay-le-Hayer	144	2	146
21	Champagne-Ardenne	10	1	03	039	Bergères	125	3	128
21	Champagne-Ardenne	10	3	07	040	Bernon	196	4	200
21	Champagne-Ardenne	10	3	10	041	Bertignolles	67	2	69
21	Champagne-Ardenne	10	3	01	042	Bérulle	264	4	268
21	Champagne-Ardenne	10	2	14	043	Bessy	130	1	131
21	Champagne-Ardenne	10	1	06	044	Bétignicourt	30	1	31
21	Champagne-Ardenne	10	3	10	045	Beurey	189	6	195
21	Champagne-Ardenne	10	1	06	046	Blaincourt-sur-Aube	96	5	101
21	Champagne-Ardenne	10	1	06	047	Blignicourt	42	3	45
21	Champagne-Ardenne	10	1	25	048	Bligny	194	4	198
21	Champagne-Ardenne	10	3	05	049	Les Bordes-Aumont	540	5	545
21	Champagne-Ardenne	10	1	25	050	Bossancourt	198	8	206
21	Champagne-Ardenne	10	3	05	051	Bouilly	1060	48	1108
21	Champagne-Ardenne	10	2	14	052	Boulages	239	2	241
21	Champagne-Ardenne	10	3	12	053	Bouranton	515	11	526
21	Champagne-Ardenne	10	2	13	054	Bourdenay	110	2	112
21	Champagne-Ardenne	10	3	04	055	Bourguignons	276	5	281
21	Champagne-Ardenne	10	3	17	056	Bouy-Luxembourg	207	2	209
21	Champagne-Ardenne	10	2	16	057	Bouy-sur-Orvin	57	1	58
21	Champagne-Ardenne	10	3	19	058	Bragelogne-Beauvoir	263	8	271
21	Champagne-Ardenne	10	1	08	059	Braux	111	11	122
21	Champagne-Ardenne	10	3	32	060	Bréviandes	2284	49	2333
21	Champagne-Ardenne	10	3	17	061	Brévonnes	708	15	723
21	Champagne-Ardenne	10	3	04	062	Briel-sur-Barse	210	8	218
21	Champagne-Ardenne	10	1	06	063	Brienne-la-Vieille	451	5	456
21	Champagne-Ardenne	10	1	06	064	Brienne-le-Château	3060	83	3143
21	Champagne-Ardenne	10	3	18	065	Brillecourt	92	1	93
21	Champagne-Ardenne	10	3	11	066	Bucey-en-Othe	445	4	449
21	Champagne-Ardenne	10	3	05	067	Buchères	1395	37	1432
21	Champagne-Ardenne	10	3	04	068	Buxeuil	141	8	149
21	Champagne-Ardenne	10	3	10	069	Buxières-sur-Arce	157	4	161
21	Champagne-Ardenne	10	3	15	070	Celles-sur-Ource	487	13	500
21	Champagne-Ardenne	10	3	10	071	Chacenay	62	4	66
21	Champagne-Ardenne	10	1	21	072	La Chaise	37	2	39
21	Champagne-Ardenne	10	1	08	073	Chalette-sur-Voire	143	7	150
21	Champagne-Ardenne	10	3	09	074	Chamoy	482	5	487
21	Champagne-Ardenne	10	1	25	078	Champ-sur-Barse	32	0	32
21	Champagne-Ardenne	10	2	14	075	Champfleury	146	4	150
21	Champagne-Ardenne	10	1	03	076	Champignol-lez-Mondeville	336	9	345
21	Champagne-Ardenne	10	3	02	077	Champigny-sur-Aube	88	2	90
21	Champagne-Ardenne	10	3	19	079	Channes	123	7	130
21	Champagne-Ardenne	10	3	07	080	Chaource	1102	12	1114
21	Champagne-Ardenne	10	3	96	081	La Chapelle-Saint-Luc	13228	208	13436
21	Champagne-Ardenne	10	2	14	082	Chapelle-Vallon	225	0	225
21	Champagne-Ardenne	10	3	04	083	Chappes	297	5	302
21	Champagne-Ardenne	10	3	02	084	Charmont-sous-Barbuise	1027	19	1046
21	Champagne-Ardenne	10	2	13	085	Charmoy	67	0	67
21	Champagne-Ardenne	10	2	14	086	Charny-le-Bachot	212	5	217
21	Champagne-Ardenne	10	3	07	087	Chaserey	51	2	53
21	Champagne-Ardenne	10	2	14	089	Châtres	644	16	660
21	Champagne-Ardenne	10	2	14	090	Chauchigny	254	4	258
21	Champagne-Ardenne	10	3	18	091	Chaudrey	153	5	158
21	Champagne-Ardenne	10	3	04	092	Chauffour-lès-Bailly	124	0	124
21	Champagne-Ardenne	10	1	21	093	Chaumesnil	88	1	89
21	Champagne-Ardenne	10	1	08	094	Chavanges	667	20	687
21	Champagne-Ardenne	10	3	02	095	Le Chêne	272	6	278
21	Champagne-Ardenne	10	3	11	096	Chennegy	451	15	466
21	Champagne-Ardenne	10	3	10	097	Chervey	184	5	189
21	Champagne-Ardenne	10	3	07	098	Chesley	338	12	350
21	Champagne-Ardenne	10	3	09	099	Chessy-les-Prés	527	11	538
21	Champagne-Ardenne	10	3	12	100	Clérey	1119	22	1141
21	Champagne-Ardenne	10	3	18	101	Coclois	189	5	194
21	Champagne-Ardenne	10	1	21	102	Colombé-la-Fosse	211	10	221
21	Champagne-Ardenne	10	1	03	103	Colombé-le-Sec	139	3	142
21	Champagne-Ardenne	10	3	05	104	Cormost	292	1	293
21	Champagne-Ardenne	10	1	06	105	Courcelles-sur-Voire	34	1	35
21	Champagne-Ardenne	10	2	16	106	Courceroy	119	2	121
21	Champagne-Ardenne	10	3	09	107	Coursan-en-Othe	99	6	105
21	Champagne-Ardenne	10	3	09	108	Courtaoult	83	2	85
21	Champagne-Ardenne	10	3	04	109	Courtenot	227	9	236
21	Champagne-Ardenne	10	3	12	110	Courteranges	585	7	592
21	Champagne-Ardenne	10	3	15	111	Courteron	118	5	123
21	Champagne-Ardenne	10	3	07	112	Coussegrey	159	7	166
21	Champagne-Ardenne	10	1	03	113	Couvignon	224	4	228
21	Champagne-Ardenne	10	2	20	114	Crancey	819	17	836
21	Champagne-Ardenne	10	3	23	115	Creney-près-Troyes	1610	35	1645
21	Champagne-Ardenne	10	3	05	116	Crésantignes	285	6	291
21	Champagne-Ardenne	10	1	21	117	Crespy-le-Neuf	146	6	152
21	Champagne-Ardenne	10	3	09	118	Les Croûtes	98	0	98
21	Champagne-Ardenne	10	3	10	119	Cunfin	211	7	218
21	Champagne-Ardenne	10	3	07	120	Cussangy	210	1	211
21	Champagne-Ardenne	10	3	18	121	Dampierre	292	9	301
21	Champagne-Ardenne	10	3	09	122	Davrey	267	4	271
21	Champagne-Ardenne	10	1	06	123	Dienville	849	28	877
21	Champagne-Ardenne	10	2	13	124	Dierrey-Saint-Julien	258	5	263
21	Champagne-Ardenne	10	2	13	125	Dierrey-Saint-Pierre	220	2	222
21	Champagne-Ardenne	10	1	25	126	Dolancourt	139	8	147
21	Champagne-Ardenne	10	3	18	127	Dommartin-le-Coq	60	1	61
21	Champagne-Ardenne	10	1	08	128	Donnement	82	5	87
21	Champagne-Ardenne	10	3	17	129	Dosches	302	7	309
21	Champagne-Ardenne	10	3	18	130	Dosnon	110	2	112
21	Champagne-Ardenne	10	2	14	131	Droupt-Saint-Basle	327	4	331
21	Champagne-Ardenne	10	2	14	132	Droupt-Sainte-Marie	236	6	242
21	Champagne-Ardenne	10	3	09	133	Eaux-Puiseaux	234	5	239
21	Champagne-Ardenne	10	2	13	134	Échemines	81	2	83
21	Champagne-Ardenne	10	1	21	135	Éclance	112	6	118
21	Champagne-Ardenne	10	3	10	136	Éguilly-sous-Bois	131	1	132
21	Champagne-Ardenne	10	1	03	137	Engente	43	0	43
21	Champagne-Ardenne	10	1	06	138	Épagne	114	5	119
21	Champagne-Ardenne	10	1	21	139	Épothémont	177	3	180
21	Champagne-Ardenne	10	3	09	140	Ervy-le-Châtel	1229	18	1247
21	Champagne-Ardenne	10	3	10	141	Essoyes	711	16	727
21	Champagne-Ardenne	10	3	11	142	Estissac	1820	29	1849
21	Champagne-Ardenne	10	3	07	143	Étourvy	208	7	215
21	Champagne-Ardenne	10	2	14	144	Étrelles-sur-Aube	142	3	145
21	Champagne-Ardenne	10	2	13	145	Faux-Villecerf	215	8	223
21	Champagne-Ardenne	10	2	13	146	Fay-lès-Marcilly	102	1	103
21	Champagne-Ardenne	10	3	05	147	Fays-la-Chapelle	148	4	152
21	Champagne-Ardenne	10	2	16	148	Ferreux-Quincey	353	13	366
21	Champagne-Ardenne	10	3	02	149	Feuges	283	2	285
21	Champagne-Ardenne	10	1	03	150	Fontaine	285	8	293
21	Champagne-Ardenne	10	2	14	151	Fontaine-les-Grès	863	14	877
21	Champagne-Ardenne	10	2	16	153	Fontaine-Mâcon	618	14	632
21	Champagne-Ardenne	10	2	16	154	Fontenay-de-Bossery	78	3	81
21	Champagne-Ardenne	10	3	10	155	Fontette	183	7	190
21	Champagne-Ardenne	10	3	11	156	Fontvannes	597	7	604
21	Champagne-Ardenne	10	2	20	157	La Fosse-Corduan	215	3	218
21	Champagne-Ardenne	10	3	04	158	Fouchères	520	14	534
21	Champagne-Ardenne	10	3	04	159	Fralignes	76	0	76
21	Champagne-Ardenne	10	1	25	160	Fravaux	46	1	47
21	Champagne-Ardenne	10	1	21	161	Fresnay	40	3	43
21	Champagne-Ardenne	10	3	12	162	Fresnoy-le-Château	242	3	245
21	Champagne-Ardenne	10	1	21	163	Fuligny	52	3	55
21	Champagne-Ardenne	10	2	20	164	Gélannes	722	24	746
21	Champagne-Ardenne	10	3	17	165	Géraudot	301	6	307
21	Champagne-Ardenne	10	2	14	166	Les Grandes-Chapelles	377	8	385
21	Champagne-Ardenne	10	3	18	167	Grandville	103	0	103
21	Champagne-Ardenne	10	3	07	168	Les Granges	81	1	82
21	Champagne-Ardenne	10	2	16	169	Gumery	235	8	243
21	Champagne-Ardenne	10	3	15	170	Gyé-sur-Seine	523	9	532
21	Champagne-Ardenne	10	1	06	171	Hampigny	257	9	266
21	Champagne-Ardenne	10	3	02	172	Herbisse	177	11	188
21	Champagne-Ardenne	10	3	18	174	Isle-Aubigny	165	6	171
21	Champagne-Ardenne	10	3	05	173	Isle-Aumont	513	18	531
21	Champagne-Ardenne	10	1	08	175	Jasseines	170	1	171
21	Champagne-Ardenne	10	1	03	176	Jaucourt	174	13	187
21	Champagne-Ardenne	10	3	05	177	Javernant	162	4	166
21	Champagne-Ardenne	10	1	25	178	Jessains	296	18	314
21	Champagne-Ardenne	10	3	05	179	Jeugny	461	5	466
21	Champagne-Ardenne	10	1	08	180	Joncreuil	83	2	85
21	Champagne-Ardenne	10	3	04	181	Jully-sur-Sarce	296	8	304
21	Champagne-Ardenne	10	1	03	182	Juvancourt	148	9	157
21	Champagne-Ardenne	10	1	25	183	Juvanzé	28	3	31
21	Champagne-Ardenne	10	1	21	184	Juzanvigny	122	0	122
21	Champagne-Ardenne	10	3	07	185	Lagesse	180	6	186
21	Champagne-Ardenne	10	3	31	186	Laines-aux-Bois	510	22	532
21	Champagne-Ardenne	10	3	10	187	Landreville	538	9	547
21	Champagne-Ardenne	10	3	07	188	Lantages	247	6	253
21	Champagne-Ardenne	10	1	06	189	Lassicourt	69	1	70
21	Champagne-Ardenne	10	3	12	190	Laubressel	474	7	481
21	Champagne-Ardenne	10	3	23	191	Lavau	857	17	874
21	Champagne-Ardenne	10	1	08	192	Lentilles	90	1	91
21	Champagne-Ardenne	10	1	06	193	Lesmont	340	9	349
21	Champagne-Ardenne	10	1	21	194	Lévigny	103	3	106
21	Champagne-Ardenne	10	3	18	195	Lhuître	279	8	287
21	Champagne-Ardenne	10	3	07	196	Lignières	235	10	245
21	Champagne-Ardenne	10	1	03	197	Lignol-le-Château	202	6	208
21	Champagne-Ardenne	10	3	05	198	Lirey	103	4	107
21	Champagne-Ardenne	10	3	10	199	Loches-sur-Ource	370	13	383
21	Champagne-Ardenne	10	1	25	200	La Loge-aux-Chèvres	83	2	85
21	Champagne-Ardenne	10	3	07	201	La Loge-Pomblin	67	1	68
21	Champagne-Ardenne	10	3	07	202	Les Loges-Margueron	231	43	274
21	Champagne-Ardenne	10	1	03	203	Longchamp-sur-Aujon	423	9	432
21	Champagne-Ardenne	10	3	05	204	Longeville-sur-Mogne	104	5	109
21	Champagne-Ardenne	10	3	10	205	Longpré-le-Sec	77	3	80
21	Champagne-Ardenne	10	3	18	206	Longsols	127	3	130
21	Champagne-Ardenne	10	2	14	207	Longueville-sur-Aube	125	2	127
21	Champagne-Ardenne	10	2	16	208	La Louptière-Thénard	282	12	294
21	Champagne-Ardenne	10	3	12	209	Lusigny-sur-Barse	1755	58	1813
21	Champagne-Ardenne	10	3	17	210	Luyères	429	8	437
21	Champagne-Ardenne	10	3	28	211	Macey	880	16	896
21	Champagne-Ardenne	10	3	05	212	Machy	115	1	116
21	Champagne-Ardenne	10	3	10	213	Magnant	179	9	188
21	Champagne-Ardenne	10	1	08	214	Magnicourt	67	2	69
21	Champagne-Ardenne	10	1	25	215	Magny-Fouchard	280	2	282
21	Champagne-Ardenne	10	3	02	216	Mailly-le-Camp	1777	24	1801
21	Champagne-Ardenne	10	1	25	217	Maison-des-Champs	40	1	41
21	Champagne-Ardenne	10	3	07	218	Maisons-lès-Chaource	182	4	186
21	Champagne-Ardenne	10	1	21	219	Maisons-lès-Soulaines	80	1	81
21	Champagne-Ardenne	10	2	20	220	Maizières-la-Grande-Paroisse	1442	60	1502
21	Champagne-Ardenne	10	1	06	221	Maizières-lès-Brienne	183	6	189
21	Champagne-Ardenne	10	3	01	222	Maraye-en-Othe	493	10	503
21	Champagne-Ardenne	10	2	13	223	Marcilly-le-Hayer	677	22	699
21	Champagne-Ardenne	10	2	13	224	Marigny-le-Châtel	1653	33	1686
21	Champagne-Ardenne	10	2	16	225	Marnay-sur-Seine	246	4	250
21	Champagne-Ardenne	10	3	04	226	Marolles-lès-Bailly	101	2	103
21	Champagne-Ardenne	10	3	09	227	Marolles-sous-Lignières	326	4	330
21	Champagne-Ardenne	10	1	06	228	Mathaux	242	4	246
21	Champagne-Ardenne	10	3	05	229	Maupas	102	0	102
21	Champagne-Ardenne	10	3	23	230	Mergey	678	15	693
21	Champagne-Ardenne	10	2	16	231	Le Mériot	574	12	586
21	Champagne-Ardenne	10	3	04	232	Merrey-sur-Arce	322	11	333
21	Champagne-Ardenne	10	2	14	233	Méry-sur-Seine	1430	61	1491
21	Champagne-Ardenne	10	2	14	234	Mesgrigny	267	4	271
21	Champagne-Ardenne	10	3	18	235	Mesnil-la-Comtesse	35	1	36
21	Champagne-Ardenne	10	3	18	236	Mesnil-Lettre	59	4	63
21	Champagne-Ardenne	10	2	13	237	Mesnil-Saint-Loup	557	38	595
21	Champagne-Ardenne	10	3	12	238	Mesnil-Saint-Père	430	7	437
21	Champagne-Ardenne	10	3	17	239	Mesnil-Sellières	568	12	580
21	Champagne-Ardenne	10	3	11	240	Messon	449	14	463
21	Champagne-Ardenne	10	3	07	241	Metz-Robert	52	4	56
21	Champagne-Ardenne	10	1	25	242	Meurville	179	3	182
21	Champagne-Ardenne	10	1	06	243	Molins-sur-Aube	113	1	114
21	Champagne-Ardenne	10	3	12	245	Montaulin	763	8	771
21	Champagne-Ardenne	10	3	05	246	Montceaux-lès-Vaudes	264	21	285
21	Champagne-Ardenne	10	3	09	247	Montfey	137	2	139
21	Champagne-Ardenne	10	3	28	248	Montgueux	401	11	412
21	Champagne-Ardenne	10	1	03	250	Montier-en-l;Isle	201	10	211
21	Champagne-Ardenne	10	3	12	249	Montiéramey	441	10	451
21	Champagne-Ardenne	10	3	09	251	Montigny-les-Monts	256	2	258
21	Champagne-Ardenne	10	3	10	252	Montmartin-le-Haut	60	0	60
21	Champagne-Ardenne	10	1	08	253	Montmorency-Beaufort	125	7	132
21	Champagne-Ardenne	10	2	26	254	Montpothier	334	6	340
21	Champagne-Ardenne	10	3	12	255	Montreuil-sur-Barse	314	6	320
21	Champagne-Ardenne	10	3	02	256	Montsuzain	358	7	365
21	Champagne-Ardenne	10	3	18	257	Morembert	47	0	47
21	Champagne-Ardenne	10	1	21	258	Morvilliers	313	8	321
21	Champagne-Ardenne	10	2	16	259	La Motte-Tilly	380	4	384
21	Champagne-Ardenne	10	3	05	260	Moussey	558	7	565
21	Champagne-Ardenne	10	3	15	261	Mussy-sur-Seine	1119	17	1136
21	Champagne-Ardenne	10	3	15	262	Neuville-sur-Seine	397	9	406
21	Champagne-Ardenne	10	3	11	263	Neuville-sur-Vanne	425	20	445
21	Champagne-Ardenne	10	3	10	264	Noé-les-Mallets	116	2	118
21	Champagne-Ardenne	10	3	33	265	Les Noës-près-Troyes	3173	40	3213
21	Champagne-Ardenne	10	3	01	266	Nogent-en-Othe	38	1	39
21	Champagne-Ardenne	10	3	18	267	Nogent-sur-Aube	349	3	352
21	Champagne-Ardenne	10	2	16	268	Nogent-sur-Seine	6064	145	6209
21	Champagne-Ardenne	10	3	02	269	Nozay	139	9	148
21	Champagne-Ardenne	10	3	17	270	Onjon	248	5	253
21	Champagne-Ardenne	10	2	20	271	Origny-le-Sec	641	10	651
21	Champagne-Ardenne	10	3	02	272	Ormes	197	4	201
21	Champagne-Ardenne	10	3	18	273	Ortillon	36	0	36
21	Champagne-Ardenne	10	2	20	274	Orvilliers-Saint-Julien	311	4	315
21	Champagne-Ardenne	10	2	20	275	Ossey-les-Trois-Maisons	598	8	606
21	Champagne-Ardenne	10	3	01	276	Paisy-Cosdon	337	11	348
21	Champagne-Ardenne	10	2	13	277	Palis	620	9	629
21	Champagne-Ardenne	10	3	07	278	Pargues	119	2	121
21	Champagne-Ardenne	10	1	08	279	Pars-lès-Chavanges	73	5	78
21	Champagne-Ardenne	10	2	20	280	Pars-lès-Romilly	780	13	793
21	Champagne-Ardenne	10	3	29	281	Le Pavillon-Sainte-Julie	316	9	325
21	Champagne-Ardenne	10	3	29	282	Payns	1255	49	1304
21	Champagne-Ardenne	10	1	06	283	Pel-et-Der	145	5	150
21	Champagne-Ardenne	10	2	26	284	Périgny-la-Rose	114	3	117
21	Champagne-Ardenne	10	1	06	285	Perthes-lès-Brienne	83	6	89
21	Champagne-Ardenne	10	1	21	286	Petit-Mesnil	241	10	251
21	Champagne-Ardenne	10	3	17	287	Piney	1353	29	1382
21	Champagne-Ardenne	10	3	15	288	Plaines-Saint-Lange	293	2	295
21	Champagne-Ardenne	10	2	14	289	Plancy-l;Abbaye	944	23	967
21	Champagne-Ardenne	10	2	13	290	Planty	211	3	214
21	Champagne-Ardenne	10	2	26	291	Plessis-Barbuise	155	2	157
21	Champagne-Ardenne	10	3	02	293	Poivres	161	1	162
21	Champagne-Ardenne	10	3	04	294	Poligny	77	0	77
21	Champagne-Ardenne	10	3	15	295	Polisot	339	3	342
21	Champagne-Ardenne	10	3	15	296	Polisy	173	6	179
21	Champagne-Ardenne	10	3	23	297	Pont-Sainte-Marie	4786	162	4948
21	Champagne-Ardenne	10	2	16	298	Pont-sur-Seine	995	14	1009
21	Champagne-Ardenne	10	3	02	299	Pouan-les-Vallées	510	11	521
21	Champagne-Ardenne	10	3	18	300	Pougy	279	4	283
21	Champagne-Ardenne	10	2	13	301	Pouy-sur-Vannes	147	1	148
21	Champagne-Ardenne	10	3	07	302	Praslin	87	3	90
21	Champagne-Ardenne	10	1	06	303	Précy-Notre-Dame	81	0	81
21	Champagne-Ardenne	10	1	06	304	Précy-Saint-Martin	205	6	211
21	Champagne-Ardenne	10	2	14	305	Prémierfait	103	0	103
21	Champagne-Ardenne	10	1	03	306	Proverville	255	11	266
21	Champagne-Ardenne	10	3	11	307	Prugny	408	4	412
21	Champagne-Ardenne	10	2	13	308	Prunay-Belleville	228	5	233
21	Champagne-Ardenne	10	3	07	309	Prusy	105	3	108
21	Champagne-Ardenne	10	3	10	310	Puits-et-Nuisement	205	4	209
21	Champagne-Ardenne	10	3	09	312	Racines	175	3	178
21	Champagne-Ardenne	10	1	06	313	Radonvilliers	393	3	396
21	Champagne-Ardenne	10	3	18	314	Ramerupt	386	10	396
21	Champagne-Ardenne	10	1	06	315	Rances	39	0	39
21	Champagne-Ardenne	10	2	14	316	Rhèges	225	4	229
21	Champagne-Ardenne	10	3	19	317	Les Riceys	1349	59	1408
21	Champagne-Ardenne	10	2	13	318	Rigny-la-Nonneuse	149	1	150
21	Champagne-Ardenne	10	3	01	319	Rigny-le-Ferron	375	9	384
21	Champagne-Ardenne	10	2	14	320	Rilly-Sainte-Syre	254	3	257
21	Champagne-Ardenne	10	3	28	321	La Rivière-de-Corps	2926	208	3134
21	Champagne-Ardenne	10	2	97	323	Romilly-sur-Seine	13526	248	13774
21	Champagne-Ardenne	10	3	05	324	Roncenay	134	4	138
21	Champagne-Ardenne	10	3	32	325	Rosières-près-Troyes	3353	333	3686
21	Champagne-Ardenne	10	1	06	326	Rosnay-l;Hôpital	225	6	231
21	Champagne-Ardenne	10	1	21	327	La Rothière	107	1	108
21	Champagne-Ardenne	10	3	17	328	Rouilly-Sacey	378	3	381
21	Champagne-Ardenne	10	3	12	329	Rouilly-Saint-Loup	554	51	605
21	Champagne-Ardenne	10	1	03	330	Rouvres-les-Vignes	113	7	120
21	Champagne-Ardenne	10	3	04	331	Rumilly-lès-Vaudes	474	8	482
21	Champagne-Ardenne	10	3	12	332	Ruvigny	456	12	468
21	Champagne-Ardenne	10	3	31	333	Saint-André-les-Vergers	11335	218	11553
21	Champagne-Ardenne	10	2	16	334	Saint-Aubin	595	10	605
21	Champagne-Ardenne	10	3	01	335	Saint-Benoist-sur-Vanne	232	5	237
21	Champagne-Ardenne	10	3	23	336	Saint-Benoît-sur-Seine	404	21	425
21	Champagne-Ardenne	10	1	06	337	Saint-Christophe-Dodinicourt	34	2	36
21	Champagne-Ardenne	10	3	02	338	Saint-Étienne-sous-Barbuise	135	5	140
21	Champagne-Ardenne	10	2	13	339	Saint-Flavy	267	10	277
21	Champagne-Ardenne	10	3	31	340	Saint-Germain	2276	48	2324
21	Champagne-Ardenne	10	2	20	341	Saint-Hilaire-sous-Romilly	370	10	380
21	Champagne-Ardenne	10	3	05	342	Saint-Jean-de-Bonneval	371	12	383
21	Champagne-Ardenne	10	3	32	343	Saint-Julien-les-Villas	6883	164	7047
21	Champagne-Ardenne	10	3	05	344	Saint-Léger-près-Troyes	744	14	758
21	Champagne-Ardenne	10	1	06	345	Saint-Léger-sous-Brienne	393	8	401
21	Champagne-Ardenne	10	1	08	346	Saint-Léger-sous-Margerie	54	4	58
21	Champagne-Ardenne	10	2	20	347	Saint-Loup-de-Buffigny	194	1	195
21	Champagne-Ardenne	10	2	13	348	Saint-Lupien	244	9	253
21	Champagne-Ardenne	10	3	29	349	Saint-Lyé	2911	66	2977
21	Champagne-Ardenne	10	3	01	350	Saint-Mards-en-Othe	655	16	671
21	Champagne-Ardenne	10	2	20	351	Saint-Martin-de-Bossenay	381	10	391
21	Champagne-Ardenne	10	2	14	353	Saint-Mesmin	897	8	905
21	Champagne-Ardenne	10	3	18	354	Saint-Nabord-sur-Aube	134	2	136
21	Champagne-Ardenne	10	2	16	355	Saint-Nicolas-la-Chapelle	77	2	79
21	Champagne-Ardenne	10	2	14	356	Saint-Oulph	218	2	220
21	Champagne-Ardenne	10	3	22	357	Saint-Parres-aux-Tertres	2842	77	2919
21	Champagne-Ardenne	10	3	04	358	Saint-Parres-lès-Vaudes	1003	26	1029
21	Champagne-Ardenne	10	3	09	359	Saint-Phal	534	6	540
21	Champagne-Ardenne	10	3	05	360	Saint-Pouange	906	187	1093
21	Champagne-Ardenne	10	3	02	361	Saint-Remy-sous-Barbuise	190	1	191
21	Champagne-Ardenne	10	3	05	363	Saint-Thibault	465	9	474
21	Champagne-Ardenne	10	3	10	364	Saint-Usage	87	2	89
21	Champagne-Ardenne	10	3	23	352	Sainte-Maure	1412	242	1654
21	Champagne-Ardenne	10	3	28	362	Sainte-Savine	10196	391	10587
21	Champagne-Ardenne	10	2	14	365	Salon	150	6	156
21	Champagne-Ardenne	10	1	21	366	Saulcy	84	1	85
21	Champagne-Ardenne	10	2	26	367	La Saulsotte	677	5	682
21	Champagne-Ardenne	10	2	14	368	Savières	984	28	1012
21	Champagne-Ardenne	10	3	02	369	Semoine	222	5	227
21	Champagne-Ardenne	10	2	16	370	Soligny-les-Étangs	221	6	227
21	Champagne-Ardenne	10	3	05	371	Sommeval	328	9	337
21	Champagne-Ardenne	10	1	21	372	Soulaines-Dhuys	320	6	326
21	Champagne-Ardenne	10	3	05	373	Souligny	410	16	426
21	Champagne-Ardenne	10	1	25	374	Spoy	135	8	143
21	Champagne-Ardenne	10	3	12	375	Thennelières	343	6	349
21	Champagne-Ardenne	10	3	10	376	Thieffrain	161	1	162
21	Champagne-Ardenne	10	1	21	377	Thil	154	3	157
21	Champagne-Ardenne	10	1	21	378	Thors	75	3	78
21	Champagne-Ardenne	10	3	02	379	Torcy-le-Grand	427	11	438
21	Champagne-Ardenne	10	3	02	380	Torcy-le-Petit	81	3	84
21	Champagne-Ardenne	10	3	28	381	Torvilliers	875	20	895
21	Champagne-Ardenne	10	2	16	382	Traînel	1058	26	1084
21	Champagne-Ardenne	10	2	13	383	Trancault	181	6	187
21	Champagne-Ardenne	10	1	25	384	Trannes	250	8	258
21	Champagne-Ardenne	10	3	18	386	Trouans	241	6	247
21	Champagne-Ardenne	10	3	99	387	Troyes	60280	1656	61936
21	Champagne-Ardenne	10	3	07	388	Turgy	44	2	46
21	Champagne-Ardenne	10	1	25	389	Unienville	112	2	114
21	Champagne-Ardenne	10	1	03	390	Urville	158	5	163
21	Champagne-Ardenne	10	3	23	391	Vailly	305	3	308
21	Champagne-Ardenne	10	3	17	019	Val-d;Auzon	403	1	404
21	Champagne-Ardenne	10	2	14	392	Vallant-Saint-Georges	387	2	389
21	Champagne-Ardenne	10	1	06	393	Vallentigny	192	6	198
21	Champagne-Ardenne	10	3	07	394	Vallières	144	1	145
21	Champagne-Ardenne	10	3	07	395	Vanlay	310	9	319
21	Champagne-Ardenne	10	3	11	396	Vauchassis	514	12	526
21	Champagne-Ardenne	10	1	25	397	Vauchonvilliers	142	2	144
21	Champagne-Ardenne	10	3	18	398	Vaucogne	78	0	78
21	Champagne-Ardenne	10	3	04	399	Vaudes	632	7	639
21	Champagne-Ardenne	10	3	18	400	Vaupoisson	145	6	151
21	Champagne-Ardenne	10	1	25	401	Vendeuvre-sur-Barse	2400	58	2458
21	Champagne-Ardenne	10	3	05	402	La Vendue-Mignot	240	6	246
21	Champagne-Ardenne	10	1	21	403	Vernonvilliers	80	2	82
21	Champagne-Ardenne	10	3	10	404	Verpillières-sur-Ource	115	6	121
21	Champagne-Ardenne	10	3	18	405	Verricourt	41	1	42
21	Champagne-Ardenne	10	3	12	406	Verrières	1750	42	1792
21	Champagne-Ardenne	10	2	14	408	Viâpres-le-Petit	127	2	129
21	Champagne-Ardenne	10	3	23	409	Villacerf	518	9	527
21	Champagne-Ardenne	10	2	13	410	Villadin	129	3	132
21	Champagne-Ardenne	10	1	21	411	La Ville-aux-Bois	19	0	19
21	Champagne-Ardenne	10	1	03	426	Ville-sous-la-Ferté	1119	24	1143
21	Champagne-Ardenne	10	3	04	427	Ville-sur-Arce	248	10	258
21	Champagne-Ardenne	10	1	21	428	Ville-sur-Terre	114	2	116
21	Champagne-Ardenne	10	3	22	412	Villechétif	945	22	967
21	Champagne-Ardenne	10	3	29	414	Villeloup	119	1	120
21	Champagne-Ardenne	10	3	11	415	Villemaur-sur-Vanne	501	17	518
21	Champagne-Ardenne	10	3	05	416	Villemereuil	238	6	244
21	Champagne-Ardenne	10	3	01	417	Villemoiron-en-Othe	228	8	236
21	Champagne-Ardenne	10	3	04	418	Villemorien	216	2	218
21	Champagne-Ardenne	10	3	04	419	Villemoyenne	748	2	750
21	Champagne-Ardenne	10	2	26	420	Villenauxe-la-Grande	2788	45	2833
21	Champagne-Ardenne	10	2	26	421	La Villeneuve-au-Châtelot	147	0	147
21	Champagne-Ardenne	10	3	09	422	Villeneuve-au-Chemin	180	8	188
21	Champagne-Ardenne	10	1	25	423	La Villeneuve-au-Chêne	436	5	441
21	Champagne-Ardenne	10	1	08	424	Villeret	65	2	67
21	Champagne-Ardenne	10	3	05	425	Villery	273	8	281
21	Champagne-Ardenne	10	3	02	429	Villette-sur-Aube	235	4	239
21	Champagne-Ardenne	10	3	02	430	Villiers-Herbisse	91	3	94
21	Champagne-Ardenne	10	3	07	431	Villiers-le-Bois	102	2	104
21	Champagne-Ardenne	10	3	04	432	Villiers-sous-Praslin	74	2	76
21	Champagne-Ardenne	10	3	04	433	Villy-en-Trodes	284	3	287
21	Champagne-Ardenne	10	3	05	434	Villy-le-Bois	64	0	64
21	Champagne-Ardenne	10	3	05	435	Villy-le-Maréchal	167	1	168
21	Champagne-Ardenne	10	3	18	436	Vinets	179	14	193
21	Champagne-Ardenne	10	3	04	437	Virey-sous-Bar	641	10	651
21	Champagne-Ardenne	10	3	10	438	Vitry-le-Croisé	256	3	259
21	Champagne-Ardenne	10	3	10	439	Viviers-sur-Artaut	111	4	115
21	Champagne-Ardenne	10	1	03	440	Voigny	183	6	189
21	Champagne-Ardenne	10	3	09	441	Vosnon	207	6	213
21	Champagne-Ardenne	10	3	02	442	Voué	583	6	589
21	Champagne-Ardenne	10	3	07	443	Vougrey	46	1	47
21	Champagne-Ardenne	10	3	01	444	Vulaines	238	5	243
21	Champagne-Ardenne	10	1	06	445	Yèvres-le-Petit	74	1	75
91	Languedoc-Roussillon	11	1	25	001	Aigues-Vives	519	10	529
91	Languedoc-Roussillon	11	1	09	002	Airoux	128	1	129
91	Languedoc-Roussillon	11	2	20	003	Ajac	198	4	202
91	Languedoc-Roussillon	11	2	01	004	Alaigne	340	6	346
91	Languedoc-Roussillon	11	1	22	005	Alairac	1279	33	1312
91	Languedoc-Roussillon	11	3	15	006	Albas	74	2	76
91	Languedoc-Roussillon	11	1	23	007	Albières	98	6	104
91	Languedoc-Roussillon	11	2	20	008	Alet-les-Bains	431	7	438
91	Languedoc-Roussillon	11	1	02	009	Alzonne	1319	34	1353
91	Languedoc-Roussillon	11	2	13	010	Antugnac	318	9	327
91	Languedoc-Roussillon	11	1	02	011	Aragon	421	14	435
91	Languedoc-Roussillon	11	3	17	012	Argeliers	1808	23	1831
91	Languedoc-Roussillon	11	3	19	013	Argens-Minervois	376	10	386
91	Languedoc-Roussillon	11	3	14	014	Armissan	1554	32	1586
91	Languedoc-Roussillon	11	2	13	015	Arques	275	4	279
91	Languedoc-Roussillon	11	1	18	016	Arquettes-en-Val	97	2	99
91	Languedoc-Roussillon	11	2	03	017	Artigues	83	5	88
91	Languedoc-Roussillon	11	1	22	018	Arzens	1148	27	1175
91	Languedoc-Roussillon	11	2	04	019	Aunat	39	0	39
91	Languedoc-Roussillon	11	1	23	020	Auriac	32	3	35
91	Languedoc-Roussillon	11	2	03	021	Axat	640	19	659
91	Languedoc-Roussillon	11	1	25	022	Azille	1188	16	1204
91	Languedoc-Roussillon	11	1	06	023	Badens	746	12	758
91	Languedoc-Roussillon	11	3	34	024	Bages	840	30	870
91	Languedoc-Roussillon	11	1	12	025	Bagnoles	243	3	246
91	Languedoc-Roussillon	11	1	29	026	Baraigne	151	2	153
91	Languedoc-Roussillon	11	1	06	027	Barbaira	733	10	743
91	Languedoc-Roussillon	11	2	04	028	Belcaire	454	7	461
91	Languedoc-Roussillon	11	2	27	029	Belcastel-et-Buc	71	3	74
91	Languedoc-Roussillon	11	1	29	030	Belflou	106	1	107
91	Languedoc-Roussillon	11	2	04	031	Belfort-sur-Rebenty	40	3	43
91	Languedoc-Roussillon	11	2	01	032	Bellegarde-du-Razès	219	2	221
91	Languedoc-Roussillon	11	1	05	033	Belpech	1320	29	1349
91	Languedoc-Roussillon	11	2	01	034	Belvèze-du-Razès	872	13	885
91	Languedoc-Roussillon	11	2	26	035	Belvianes-et-Cavirac	288	6	294
91	Languedoc-Roussillon	11	2	04	036	Belvis	182	3	185
91	Languedoc-Roussillon	11	1	07	037	Berriac	885	28	913
91	Languedoc-Roussillon	11	2	03	038	Bessède-de-Sault	56	2	58
91	Languedoc-Roussillon	11	2	20	039	La Bezole	44	1	45
91	Languedoc-Roussillon	11	3	33	040	Bizanet	1331	32	1363
91	Languedoc-Roussillon	11	3	17	041	Bize-Minervois	1081	24	1105
91	Languedoc-Roussillon	11	1	06	042	Blomac	204	2	206
91	Languedoc-Roussillon	11	1	06	043	Bouilhonnac	226	3	229
91	Languedoc-Roussillon	11	1	23	044	Bouisse	93	1	94
91	Languedoc-Roussillon	11	2	20	045	Bouriège	132	5	137
91	Languedoc-Roussillon	11	2	20	046	Bourigeole	46	2	48
91	Languedoc-Roussillon	11	2	03	047	Le Bousquet	45	5	50
91	Languedoc-Roussillon	11	3	19	048	Boutenac	705	25	730
91	Languedoc-Roussillon	11	1	16	049	Bram	3315	98	3413
91	Languedoc-Roussillon	11	2	26	050	Brenac	203	5	208
91	Languedoc-Roussillon	11	2	01	051	Brézilhac	169	9	178
91	Languedoc-Roussillon	11	1	28	052	Brousses-et-Villaret	314	3	317
91	Languedoc-Roussillon	11	2	01	053	Brugairolles	253	3	256
91	Languedoc-Roussillon	11	1	09	054	Les Brunels	224	3	227
91	Languedoc-Roussillon	11	2	13	055	Bugarach	202	2	204
91	Languedoc-Roussillon	11	1	25	056	Cabrespine	180	6	186
91	Languedoc-Roussillon	11	1	05	057	Cahuzac	32	0	32
91	Languedoc-Roussillon	11	2	01	058	Cailhau	255	9	264
91	Languedoc-Roussillon	11	2	01	059	Cailhavel	100	0	100
91	Languedoc-Roussillon	11	2	03	060	Cailla	53	0	53
91	Languedoc-Roussillon	11	2	01	061	Cambieure	252	5	257
91	Languedoc-Roussillon	11	2	04	062	Campagna-de-Sault	14	1	15
91	Languedoc-Roussillon	11	2	26	063	Campagne-sur-Aude	661	21	682
91	Languedoc-Roussillon	11	3	19	064	Camplong-d;Aude	313	5	318
91	Languedoc-Roussillon	11	2	13	065	Camps-sur-l;Agly	78	0	78
91	Languedoc-Roussillon	11	2	04	066	Camurac	116	2	118
91	Languedoc-Roussillon	11	3	33	067	Canet	1384	10	1394
91	Languedoc-Roussillon	11	1	06	068	Capendu	1583	51	1634
91	Languedoc-Roussillon	11	1	98	069	Carcassonne	47419	1474	48893
91	Languedoc-Roussillon	11	1	09	070	Carlipa	315	8	323
91	Languedoc-Roussillon	11	3	15	071	Cascastel-des-Corbières	212	2	214
91	Languedoc-Roussillon	11	1	16	072	La Cassaigne	196	4	200
91	Languedoc-Roussillon	11	2	13	073	Cassaignes	68	2	70
91	Languedoc-Roussillon	11	1	09	074	Les Cassés	241	5	246
91	Languedoc-Roussillon	11	1	25	075	Castans	118	1	119
91	Languedoc-Roussillon	11	3	19	077	Castelnau-d;Aude	461	4	465
91	Languedoc-Roussillon	11	1	99	076	Castelnaudary	11753	467	12220
91	Languedoc-Roussillon	11	2	20	078	Castelreng	202	16	218
91	Languedoc-Roussillon	11	1	21	079	Caudebronde	182	3	185
91	Languedoc-Roussillon	11	2	11	080	Caudeval	179	8	187
91	Languedoc-Roussillon	11	1	25	081	Caunes-Minervois	1629	18	1647
91	Languedoc-Roussillon	11	2	27	082	Caunette-sur-Lauquet	7	0	7
91	Languedoc-Roussillon	11	1	18	083	Caunettes-en-Val	50	0	50
91	Languedoc-Roussillon	11	1	02	084	Caux-et-Sauzens	782	31	813
91	Languedoc-Roussillon	11	1	07	085	Cavanac	921	19	940
91	Languedoc-Roussillon	11	3	30	086	Caves	692	14	706
91	Languedoc-Roussillon	11	1	16	087	Cazalrenoux	77	0	77
91	Languedoc-Roussillon	11	1	07	088	Cazilhac	1658	44	1702
91	Languedoc-Roussillon	11	1	09	089	Cenne-Monestiés	362	5	367
91	Languedoc-Roussillon	11	2	20	090	Cépie	653	3	656
91	Languedoc-Roussillon	11	2	11	091	Chalabre	1131	19	1150
91	Languedoc-Roussillon	11	1	25	092	Citou	82	2	84
91	Languedoc-Roussillon	11	2	03	093	Le Clat	35	0	35
91	Languedoc-Roussillon	11	2	27	094	Clermont-sur-Lauquet	25	0	25
91	Languedoc-Roussillon	11	1	06	095	Comigne	274	2	276
91	Languedoc-Roussillon	11	2	04	096	Comus	31	2	33
91	Languedoc-Roussillon	11	3	19	098	Conilhac-Corbières	887	22	909
91	Languedoc-Roussillon	11	2	13	097	Conilhac-de-la-Montagne	61	4	65
91	Languedoc-Roussillon	11	1	12	099	Conques-sur-Orbiel	2334	45	2379
91	Languedoc-Roussillon	11	2	11	100	Corbières	36	1	37
91	Languedoc-Roussillon	11	2	26	101	Coudons	48	1	49
91	Languedoc-Roussillon	11	1	07	102	Couffoulens	606	15	621
91	Languedoc-Roussillon	11	2	13	103	Couiza	1147	23	1170
91	Languedoc-Roussillon	11	2	03	104	Counozouls	45	2	47
91	Languedoc-Roussillon	11	2	20	105	Cournanel	659	17	676
91	Languedoc-Roussillon	11	3	14	106	Coursan	6050	136	6186
91	Languedoc-Roussillon	11	2	11	107	Courtauly	74	2	76
91	Languedoc-Roussillon	11	2	01	108	La Courtète	45	0	45
91	Languedoc-Roussillon	11	2	13	109	Coustaussa	56	2	58
91	Languedoc-Roussillon	11	3	15	110	Coustouge	95	2	97
91	Languedoc-Roussillon	11	3	19	111	Cruscades	538	2	540
91	Languedoc-Roussillon	11	2	13	112	Cubières-sur-Cinoble	105	0	105
91	Languedoc-Roussillon	11	3	31	113	Cucugnan	137	2	139
91	Languedoc-Roussillon	11	1	29	114	Cumiès	36	2	38
91	Languedoc-Roussillon	11	1	28	115	Cuxac-Cabardès	905	30	935
91	Languedoc-Roussillon	11	3	14	116	Cuxac-d;Aude	4253	87	4340
91	Languedoc-Roussillon	11	1	23	117	Davejean	113	0	113
91	Languedoc-Roussillon	11	1	23	118	Dernacueillette	43	2	45
91	Languedoc-Roussillon	11	2	20	119	La Digne-d;Amont	284	5	289
91	Languedoc-Roussillon	11	2	20	120	La Digne-d;Aval	537	5	542
91	Languedoc-Roussillon	11	2	01	121	Donazac	93	2	95
91	Languedoc-Roussillon	11	1	06	122	Douzens	704	9	713
91	Languedoc-Roussillon	11	3	31	123	Duilhac-sous-Peyrepertuse	135	0	135
91	Languedoc-Roussillon	11	3	15	124	Durban-Corbières	684	12	696
91	Languedoc-Roussillon	11	3	15	125	Embres-et-Castelmaure	163	6	169
91	Languedoc-Roussillon	11	3	19	126	Escales	374	3	377
91	Languedoc-Roussillon	11	2	03	127	Escouloubre	95	0	95
91	Languedoc-Roussillon	11	2	01	128	Escueillens-et-Saint-Just-de-Bélengard	190	1	191
91	Languedoc-Roussillon	11	2	26	129	Espéraza	2081	30	2111
91	Languedoc-Roussillon	11	2	04	130	Espezel	214	7	221
91	Languedoc-Roussillon	11	2	26	131	Fa	366	5	371
91	Languedoc-Roussillon	11	3	19	132	Fabrezan	1263	16	1279
91	Languedoc-Roussillon	11	1	18	133	Fajac-en-Val	34	1	35
91	Languedoc-Roussillon	11	1	29	134	Fajac-la-Relenque	47	0	47
91	Languedoc-Roussillon	11	2	04	135	La Fajolle	15	0	15
91	Languedoc-Roussillon	11	1	16	136	Fanjeaux	779	64	843
91	Languedoc-Roussillon	11	1	23	137	Félines-Termenès	135	1	136
91	Languedoc-Roussillon	11	1	10	138	Fendeille	565	15	580
91	Languedoc-Roussillon	11	2	01	139	Fenouillet-du-Razès	88	3	91
91	Languedoc-Roussillon	11	3	19	140	Ferrals-les-Corbières	1135	17	1152
91	Languedoc-Roussillon	11	2	01	141	Ferran	101	3	104
91	Languedoc-Roussillon	11	2	20	142	Festes-et-Saint-André	202	13	215
91	Languedoc-Roussillon	11	3	30	143	Feuilla	98	0	98
91	Languedoc-Roussillon	11	3	30	144	Fitou	965	15	980
91	Languedoc-Roussillon	11	3	14	145	Fleury	3405	49	3454
91	Languedoc-Roussillon	11	1	06	146	Floure	367	8	375
91	Languedoc-Roussillon	11	2	04	147	Fontanès-de-Sault	5	0	5
91	Languedoc-Roussillon	11	3	19	148	Fontcouverte	534	13	547
91	Languedoc-Roussillon	11	1	16	149	Fonters-du-Razès	90	3	93
91	Languedoc-Roussillon	11	1	28	150	Fontiers-Cabardès	435	59	494
91	Languedoc-Roussillon	11	1	06	151	Fontiès-d;Aude	403	6	409
91	Languedoc-Roussillon	11	3	15	152	Fontjoncouse	141	2	143
91	Languedoc-Roussillon	11	1	16	153	La Force	205	5	210
91	Languedoc-Roussillon	11	1	21	154	Fournes-Cabardès	63	1	64
91	Languedoc-Roussillon	11	2	13	155	Fourtou	62	2	64
91	Languedoc-Roussillon	11	1	28	156	Fraisse-Cabardès	110	6	116
91	Languedoc-Roussillon	11	3	15	157	Fraissé-des-Corbières	252	4	256
91	Languedoc-Roussillon	11	2	20	158	Gaja-et-Villedieu	293	15	308
91	Languedoc-Roussillon	11	1	16	159	Gaja-la-Selve	152	2	154
91	Languedoc-Roussillon	11	2	04	160	Galinagues	39	1	40
91	Languedoc-Roussillon	11	2	27	161	Gardie	106	1	107
91	Languedoc-Roussillon	11	1	16	162	Generville	57	2	59
91	Languedoc-Roussillon	11	2	03	163	Gincla	48	0	48
91	Languedoc-Roussillon	11	3	17	164	Ginestas	1358	26	1384
91	Languedoc-Roussillon	11	2	26	165	Ginoles	356	15	371
91	Languedoc-Roussillon	11	1	29	166	Gourvieille	56	4	60
91	Languedoc-Roussillon	11	2	01	167	Gramazie	101	4	105
91	Languedoc-Roussillon	11	2	26	168	Granès	119	4	123
91	Languedoc-Roussillon	11	2	27	169	Greffeil	87	4	91
91	Languedoc-Roussillon	11	3	14	170	Gruissan	4676	78	4754
91	Languedoc-Roussillon	11	2	11	171	Gueytes-et-Labastide	41	0	41
91	Languedoc-Roussillon	11	3	19	172	Homps	694	7	701
91	Languedoc-Roussillon	11	2	01	173	Hounoux	134	1	135
91	Languedoc-Roussillon	11	1	21	174	Les Ilhes	51	0	51
91	Languedoc-Roussillon	11	1	09	175	Issel	465	4	469
91	Languedoc-Roussillon	11	3	15	176	Jonquières	61	0	61
91	Languedoc-Roussillon	11	2	04	177	Joucou	38	2	40
91	Languedoc-Roussillon	11	1	10	178	Labastide-d;Anjou	994	17	1011
91	Languedoc-Roussillon	11	1	18	179	Labastide-en-Val	93	7	100
91	Languedoc-Roussillon	11	1	21	180	Labastide-Esparbairenque	85	4	89
91	Languedoc-Roussillon	11	1	09	181	Labécède-Lauragais	403	7	410
91	Languedoc-Roussillon	11	1	28	182	Lacombe	170	3	173
91	Languedoc-Roussillon	11	2	27	183	Ladern-sur-Lauquet	259	4	263
91	Languedoc-Roussillon	11	1	05	184	Lafage	103	2	105
91	Languedoc-Roussillon	11	1	18	185	Lagrasse	583	26	609
91	Languedoc-Roussillon	11	1	23	186	Lairière	45	0	45
91	Languedoc-Roussillon	11	1	23	187	Lanet	48	1	49
91	Languedoc-Roussillon	11	1	28	189	Laprade	93	3	96
91	Languedoc-Roussillon	11	1	23	191	Laroque-de-Fa	149	1	150
91	Languedoc-Roussillon	11	1	10	192	Lasbordes	825	33	858
91	Languedoc-Roussillon	11	2	01	193	Lasserre-de-Prouille	240	8	248
91	Languedoc-Roussillon	11	1	21	194	Lastours	165	2	167
91	Languedoc-Roussillon	11	1	10	195	Laurabuc	406	1	407
91	Languedoc-Roussillon	11	1	16	196	Laurac	180	4	184
91	Languedoc-Roussillon	11	2	01	197	Lauraguel	587	20	607
91	Languedoc-Roussillon	11	1	25	198	Laure-Minervois	1051	31	1082
91	Languedoc-Roussillon	11	1	22	199	Lavalette	1294	35	1329
91	Languedoc-Roussillon	11	1	25	200	Lespinassière	116	1	117
91	Languedoc-Roussillon	11	1	07	201	Leuc	717	24	741
91	Languedoc-Roussillon	11	3	30	202	Leucate	4043	60	4103
91	Languedoc-Roussillon	11	3	19	203	Lézignan-Corbières	10539	151	10690
91	Languedoc-Roussillon	11	2	01	204	Lignairolles	36	2	38
91	Languedoc-Roussillon	11	1	12	205	Limousis	107	1	108
91	Languedoc-Roussillon	11	2	20	206	Limoux	10130	608	10738
91	Languedoc-Roussillon	11	2	20	207	Loupia	230	10	240
91	Languedoc-Roussillon	11	1	29	208	La Louvière-Lauragais	79	1	80
91	Languedoc-Roussillon	11	2	13	209	Luc-sur-Aude	202	4	206
91	Languedoc-Roussillon	11	3	19	210	Luc-sur-Orbieu	1023	16	1039
91	Languedoc-Roussillon	11	2	20	211	Magrie	511	10	521
91	Languedoc-Roussillon	11	3	17	212	Mailhac	473	5	478
91	Languedoc-Roussillon	11	3	31	213	Maisons	41	1	42
91	Languedoc-Roussillon	11	2	20	214	Malras	355	11	366
91	Languedoc-Roussillon	11	1	12	215	Malves-en-Minervois	784	22	806
91	Languedoc-Roussillon	11	2	01	216	Malviès	379	8	387
91	Languedoc-Roussillon	11	3	33	217	Marcorignan	1163	32	1195
91	Languedoc-Roussillon	11	1	29	218	Marquein	76	2	78
91	Languedoc-Roussillon	11	2	26	219	Marsa	26	0	26
91	Languedoc-Roussillon	11	1	06	220	Marseillette	677	13	690
91	Languedoc-Roussillon	11	1	21	221	Les Martys	271	3	274
91	Languedoc-Roussillon	11	1	21	222	Mas-Cabardès	200	2	202
91	Languedoc-Roussillon	11	1	07	223	Mas-des-Cours	23	2	25
91	Languedoc-Roussillon	11	1	10	225	Mas-Saintes-Puelles	900	20	920
91	Languedoc-Roussillon	11	1	23	224	Massac	30	0	30
91	Languedoc-Roussillon	11	1	05	226	Mayreville	75	5	80
91	Languedoc-Roussillon	11	1	18	227	Mayronnes	34	0	34
91	Languedoc-Roussillon	11	2	01	228	Mazerolles-du-Razès	175	2	177
91	Languedoc-Roussillon	11	2	04	229	Mazuby	24	0	24
91	Languedoc-Roussillon	11	2	04	230	Mérial	26	0	26
91	Languedoc-Roussillon	11	1	29	231	Mézerville	82	0	82
91	Languedoc-Roussillon	11	1	21	232	Miraval-Cabardes	43	1	44
91	Languedoc-Roussillon	11	3	17	233	Mirepeisset	748	12	760
91	Languedoc-Roussillon	11	1	10	234	Mireval-Lauragais	164	9	173
91	Languedoc-Roussillon	11	2	13	235	Missègre	66	1	67
91	Languedoc-Roussillon	11	1	05	236	Molandier	232	4	236
91	Languedoc-Roussillon	11	1	29	238	Molleville	91	4	95
91	Languedoc-Roussillon	11	1	29	239	Montauriol	77	1	78
91	Languedoc-Roussillon	11	2	13	240	Montazels	530	9	539
91	Languedoc-Roussillon	11	3	19	241	Montbrun-des-Corbières	318	9	327
91	Languedoc-Roussillon	11	1	22	242	Montclar	194	4	198
91	Languedoc-Roussillon	11	1	10	243	Montferrand	496	8	504
91	Languedoc-Roussillon	11	2	03	244	Montfort-sur-Boulzane	91	2	93
91	Languedoc-Roussillon	11	3	31	245	Montgaillard	56	1	57
91	Languedoc-Roussillon	11	2	01	246	Montgradail	59	0	59
91	Languedoc-Roussillon	11	2	01	247	Monthaut	47	0	47
91	Languedoc-Roussillon	11	1	06	248	Montirat	71	4	75
91	Languedoc-Roussillon	11	2	11	249	Montjardin	98	1	99
91	Languedoc-Roussillon	11	1	23	250	Montjoi	42	0	42
91	Languedoc-Roussillon	11	1	18	251	Montlaur	530	15	545
91	Languedoc-Roussillon	11	1	09	252	Montmaur	324	7	331
91	Languedoc-Roussillon	11	1	02	253	Montolieu	766	15	781
91	Languedoc-Roussillon	11	1	22	254	Montréal	1921	164	2085
91	Languedoc-Roussillon	11	3	33	255	Montredon-des-Corbières	1286	32	1318
91	Languedoc-Roussillon	11	3	19	256	Montséret	498	9	507
91	Languedoc-Roussillon	11	1	06	257	Monze	195	2	197
91	Languedoc-Roussillon	11	3	33	258	Moussan	1806	28	1834
91	Languedoc-Roussillon	11	1	02	259	Moussoulens	942	20	962
91	Languedoc-Roussillon	11	1	23	260	Mouthoumet	116	4	120
91	Languedoc-Roussillon	11	1	06	261	Moux	602	15	617
91	Languedoc-Roussillon	11	3	97	262	Narbonne	51039	1450	52489
91	Languedoc-Roussillon	11	2	26	263	Nébias	270	6	276
91	Languedoc-Roussillon	11	3	33	264	Névian	1327	34	1361
91	Languedoc-Roussillon	11	2	04	265	Niort-de-Sault	29	2	31
91	Languedoc-Roussillon	11	3	19	267	Ornaisons	1233	23	1256
91	Languedoc-Roussillon	11	1	16	268	Orsans	92	3	95
91	Languedoc-Roussillon	11	3	17	269	Ouveillan	2346	35	2381
91	Languedoc-Roussillon	11	3	31	270	Padern	129	2	131
91	Languedoc-Roussillon	11	1	23	271	Palairac	33	1	34
91	Languedoc-Roussillon	11	1	07	272	Palaja	2135	80	2215
91	Languedoc-Roussillon	11	3	30	188	La Palme	1527	31	1558
91	Languedoc-Roussillon	11	3	17	273	Paraza	610	5	615
91	Languedoc-Roussillon	11	2	20	274	Pauligne	335	17	352
91	Languedoc-Roussillon	11	1	29	275	Payra-sur-l;Hers	168	6	174
91	Languedoc-Roussillon	11	3	31	276	Paziols	523	8	531
91	Languedoc-Roussillon	11	1	05	278	Pech-Luna	98	2	100
91	Languedoc-Roussillon	11	1	05	277	Pécharic-et-le-Py	30	0	30
91	Languedoc-Roussillon	11	1	08	279	Pennautier	2465	72	2537
91	Languedoc-Roussillon	11	1	25	280	Pépieux	1001	35	1036
91	Languedoc-Roussillon	11	1	10	281	Pexiora	1200	25	1225
91	Languedoc-Roussillon	11	2	11	282	Peyrefitte-du-Razès	51	2	53
91	Languedoc-Roussillon	11	1	05	283	Peyrefitte-sur-l;Hers	75	2	77
91	Languedoc-Roussillon	11	1	09	284	Peyrens	416	4	420
91	Languedoc-Roussillon	11	3	30	285	Peyriac-de-Mer	1035	29	1064
91	Languedoc-Roussillon	11	1	25	286	Peyriac-Minervois	1087	25	1112
91	Languedoc-Roussillon	11	2	13	287	Peyrolles	83	1	84
91	Languedoc-Roussillon	11	1	02	288	Pezens	1334	123	1457
91	Languedoc-Roussillon	11	2	20	289	Pieusse	983	26	1009
91	Languedoc-Roussillon	11	1	05	290	Plaigne	114	3	117
91	Languedoc-Roussillon	11	1	16	291	Plavilla	120	2	122
91	Languedoc-Roussillon	11	1	09	292	La Pomarède	162	5	167
91	Languedoc-Roussillon	11	2	27	293	Pomas	777	16	793
91	Languedoc-Roussillon	11	2	01	294	Pomy	54	2	56
91	Languedoc-Roussillon	11	3	30	266	Port-la-Nouvelle	5713	69	5782
91	Languedoc-Roussillon	11	3	30	295	Portel-des-Corbières	1197	26	1223
91	Languedoc-Roussillon	11	3	17	296	Pouzols-Minervois	455	5	460
91	Languedoc-Roussillon	11	1	21	297	Pradelles-Cabardès	151	5	156
91	Languedoc-Roussillon	11	1	18	298	Pradelles-en-Val	200	3	203
91	Languedoc-Roussillon	11	1	22	299	Preixan	535	10	545
91	Languedoc-Roussillon	11	1	09	300	Puginier	146	3	149
91	Languedoc-Roussillon	11	1	25	301	Puichéric	1082	20	1102
91	Languedoc-Roussillon	11	2	03	302	Puilaurens	260	3	263
91	Languedoc-Roussillon	11	2	11	303	Puivert	521	8	529
91	Languedoc-Roussillon	11	2	26	304	Quillan	3301	159	3460
91	Languedoc-Roussillon	11	3	15	305	Quintillan	65	1	66
91	Languedoc-Roussillon	11	2	26	306	Quirbajou	37	3	40
91	Languedoc-Roussillon	11	3	33	307	Raissac-d;Aude	243	1	244
91	Languedoc-Roussillon	11	1	02	308	Raissac-sur-Lampy	390	6	396
91	Languedoc-Roussillon	11	1	25	190	La Redorte	1121	20	1141
91	Languedoc-Roussillon	11	2	13	309	Rennes-le-Château	72	5	77
91	Languedoc-Roussillon	11	2	13	310	Rennes-les-Bains	196	3	199
91	Languedoc-Roussillon	11	1	18	311	Ribaute	295	5	300
91	Languedoc-Roussillon	11	1	16	312	Ribouisse	105	2	107
91	Languedoc-Roussillon	11	1	10	313	Ricaud	294	2	296
91	Languedoc-Roussillon	11	1	18	314	Rieux-en-Val	87	0	87
91	Languedoc-Roussillon	11	1	25	315	Rieux-Minervois	2011	59	2070
91	Languedoc-Roussillon	11	2	11	316	Rivel	223	4	227
91	Languedoc-Roussillon	11	2	04	317	Rodome	135	3	138
91	Languedoc-Roussillon	11	1	06	318	Roquecourbe-Minervois	122	1	123
91	Languedoc-Roussillon	11	1	21	319	Roquefère	72	3	75
91	Languedoc-Roussillon	11	2	04	320	Roquefeuil	277	6	283
91	Languedoc-Roussillon	11	2	03	321	Roquefort-de-Sault	79	4	83
91	Languedoc-Roussillon	11	3	30	322	Roquefort-des-Corbières	971	26	997
91	Languedoc-Roussillon	11	2	13	323	Roquetaillade	212	4	216
91	Languedoc-Roussillon	11	3	17	324	Roubia	477	8	485
91	Languedoc-Roussillon	11	1	22	325	Rouffiac-d;Aude	390	9	399
91	Languedoc-Roussillon	11	3	31	326	Rouffiac-des-Corbières	75	2	77
91	Languedoc-Roussillon	11	1	22	327	Roullens	495	15	510
91	Languedoc-Roussillon	11	2	01	328	Routier	252	10	262
91	Languedoc-Roussillon	11	2	26	329	Rouvenac	208	5	213
91	Languedoc-Roussillon	11	1	06	330	Rustiques	473	11	484
91	Languedoc-Roussillon	11	1	05	331	Saint-Amans	62	0	62
91	Languedoc-Roussillon	11	3	19	332	Saint-André-de-Roquelongue	1130	22	1152
91	Languedoc-Roussillon	11	2	11	333	Saint-Benoît	113	3	116
91	Languedoc-Roussillon	11	1	06	337	Saint-Couat-d;Aude	394	7	401
91	Languedoc-Roussillon	11	2	20	338	Saint-Couat-du-Razès	55	2	57
91	Languedoc-Roussillon	11	1	28	339	Saint-Denis	494	9	503
91	Languedoc-Roussillon	11	2	26	341	Saint-Ferriol	144	6	150
91	Languedoc-Roussillon	11	1	25	342	Saint-Frichoux	226	3	229
91	Languedoc-Roussillon	11	1	16	343	Saint-Gaudéric	76	3	79
91	Languedoc-Roussillon	11	2	27	344	Saint-Hilaire	751	15	766
91	Languedoc-Roussillon	11	3	15	345	Saint-Jean-de-Barrou	281	4	285
91	Languedoc-Roussillon	11	2	11	346	Saint-Jean-de-Paracol	114	3	117
91	Languedoc-Roussillon	11	2	26	347	Saint-Julia-de-Bec	101	4	105
91	Languedoc-Roussillon	11	1	16	348	Saint-Julien-de-Briola	79	1	80
91	Languedoc-Roussillon	11	2	26	350	Saint-Just-et-le-Bézu	65	2	67
91	Languedoc-Roussillon	11	3	15	351	Saint-Laurent-de-la-Cabrerisse	764	26	790
91	Languedoc-Roussillon	11	2	26	352	Saint-Louis-et-Parahou	62	0	62
91	Languedoc-Roussillon	11	3	17	353	Saint-Marcel-sur-Aude	1654	23	1677
91	Languedoc-Roussillon	11	2	20	355	Saint-Martin-de-Villereglan	336	5	341
91	Languedoc-Roussillon	11	1	18	354	Saint-Martin-des-Puits	22	1	23
91	Languedoc-Roussillon	11	1	10	356	Saint-Martin-Lalande	1090	28	1118
91	Languedoc-Roussillon	11	1	02	357	Saint-Martin-le-Vieil	233	6	239
91	Languedoc-Roussillon	11	2	26	358	Saint-Martin-Lys	40	2	42
91	Languedoc-Roussillon	11	1	29	359	Saint-Michel-de-Lanès	376	11	387
91	Languedoc-Roussillon	11	3	17	360	Saint-Nazaire-d;Aude	1847	34	1881
91	Languedoc-Roussillon	11	1	09	361	Saint-Papoul	769	19	788
91	Languedoc-Roussillon	11	1	09	362	Saint-Paulet	177	2	179
91	Languedoc-Roussillon	11	1	18	363	Saint-Pierre-des-Champs	172	5	177
91	Languedoc-Roussillon	11	2	27	364	Saint-Polycarpe	159	4	163
91	Languedoc-Roussillon	11	1	05	365	Saint-Sernin	40	0	40
91	Languedoc-Roussillon	11	1	29	334	Sainte-Camelle	114	2	116
91	Languedoc-Roussillon	11	2	03	335	Sainte-Colombe-sur-Guette	49	0	49
91	Languedoc-Roussillon	11	2	11	336	Sainte-Colombe-sur-l;Hers	502	11	513
91	Languedoc-Roussillon	11	1	02	340	Sainte-Eulalie	522	8	530
91	Languedoc-Roussillon	11	3	17	366	Sainte-Valière	546	13	559
91	Languedoc-Roussillon	11	1	28	367	Saissac	929	15	944
91	Languedoc-Roussillon	11	1	12	368	Sallèles-Cabardès	109	1	110
91	Languedoc-Roussillon	11	3	17	369	Sallèles-d;Aude	2580	38	2618
91	Languedoc-Roussillon	11	3	14	370	Salles-d;Aude	2833	58	2891
91	Languedoc-Roussillon	11	1	29	371	Salles-sur-l;Hers	614	3	617
91	Languedoc-Roussillon	11	1	21	372	Salsigne	372	5	377
91	Languedoc-Roussillon	11	2	03	373	Salvezines	74	2	76
91	Languedoc-Roussillon	11	1	23	374	Salza	19	3	22
91	Languedoc-Roussillon	11	2	01	375	Seignalens	33	2	35
91	Languedoc-Roussillon	11	2	13	376	La Serpent	76	2	78
91	Languedoc-Roussillon	11	2	13	377	Serres	48	3	51
91	Languedoc-Roussillon	11	1	18	378	Serviès-en-Val	219	11	230
91	Languedoc-Roussillon	11	3	30	379	Sigean	5377	134	5511
91	Languedoc-Roussillon	11	2	11	380	Sonnac-sur-l;Hers	159	4	163
91	Languedoc-Roussillon	11	2	13	381	Sougraigne	82	2	84
91	Languedoc-Roussillon	11	1	09	382	Souilhanels	405	68	473
91	Languedoc-Roussillon	11	1	09	383	Souilhe	336	9	345
91	Languedoc-Roussillon	11	1	23	384	Soulatgé	113	5	118
91	Languedoc-Roussillon	11	1	09	385	Soupex	265	5	270
91	Languedoc-Roussillon	11	1	18	386	Talairan	375	4	379
91	Languedoc-Roussillon	11	1	18	387	Taurize	78	1	79
91	Languedoc-Roussillon	11	1	23	388	Termes	48	3	51
91	Languedoc-Roussillon	11	2	13	389	Terroles	14	0	14
91	Languedoc-Roussillon	11	3	15	390	Thézan-des-Corbières	535	5	540
91	Languedoc-Roussillon	11	1	21	391	La Tourette-Cabardès	22	0	22
91	Languedoc-Roussillon	11	1	18	392	Tournissan	271	9	280
91	Languedoc-Roussillon	11	3	19	393	Tourouzelle	477	7	484
91	Languedoc-Roussillon	11	2	20	394	Tourreilles	121	3	124
91	Languedoc-Roussillon	11	1	21	395	Trassanel	32	1	33
91	Languedoc-Roussillon	11	1	25	396	Trausse	515	9	524
91	Languedoc-Roussillon	11	1	06	397	Trèbes	5308	122	5430
91	Languedoc-Roussillon	11	3	30	398	Treilles	182	1	183
91	Languedoc-Roussillon	11	1	09	399	Tréville	110	9	119
91	Languedoc-Roussillon	11	2	11	400	Tréziers	105	2	107
91	Languedoc-Roussillon	11	3	31	401	Tuchan	832	25	857
91	Languedoc-Roussillon	11	2	13	402	Valmigère	20	1	21
91	Languedoc-Roussillon	11	1	02	404	Ventenac-Cabardès	848	32	880
91	Languedoc-Roussillon	11	3	17	405	Ventenac-en-Minervois	534	4	538
91	Languedoc-Roussillon	11	2	20	406	Véraza	38	0	38
91	Languedoc-Roussillon	11	1	09	407	Verdun-en-Lauragais	259	9	268
91	Languedoc-Roussillon	11	2	27	408	Verzeille	438	7	445
91	Languedoc-Roussillon	11	1	23	409	Vignevieille	102	3	105
91	Languedoc-Roussillon	11	1	12	410	Villalier	934	16	950
91	Languedoc-Roussillon	11	1	21	411	Villanière	144	1	145
91	Languedoc-Roussillon	11	1	18	414	Villar-en-Val	35	0	35
91	Languedoc-Roussillon	11	2	27	415	Villar-Saint-Anselme	95	1	96
91	Languedoc-Roussillon	11	2	27	412	Villardebelle	68	2	70
91	Languedoc-Roussillon	11	1	21	413	Villardonnel	535	8	543
91	Languedoc-Roussillon	11	1	12	416	Villarzel-Cabardès	191	2	193
91	Languedoc-Roussillon	11	2	01	417	Villarzel-du-Razès	96	6	102
91	Languedoc-Roussillon	11	1	16	418	Villasavary	1200	21	1221
91	Languedoc-Roussillon	11	1	05	419	Villautou	57	2	59
91	Languedoc-Roussillon	11	2	27	420	Villebazy	113	2	115
91	Languedoc-Roussillon	11	3	33	421	Villedaigne	452	6	458
91	Languedoc-Roussillon	11	1	06	422	Villedubert	334	11	345
91	Languedoc-Roussillon	11	2	27	423	Villefloure	147	1	148
91	Languedoc-Roussillon	11	2	11	424	Villefort	101	0	101
91	Languedoc-Roussillon	11	1	12	425	Villegailhenc	1633	30	1663
91	Languedoc-Roussillon	11	1	12	426	Villegly	1051	23	1074
91	Languedoc-Roussillon	11	2	20	427	Villelongue-d;Aude	325	15	340
91	Languedoc-Roussillon	11	1	09	428	Villemagne	283	3	286
91	Languedoc-Roussillon	11	1	12	429	Villemoustaussou	3479	78	3557
91	Languedoc-Roussillon	11	1	10	430	Villeneuve-la-Comptal	1226	38	1264
91	Languedoc-Roussillon	11	3	15	431	Villeneuve-les-Corbières	267	3	270
91	Languedoc-Roussillon	11	1	22	432	Villeneuve-lès-Montréal	258	5	263
91	Languedoc-Roussillon	11	1	25	433	Villeneuve-Minervois	1032	8	1040
91	Languedoc-Roussillon	11	1	10	434	Villepinte	1231	23	1254
91	Languedoc-Roussillon	11	1	23	435	Villerouge-Termenès	155	10	165
91	Languedoc-Roussillon	11	3	15	436	Villesèque-des-Corbières	396	12	408
91	Languedoc-Roussillon	11	1	02	437	Villesèquelande	821	15	836
91	Languedoc-Roussillon	11	1	16	438	Villesiscle	352	1	353
91	Languedoc-Roussillon	11	1	09	439	Villespy	346	8	354
91	Languedoc-Roussillon	11	1	18	440	Villetritouls	39	2	41
91	Languedoc-Roussillon	11	3	14	441	Vinassan	2499	46	2545
73	Midi-Pyrénées	12	2	24	001	Agen-d;Aveyron	1077	36	1113
73	Midi-Pyrénées	12	1	17	002	Aguessac	860	33	893
73	Midi-Pyrénées	12	3	06	003	Les Albres	337	6	343
73	Midi-Pyrénées	12	3	10	004	Almont-les-Junies	487	13	500
73	Midi-Pyrénées	12	2	33	005	Alpuech	77	4	81
73	Midi-Pyrénées	12	1	37	006	Alrance	400	7	407
73	Midi-Pyrénées	12	3	43	007	Ambeyrac	185	4	189
73	Midi-Pyrénées	12	2	27	008	Anglars-Saint-Félix	709	12	721
73	Midi-Pyrénées	12	1	04	009	Arnac-sur-Dourdou	27	0	27
73	Midi-Pyrénées	12	2	24	010	Arques	118	1	119
73	Midi-Pyrénées	12	2	07	011	Arvieu	865	18	883
73	Midi-Pyrénées	12	3	06	012	Asprières	683	13	696
73	Midi-Pyrénées	12	3	01	013	Aubin	4044	175	4219
73	Midi-Pyrénées	12	2	34	014	Aurelle-Verlac	165	1	166
73	Midi-Pyrénées	12	2	07	015	Auriac-Lagast	241	6	247
73	Midi-Pyrénées	12	2	27	016	Auzits	862	28	890
73	Midi-Pyrénées	12	1	35	017	Ayssènes	214	1	215
73	Midi-Pyrénées	12	3	06	018	Balaguier-d;Olt	127	2	129
73	Midi-Pyrénées	12	1	36	019	Balaguier-sur-Rance	104	2	106
73	Midi-Pyrénées	12	2	16	020	Balsac	611	19	630
73	Midi-Pyrénées	12	2	39	056	Baraqueville	3041	114	3155
73	Midi-Pyrénées	12	3	26	021	La Bastide-l;Évêque	820	25	845
73	Midi-Pyrénées	12	1	29	022	La Bastide-Pradines	111	2	113
73	Midi-Pyrénées	12	1	36	023	La Bastide-Solages	116	1	117
73	Midi-Pyrénées	12	2	27	024	Belcastel	226	6	232
73	Midi-Pyrénées	12	1	02	025	Belmont-sur-Rance	998	21	1019
73	Midi-Pyrénées	12	2	15	026	Bertholène	999	29	1028
73	Midi-Pyrénées	12	2	12	027	Bessuéjouls	247	10	257
73	Midi-Pyrénées	12	3	10	028	Boisse-Penchot	538	3	541
73	Midi-Pyrénées	12	3	20	029	Bor-et-Bar	188	5	193
73	Midi-Pyrénées	12	3	06	030	Bouillac	438	6	444
73	Midi-Pyrénées	12	2	27	031	Bournazel	321	6	327
73	Midi-Pyrénées	12	2	39	032	Boussac	529	10	539
73	Midi-Pyrénées	12	2	03	033	Bozouls	2759	61	2820
73	Midi-Pyrénées	12	3	18	034	Brandonnet	309	11	320
73	Midi-Pyrénées	12	1	36	035	Brasc	204	2	206
73	Midi-Pyrénées	12	2	19	036	Brommat	693	18	711
73	Midi-Pyrénées	12	1	35	037	Broquiès	638	26	664
73	Midi-Pyrénées	12	1	35	038	Brousse-le-Château	155	4	159
73	Midi-Pyrénées	12	1	04	039	Brusque	305	5	310
73	Midi-Pyrénées	12	1	40	040	Buzeins	186	3	189
73	Midi-Pyrénées	12	2	22	041	Cabanès	224	9	233
73	Midi-Pyrénées	12	1	29	042	Calmels-et-le-Viala	232	11	243
73	Midi-Pyrénées	12	2	07	043	Calmont	2001	65	2066
73	Midi-Pyrénées	12	1	04	044	Camarès	976	41	1017
73	Midi-Pyrénées	12	2	39	045	Camboulazet	365	9	374
73	Midi-Pyrénées	12	2	22	046	Camjac	556	17	573
73	Midi-Pyrénées	12	1	05	047	Campagnac	455	12	467
73	Midi-Pyrénées	12	2	30	048	Campouriez	383	14	397
73	Midi-Pyrénées	12	2	13	049	Campuac	457	8	465
73	Midi-Pyrénées	12	2	24	050	Canet-de-Salars	421	9	430
73	Midi-Pyrénées	12	2	33	051	Cantoin	325	17	342
73	Midi-Pyrénées	12	3	06	052	Capdenac-Gare	4457	155	4612
73	Midi-Pyrénées	12	3	43	053	La Capelle-Balaguier	276	6	282
73	Midi-Pyrénées	12	3	26	054	La Capelle-Bleys	390	8	398
73	Midi-Pyrénées	12	1	05	055	La Capelle-Bonance	91	0	91
73	Midi-Pyrénées	12	2	07	057	Cassagnes-Bégonhès	903	44	947
73	Midi-Pyrénées	12	2	14	058	Cassuéjouls	130	5	135
73	Midi-Pyrénées	12	2	39	059	Castanet	538	34	572
73	Midi-Pyrénées	12	2	38	060	Castelmary	134	1	135
73	Midi-Pyrénées	12	2	12	061	Castelnau-de-Mandailles	542	9	551
73	Midi-Pyrénées	12	1	31	062	Castelnau-Pégayrols	329	2	331
73	Midi-Pyrénées	12	3	06	257	Causse-et-Diège	725	19	744
73	Midi-Pyrénées	12	1	21	063	La Cavalerie	1071	35	1106
73	Midi-Pyrénées	12	2	12	064	Le Cayrol	275	4	279
73	Midi-Pyrénées	12	2	22	065	Centrès	546	15	561
73	Midi-Pyrénées	12	2	16	066	Clairvaux-d;Aveyron	1152	29	1181
73	Midi-Pyrénées	12	1	09	067	Le Clapier	75	0	75
73	Midi-Pyrénées	12	2	39	068	Colombiès	951	15	966
73	Midi-Pyrénées	12	1	36	069	Combret	308	6	314
73	Midi-Pyrénées	12	1	17	070	Compeyre	517	18	535
73	Midi-Pyrénées	12	3	18	071	Compolibat	397	16	413
73	Midi-Pyrénées	12	1	44	072	Comprégnac	232	15	247
73	Midi-Pyrénées	12	2	07	073	Comps-la-Grand-Ville	542	6	548
73	Midi-Pyrénées	12	2	32	074	Condom-d;Aubrac	315	9	324
73	Midi-Pyrénées	12	2	25	075	Connac	109	3	112
73	Midi-Pyrénées	12	2	08	076	Conques	275	7	282
73	Midi-Pyrénées	12	1	09	077	Cornus	507	16	523
73	Midi-Pyrénées	12	1	35	078	Les Costes-Gozon	176	0	176
73	Midi-Pyrénées	12	2	13	079	Coubisou	541	13	554
73	Midi-Pyrénées	12	1	36	080	Coupiac	449	9	458
73	Midi-Pyrénées	12	2	15	081	Coussergues	252	5	257
73	Midi-Pyrénées	12	1	21	082	La Couvertoirade	175	10	185
73	Midi-Pyrénées	12	3	01	083	Cransac	1645	52	1697
73	Midi-Pyrénées	12	1	44	084	Creissels	1474	48	1522
73	Midi-Pyrénées	12	2	38	085	Crespin	256	7	263
73	Midi-Pyrénées	12	1	23	086	La Cresse	330	8	338
73	Midi-Pyrénées	12	2	15	087	Cruéjouls	417	7	424
73	Midi-Pyrénées	12	1	37	307	Curan	310	6	316
73	Midi-Pyrénées	12	2	14	088	Curières	234	8	242
73	Midi-Pyrénées	12	3	10	089	Decazeville	6012	193	6205
73	Midi-Pyrénées	12	2	45	090	Druelle	1972	71	2043
73	Midi-Pyrénées	12	3	18	091	Drulhe	413	11	424
73	Midi-Pyrénées	12	2	25	092	Durenque	553	12	565
73	Midi-Pyrénées	12	2	11	094	Entraygues-sur-Truyère	1168	32	1200
73	Midi-Pyrénées	12	2	27	095	Escandolières	204	7	211
73	Midi-Pyrénées	12	2	12	096	Espalion	4341	151	4492
73	Midi-Pyrénées	12	2	11	097	Espeyrac	248	5	253
73	Midi-Pyrénées	12	2	13	098	Estaing	600	6	606
73	Midi-Pyrénées	12	1	04	099	Fayet	260	8	268
73	Midi-Pyrénées	12	2	11	093	Le Fel	163	6	169
73	Midi-Pyrénées	12	3	01	100	Firmi	2517	57	2574
73	Midi-Pyrénées	12	3	10	101	Flagnac	984	18	1002
73	Midi-Pyrénées	12	2	24	102	Flavin	2247	61	2308
73	Midi-Pyrénées	12	2	30	103	Florentin-la-Capelle	328	12	340
73	Midi-Pyrénées	12	3	06	104	Foissac	454	10	464
73	Midi-Pyrénées	12	1	09	155	Fondamente	309	3	312
73	Midi-Pyrénées	12	3	20	105	La Fouillade	1113	35	1148
73	Midi-Pyrénées	12	2	03	106	Gabriac	487	13	500
73	Midi-Pyrénées	12	2	15	107	Gaillac-d;Aveyron	329	6	335
73	Midi-Pyrénées	12	3	18	108	Galgan	352	11	363
73	Midi-Pyrénées	12	1	04	109	Gissac	116	9	125
73	Midi-Pyrénées	12	2	11	110	Golinhac	404	11	415
73	Midi-Pyrénées	12	2	27	111	Goutrens	492	17	509
73	Midi-Pyrénées	12	2	33	112	Graissac	207	9	216
73	Midi-Pyrénées	12	2	39	113	Gramond	431	8	439
73	Midi-Pyrénées	12	2	08	114	Grand-Vabre	403	17	420
73	Midi-Pyrénées	12	1	21	115	L; Hospitalet-du-Larzac	316	7	323
73	Midi-Pyrénées	12	2	30	116	Huparlac	246	15	261
73	Midi-Pyrénées	12	2	33	117	Lacalm	197	10	207
73	Midi-Pyrénées	12	2	19	118	Lacroix-Barrez	489	13	502
73	Midi-Pyrénées	12	2	14	119	Laguiole	1256	53	1309
73	Midi-Pyrénées	12	2	15	120	Laissac	1580	52	1632
73	Midi-Pyrénées	12	3	18	121	Lanuéjouls	732	17	749
73	Midi-Pyrénées	12	1	40	123	Lapanouse	753	51	804
73	Midi-Pyrénées	12	1	09	122	Lapanouse-de-Cernon	118	3	121
73	Midi-Pyrénées	12	2	12	124	Lassouts	320	6	326
73	Midi-Pyrénées	12	1	36	125	Laval-Roquecezière	293	14	307
73	Midi-Pyrénées	12	1	40	126	Lavernhe	242	2	244
73	Midi-Pyrénées	12	2	25	127	Lédergues	705	16	721
73	Midi-Pyrénées	12	2	38	128	Lescure-Jaoul	255	7	262
73	Midi-Pyrénées	12	1	35	129	Lestrade-et-Thouels	467	11	478
73	Midi-Pyrénées	12	3	10	130	Livinhac-le-Haut	1113	32	1145
73	Midi-Pyrénées	12	2	03	131	La Loubière	1407	51	1458
73	Midi-Pyrénées	12	2	45	133	Luc-la-Primaube	5709	183	5892
73	Midi-Pyrénées	12	3	18	134	Lugan	332	13	345
73	Midi-Pyrénées	12	3	20	135	Lunac	439	15	454
73	Midi-Pyrénées	12	3	18	136	Maleville	919	20	939
73	Midi-Pyrénées	12	2	39	137	Manhac	723	10	733
73	Midi-Pyrénées	12	2	16	138	Marcillac-Vallon	1667	51	1718
73	Midi-Pyrénées	12	1	09	139	Marnhagues-et-Latour	140	1	141
73	Midi-Pyrénées	12	3	42	140	Martiel	915	34	949
73	Midi-Pyrénées	12	1	36	141	Martrin	219	6	225
73	Midi-Pyrénées	12	2	27	142	Mayran	577	9	586
73	Midi-Pyrénées	12	1	04	143	Mélagues	64	3	67
73	Midi-Pyrénées	12	2	22	144	Meljac	137	2	139
73	Midi-Pyrénées	12	1	97	145	Millau	21887	888	22775
73	Midi-Pyrénées	12	2	28	146	Le Monastère	2109	92	2201
73	Midi-Pyrénées	12	1	04	147	Montagnol	158	3	161
73	Midi-Pyrénées	12	3	18	148	Montbazens	1407	35	1442
73	Midi-Pyrénées	12	1	36	149	Montclar	153	3	156
73	Midi-Pyrénées	12	3	20	150	Monteils	549	97	646
73	Midi-Pyrénées	12	2	30	151	Montézic	248	8	256
73	Midi-Pyrénées	12	1	36	152	Montfranc	128	2	130
73	Midi-Pyrénées	12	1	31	153	Montjaux	386	12	398
73	Midi-Pyrénées	12	1	02	154	Montlaur	650	16	666
73	Midi-Pyrénées	12	2	14	156	Montpeyroux	559	16	575
73	Midi-Pyrénées	12	2	03	157	Montrozier	1433	46	1479
73	Midi-Pyrénées	12	3	43	158	Montsalès	248	4	252
73	Midi-Pyrénées	12	3	42	159	Morlhon-le-Haut	560	20	580
73	Midi-Pyrénées	12	1	23	160	Mostuéjouls	291	8	299
73	Midi-Pyrénées	12	1	02	192	Mounes-Prohencoux	184	9	193
73	Midi-Pyrénées	12	2	16	161	Mouret	510	12	522
73	Midi-Pyrénées	12	2	39	162	Moyrazès	1139	22	1161
73	Midi-Pyrénées	12	2	19	164	Mur-de-Barrez	816	30	846
73	Midi-Pyrénées	12	1	02	163	Murasson	194	9	203
73	Midi-Pyrénées	12	2	16	165	Muret-le-Château	334	15	349
73	Midi-Pyrénées	12	2	19	166	Murols	103	1	104
73	Midi-Pyrénées	12	3	20	167	Najac	754	20	774
73	Midi-Pyrénées	12	1	21	168	Nant	924	17	941
73	Midi-Pyrénées	12	2	22	169	Naucelle	2017	259	2276
73	Midi-Pyrénées	12	3	06	170	Naussac	333	16	349
73	Midi-Pyrénées	12	2	16	171	Nauviale	569	17	586
73	Midi-Pyrénées	12	2	13	172	Le Nayrac	551	12	563
73	Midi-Pyrénées	12	2	08	173	Noailhac	174	9	183
73	Midi-Pyrénées	12	2	45	174	Olemps	3182	118	3300
73	Midi-Pyrénées	12	3	43	175	Ols-et-Rinhodes	148	5	153
73	Midi-Pyrénées	12	2	46	176	Onet-le-Château	11084	555	11639
73	Midi-Pyrénées	12	2	15	177	Palmas	311	9	320
73	Midi-Pyrénées	12	1	17	178	Paulhe	348	17	365
73	Midi-Pyrénées	12	1	04	179	Peux-et-Couffouleux	104	4	108
73	Midi-Pyrénées	12	1	23	180	Peyreleau	78	6	84
73	Midi-Pyrénées	12	3	18	181	Peyrusse-le-Roc	220	7	227
73	Midi-Pyrénées	12	2	34	182	Pierrefiche	275	10	285
73	Midi-Pyrénées	12	1	36	183	Plaisance	212	14	226
73	Midi-Pyrénées	12	2	34	184	Pomayrols	137	0	137
73	Midi-Pyrénées	12	2	24	185	Pont-de-Salars	1635	50	1685
73	Midi-Pyrénées	12	1	36	186	Pousthomy	221	6	227
73	Midi-Pyrénées	12	2	34	187	Prades-d;Aubrac	411	6	417
73	Midi-Pyrénées	12	2	24	188	Prades-Salars	279	12	291
73	Midi-Pyrénées	12	2	39	189	Pradinas	372	13	385
73	Midi-Pyrénées	12	3	26	190	Prévinquières	301	13	314
73	Midi-Pyrénées	12	3	18	191	Privezac	331	4	335
73	Midi-Pyrénées	12	2	16	193	Pruines	284	7	291
73	Midi-Pyrénées	12	2	22	194	Quins	837	16	853
73	Midi-Pyrénées	12	1	02	195	Rebourguil	273	5	278
73	Midi-Pyrénées	12	1	40	196	Recoules-Prévinquières	471	15	486
73	Midi-Pyrénées	12	2	25	197	Réquista	2026	104	2130
73	Midi-Pyrénées	12	3	26	198	Rieupeyroux	2084	75	2159
73	Midi-Pyrénées	12	2	27	199	Rignac	1934	171	2105
73	Midi-Pyrénées	12	1	23	200	Rivière-sur-Tarn	1055	23	1078
73	Midi-Pyrénées	12	2	03	201	Rodelle	976	38	1014
73	Midi-Pyrénées	12	2	98	202	Rodez	23917	2057	25974
73	Midi-Pyrénées	12	1	23	204	La Roque-Sainte-Marguerite	198	7	205
73	Midi-Pyrénées	12	1	29	203	Roquefort-sur-Soulzon	666	24	690
73	Midi-Pyrénées	12	3	42	205	La Rouquette	737	30	767
73	Midi-Pyrénées	12	3	18	206	Roussennac	517	22	539
73	Midi-Pyrénées	12	2	25	207	Rullac-Saint-Cirq	382	11	393
73	Midi-Pyrénées	12	1	29	208	Saint-Affrique	8288	665	8953
73	Midi-Pyrénées	12	2	30	209	Saint-Amans-des-Cots	772	19	791
73	Midi-Pyrénées	12	3	20	210	Saint-André-de-Najac	418	13	431
73	Midi-Pyrénées	12	1	23	211	Saint-André-de-Vézines	126	3	129
73	Midi-Pyrénées	12	1	09	212	Saint-Beaulize	101	4	105
73	Midi-Pyrénées	12	1	31	213	Saint-Beauzély	529	12	541
73	Midi-Pyrénées	12	2	32	214	Saint-Chély-d;Aubrac	554	18	572
73	Midi-Pyrénées	12	2	16	215	Saint-Christophe-Vallon	1141	55	1196
73	Midi-Pyrénées	12	2	12	216	Saint-Côme-d;Olt	1365	38	1403
73	Midi-Pyrénées	12	2	08	218	Saint-Cyprien-sur-Dourdou	847	22	869
73	Midi-Pyrénées	12	2	08	221	Saint-Félix-de-Lunel	405	4	409
73	Midi-Pyrénées	12	1	29	222	Saint-Félix-de-Sorgues	198	3	201
73	Midi-Pyrénées	12	2	34	224	Saint-Geniez-d;Olt	2042	43	2085
73	Midi-Pyrénées	12	1	44	225	Saint-Georges-de-Luzençon	1567	52	1619
73	Midi-Pyrénées	12	2	11	226	Saint-Hippolyte	445	24	469
73	Midi-Pyrénées	12	3	43	227	Saint-Igest	177	4	181
73	Midi-Pyrénées	12	1	29	228	Saint-Izaire	311	15	326
73	Midi-Pyrénées	12	1	29	229	Saint-Jean-d;Alcapiès	258	7	265
73	Midi-Pyrénées	12	2	25	230	Saint-Jean-Delnous	430	9	439
73	Midi-Pyrénées	12	1	21	231	Saint-Jean-du-Bruel	682	9	691
73	Midi-Pyrénées	12	1	09	232	Saint-Jean-et-Saint-Paul	266	10	276
73	Midi-Pyrénées	12	1	36	233	Saint-Juéry	220	6	226
73	Midi-Pyrénées	12	2	22	235	Saint-Just-sur-Viaur	201	0	201
73	Midi-Pyrénées	12	1	05	237	Saint-Laurent-d;Olt	648	89	737
73	Midi-Pyrénées	12	1	41	236	Saint-Laurent-de-Lévézou	155	5	160
73	Midi-Pyrénées	12	1	41	238	Saint-Léons	363	10	373
73	Midi-Pyrénées	12	1	05	239	Saint-Martin-de-Lenne	302	4	306
73	Midi-Pyrénées	12	3	10	240	Saint-Parthem	401	9	410
73	Midi-Pyrénées	12	3	43	242	Saint-Rémy	318	3	321
73	Midi-Pyrénées	12	1	29	243	Saint-Rome-de-Cernon	772	10	782
73	Midi-Pyrénées	12	1	35	244	Saint-Rome-de-Tarn	861	11	872
73	Midi-Pyrénées	12	3	26	245	Saint-Salvadou	395	16	411
73	Midi-Pyrénées	12	3	10	246	Saint-Santin	546	4	550
73	Midi-Pyrénées	12	1	05	247	Saint-Saturnin-de-Lenne	344	6	350
73	Midi-Pyrénées	12	1	36	248	Saint-Sernin-sur-Rance	694	126	820
73	Midi-Pyrénées	12	1	02	249	Saint-Sever-du-Moustier	229	3	232
73	Midi-Pyrénées	12	2	30	250	Saint-Symphorien-de-Thénières	239	8	247
73	Midi-Pyrénées	12	1	35	251	Saint-Victor-et-Melvieu	381	4	385
73	Midi-Pyrénées	12	3	43	217	Sainte-Croix	729	27	756
73	Midi-Pyrénées	12	2	34	219	Sainte-Eulalie-d;Olt	366	11	377
73	Midi-Pyrénées	12	1	09	220	Sainte-Eulalie-de-Cernon	256	9	265
73	Midi-Pyrénées	12	2	33	223	Sainte-Geneviève-sur-Argence	1003	29	1032
73	Midi-Pyrénées	12	2	07	234	Sainte-Juliette-sur-Viaur	537	11	548
73	Midi-Pyrénées	12	2	28	241	Sainte-Radegonde	1658	57	1715
73	Midi-Pyrénées	12	3	06	252	Salles-Courbatiès	404	15	419
73	Midi-Pyrénées	12	1	37	253	Salles-Curan	1067	30	1097
73	Midi-Pyrénées	12	2	16	254	Salles-la-Source	2076	69	2145
73	Midi-Pyrénées	12	2	07	255	Salmiech	731	12	743
73	Midi-Pyrénées	12	3	43	256	Salvagnac-Cajarc	356	9	365
73	Midi-Pyrénées	12	2	38	258	La Salvetat-Peyralès	1066	20	1086
73	Midi-Pyrénées	12	3	20	259	Sanvensa	643	12	655
73	Midi-Pyrénées	12	1	21	260	Sauclières	173	1	174
73	Midi-Pyrénées	12	3	43	261	Saujac	128	3	131
73	Midi-Pyrénées	12	2	39	262	Sauveterre-de-Rouergue	799	24	823
73	Midi-Pyrénées	12	3	42	263	Savignac	608	22	630
73	Midi-Pyrénées	12	2	46	264	Sébazac-Concourès	3069	99	3168
73	Midi-Pyrénées	12	2	13	265	Sébrazac	509	11	520
73	Midi-Pyrénées	12	1	41	266	Ségur	578	13	591
73	Midi-Pyrénées	12	2	25	267	La Selve	652	23	675
73	Midi-Pyrénées	12	2	08	268	Sénergues	474	15	489
73	Midi-Pyrénées	12	1	36	269	La Serre	126	5	131
73	Midi-Pyrénées	12	2	15	271	Sévérac-l;Église	416	80	496
73	Midi-Pyrénées	12	1	40	270	Sévérac-le-Château	2424	93	2517
73	Midi-Pyrénées	12	3	06	272	Sonnac	466	11	477
73	Midi-Pyrénées	12	2	14	273	Soulages-Bonneval	272	7	279
73	Midi-Pyrénées	12	1	04	274	Sylvanès	96	2	98
73	Midi-Pyrénées	12	1	04	275	Tauriac-de-Camarès	61	2	63
73	Midi-Pyrénées	12	2	22	276	Tauriac-de-Naucelle	375	10	385
73	Midi-Pyrénées	12	2	19	277	Taussac	457	18	475
73	Midi-Pyrénées	12	2	38	278	Tayrac	170	8	178
73	Midi-Pyrénées	12	2	33	279	La Terrisse	164	6	170
73	Midi-Pyrénées	12	2	19	280	Thérondels	444	13	457
73	Midi-Pyrénées	12	3	42	281	Toulonjac	702	21	723
73	Midi-Pyrénées	12	1	29	282	Tournemire	393	12	405
73	Midi-Pyrénées	12	2	24	283	Trémouilles	512	13	525
73	Midi-Pyrénées	12	1	35	284	Le Truel	352	11	363
73	Midi-Pyrénées	12	3	26	285	Vabre-Tizac	436	7	443
73	Midi-Pyrénées	12	1	29	286	Vabres-l;Abbaye	1128	43	1171
73	Midi-Pyrénées	12	3	42	287	Vailhourles	658	20	678
73	Midi-Pyrénées	12	2	16	288	Valady	1548	32	1580
73	Midi-Pyrénées	12	3	18	289	Valzergues	196	13	209
73	Midi-Pyrénées	12	3	18	290	Vaureilles	517	16	533
73	Midi-Pyrénées	12	1	31	291	Verrières	429	14	443
73	Midi-Pyrénées	12	1	29	292	Versols-et-Lapeyre	445	7	452
73	Midi-Pyrénées	12	1	23	293	Veyreau	128	4	132
73	Midi-Pyrénées	12	1	41	294	Vézins-de-Lévézou	653	11	664
73	Midi-Pyrénées	12	1	09	295	Viala-du-Pas-de-Jaux	99	1	100
73	Midi-Pyrénées	12	1	31	296	Viala-du-Tarn	531	17	548
73	Midi-Pyrénées	12	2	24	297	Le Vibal	470	9	479
73	Midi-Pyrénées	12	2	13	298	Villecomtal	422	12	434
73	Midi-Pyrénées	12	1	37	299	Villefranche-de-Panat	761	23	784
73	Midi-Pyrénées	12	3	42	300	Villefranche-de-Rouergue	12124	757	12881
73	Midi-Pyrénées	12	3	43	301	Villeneuve	1947	68	2015
73	Midi-Pyrénées	12	2	15	303	Vimenet	257	5	262
73	Midi-Pyrénées	12	2	33	304	Vitrac-en-Viadène	112	1	113
73	Midi-Pyrénées	12	3	01	305	Viviez	1375	53	1428
93	Provence-Alpes-Côte d;Azur	13	1	97	001	Aix-en-Provence	141438	3446	144884
93	Provence-Alpes-Côte d;Azur	13	3	35	002	Allauch	19521	254	19775
93	Provence-Alpes-Côte d;Azur	13	2	09	003	Alleins	2414	52	2466
93	Provence-Alpes-Côte d;Azur	13	2	98	004	Arles	52661	1124	53785
93	Provence-Alpes-Côte d;Azur	13	3	94	005	Aubagne	46423	469	46892
93	Provence-Alpes-Côte d;Azur	13	2	09	006	Aureille	1499	32	1531
93	Provence-Alpes-Côte d;Azur	13	3	29	007	Auriol	11764	106	11870
93	Provence-Alpes-Côte d;Azur	13	1	51	008	Aurons	532	13	545
93	Provence-Alpes-Côte d;Azur	13	1	51	009	La Barben	684	19	703
93	Provence-Alpes-Côte d;Azur	13	2	07	010	Barbentane	3791	184	3975
93	Provence-Alpes-Côte d;Azur	13	2	31	011	Les Baux-de-Provence	436	6	442
93	Provence-Alpes-Côte d;Azur	13	1	34	012	Beaurecueil	613	24	637
93	Provence-Alpes-Côte d;Azur	13	3	29	013	Belcodène	1799	59	1858
93	Provence-Alpes-Côte d;Azur	13	4	06	014	Berre-l;Étang	13582	114	13696
93	Provence-Alpes-Côte d;Azur	13	1	10	015	Bouc-Bel-Air	13679	349	14028
93	Provence-Alpes-Côte d;Azur	13	3	29	016	La Bouilladisse	5990	58	6048
93	Provence-Alpes-Côte d;Azur	13	2	33	017	Boulbon	1535	20	1555
93	Provence-Alpes-Côte d;Azur	13	2	26	018	Cabannes	4319	75	4394
93	Provence-Alpes-Côte d;Azur	13	1	52	019	Cabriès	8572	268	8840
93	Provence-Alpes-Côte d;Azur	13	3	29	020	Cadolive	2124	28	2152
93	Provence-Alpes-Côte d;Azur	13	3	54	119	Carnoux-en-Provence	6862	114	6976
93	Provence-Alpes-Côte d;Azur	13	4	48	021	Carry-le-Rouet	6305	131	6436
93	Provence-Alpes-Côte d;Azur	13	3	54	022	Cassis	7722	108	7830
93	Provence-Alpes-Côte d;Azur	13	3	08	023	Ceyreste	4112	74	4186
93	Provence-Alpes-Côte d;Azur	13	1	12	024	Charleval	2481	47	2528
93	Provence-Alpes-Côte d;Azur	13	1	34	025	Châteauneuf-le-Rouge	2123	48	2171
93	Provence-Alpes-Côte d;Azur	13	4	48	026	Châteauneuf-les-Martigues	11665	131	11796
93	Provence-Alpes-Côte d;Azur	13	2	07	027	Châteaurenard	14928	151	15079
93	Provence-Alpes-Côte d;Azur	13	3	08	028	La Ciotat	33829	429	34258
93	Provence-Alpes-Côte d;Azur	13	1	51	029	Cornillon-Confoux	1337	29	1366
93	Provence-Alpes-Côte d;Azur	13	1	51	118	Coudoux	3448	53	3501
93	Provence-Alpes-Côte d;Azur	13	3	54	030	Cuges-les-Pins	4873	67	4940
93	Provence-Alpes-Côte d;Azur	13	3	29	031	La Destrousse	2953	45	2998
93	Provence-Alpes-Côte d;Azur	13	1	02	032	Éguilles	7554	229	7783
93	Provence-Alpes-Côte d;Azur	13	4	48	033	Ensuès-la-Redonne	5225	91	5316
93	Provence-Alpes-Côte d;Azur	13	2	26	034	Eygalières	1775	41	1816
93	Provence-Alpes-Côte d;Azur	13	2	09	035	Eyguières	6404	103	6507
93	Provence-Alpes-Côte d;Azur	13	2	07	036	Eyragues	4170	110	4280
93	Provence-Alpes-Côte d;Azur	13	1	51	037	La Fare-les-Oliviers	6895	98	6993
93	Provence-Alpes-Côte d;Azur	13	2	03	038	Fontvieille	3621	89	3710
93	Provence-Alpes-Côte d;Azur	13	4	49	039	Fos-sur-Mer	15357	305	15662
93	Provence-Alpes-Côte d;Azur	13	1	34	040	Fuveau	9247	182	9429
93	Provence-Alpes-Côte d;Azur	13	1	10	041	Gardanne	20474	325	20799
93	Provence-Alpes-Côte d;Azur	13	3	54	042	Gémenos	6137	108	6245
93	Provence-Alpes-Côte d;Azur	13	4	48	043	Gignac-la-Nerthe	9018	94	9112
93	Provence-Alpes-Côte d;Azur	13	1	32	044	Grans	4245	104	4349
93	Provence-Alpes-Côte d;Azur	13	2	07	045	Graveson	3914	67	3981
93	Provence-Alpes-Côte d;Azur	13	3	29	046	Gréasque	4109	54	4163
93	Provence-Alpes-Côte d;Azur	13	4	95	047	Istres	42544	1107	43651
93	Provence-Alpes-Côte d;Azur	13	1	27	048	Jouques	4238	55	4293
93	Provence-Alpes-Côte d;Azur	13	2	09	049	Lamanon	1747	57	1804
93	Provence-Alpes-Côte d;Azur	13	1	12	050	Lambesc	9239	253	9492
93	Provence-Alpes-Côte d;Azur	13	1	51	051	Lançon-Provence	8326	126	8452
93	Provence-Alpes-Côte d;Azur	13	2	31	052	Maillane	2318	38	2356
93	Provence-Alpes-Côte d;Azur	13	2	09	053	Mallemort	6041	104	6145
93	Provence-Alpes-Côte d;Azur	13	4	36	054	Marignane	34485	288	34773
93	Provence-Alpes-Côte d;Azur	13	3	99	201	Marseille 1er Arrondissement	39349	351	39700
93	Provence-Alpes-Côte d;Azur	13	3	16	202	Marseille 2e  Arrondissement	25495	205	25700
93	Provence-Alpes-Côte d;Azur	13	3	99	203	Marseille 3e  Arrondissement	44975	260	45235
93	Provence-Alpes-Côte d;Azur	13	3	99	204	Marseille 4e  Arrondissement	47911	451	48362
93	Provence-Alpes-Côte d;Azur	13	3	99	205	Marseille 5e  Arrondissement	45535	397	45932
93	Provence-Alpes-Côte d;Azur	13	3	99	206	Marseille 6e  Arrondissement	42133	596	42729
93	Provence-Alpes-Côte d;Azur	13	3	99	207	Marseille 7e  Arrondissement	35904	428	36332
93	Provence-Alpes-Côte d;Azur	13	3	99	208	Marseille 8e  Arrondissement	78001	1524	79525
93	Provence-Alpes-Côte d;Azur	13	3	99	209	Marseille 9e  Arrondissement	75234	868	76102
93	Provence-Alpes-Côte d;Azur	13	3	99	210	Marseille 10e  Arrondissement	52567	516	53083
93	Provence-Alpes-Côte d;Azur	13	3	99	211	Marseille 11e  Arrondissement	57302	606	57908
93	Provence-Alpes-Côte d;Azur	13	3	99	212	Marseille 12e  Arrondissement	59561	682	60243
93	Provence-Alpes-Côte d;Azur	13	3	99	213	Marseille 13e  Arrondissement	90256	922	91178
93	Provence-Alpes-Côte d;Azur	13	3	99	214	Marseille 14e  Arrondissement	60070	328	60398
93	Provence-Alpes-Côte d;Azur	13	3	99	215	Marseille 15e  Arrondissement	79300	359	79659
93	Provence-Alpes-Côte d;Azur	13	3	39	216	Marseille 16e  Arrondissement	17133	149	17282
93	Provence-Alpes-Côte d;Azur	13	4	96	056	Martigues	47544	717	48261
93	Provence-Alpes-Côte d;Azur	13	2	33	057	Mas-Blanc-des-Alpilles	502	4	506
93	Provence-Alpes-Côte d;Azur	13	2	31	058	Maussane-les-Alpilles	2132	41	2173
93	Provence-Alpes-Côte d;Azur	13	1	27	059	Meyrargues	3578	67	3645
93	Provence-Alpes-Côte d;Azur	13	1	02	060	Meyreuil	5295	108	5403
93	Provence-Alpes-Côte d;Azur	13	1	10	062	Mimet	4519	76	4595
93	Provence-Alpes-Côte d;Azur	13	4	11	063	Miramas	25368	455	25823
93	Provence-Alpes-Côte d;Azur	13	2	26	064	Mollégès	2547	35	2582
93	Provence-Alpes-Côte d;Azur	13	2	09	065	Mouriès	3560	89	3649
93	Provence-Alpes-Côte d;Azur	13	2	07	066	Noves	5233	72	5305
93	Provence-Alpes-Côte d;Azur	13	2	26	067	Orgon	3118	58	3176
93	Provence-Alpes-Côte d;Azur	13	2	31	068	Paradou	1417	36	1453
93	Provence-Alpes-Côte d;Azur	13	1	51	069	Pélissanne	9518	253	9771
93	Provence-Alpes-Côte d;Azur	13	3	05	070	La Penne-sur-Huveaune	6336	60	6396
93	Provence-Alpes-Côte d;Azur	13	1	52	071	Les Pennes-Mirabeau	19482	224	19706
93	Provence-Alpes-Côte d;Azur	13	1	34	072	Peynier	2943	165	3108
93	Provence-Alpes-Côte d;Azur	13	3	29	073	Peypin	5384	52	5436
93	Provence-Alpes-Côte d;Azur	13	1	27	074	Peyrolles-en-Provence	4682	90	4772
93	Provence-Alpes-Côte d;Azur	13	2	26	076	Plan-d;Orgon	2895	36	2931
93	Provence-Alpes-Côte d;Azur	13	3	35	075	Plan-de-Cuques	10917	65	10982
93	Provence-Alpes-Côte d;Azur	13	4	50	077	Port-de-Bouc	17216	330	17546
93	Provence-Alpes-Côte d;Azur	13	2	28	078	Port-Saint-Louis-du-Rhône	8638	110	8748
93	Provence-Alpes-Côte d;Azur	13	1	27	080	Le Puy-Sainte-Réparade	5299	90	5389
93	Provence-Alpes-Côte d;Azur	13	1	34	079	Puyloubier	1821	125	1946
93	Provence-Alpes-Côte d;Azur	13	4	06	081	Rognac	11770	158	11928
93	Provence-Alpes-Côte d;Azur	13	1	12	082	Rognes	4682	85	4767
93	Provence-Alpes-Côte d;Azur	13	2	07	083	Rognonas	4104	59	4163
93	Provence-Alpes-Côte d;Azur	13	1	12	084	La Roque-d;Anthéron	5186	70	5256
93	Provence-Alpes-Côte d;Azur	13	3	54	085	Roquefort-la-Bédoule	5052	83	5135
93	Provence-Alpes-Côte d;Azur	13	3	29	086	Roquevaire	8549	134	8683
93	Provence-Alpes-Côte d;Azur	13	1	34	087	Rousset	4432	114	4546
93	Provence-Alpes-Côte d;Azur	13	4	48	088	Le Rove	4273	43	4316
93	Provence-Alpes-Côte d;Azur	13	2	26	089	Saint-Andiol	3189	47	3236
93	Provence-Alpes-Côte d;Azur	13	1	34	090	Saint-Antonin-sur-Bayon	137	4	141
93	Provence-Alpes-Côte d;Azur	13	1	12	091	Saint-Cannat	5523	121	5644
93	Provence-Alpes-Côte d;Azur	13	4	06	092	Saint-Chamas	7778	156	7934
93	Provence-Alpes-Côte d;Azur	13	1	12	093	Saint-Estève-Janson	354	6	360
93	Provence-Alpes-Côte d;Azur	13	2	33	094	Saint-Étienne-du-Grès	2250	63	2313
93	Provence-Alpes-Côte d;Azur	13	1	01	095	Saint-Marc-Jaumegarde	1123	68	1191
93	Provence-Alpes-Côte d;Azur	13	2	03	097	Saint-Martin-de-Crau	11180	216	11396
93	Provence-Alpes-Côte d;Azur	13	4	49	098	Saint-Mitre-les-Remparts	5428	111	5539
93	Provence-Alpes-Côte d;Azur	13	1	27	099	Saint-Paul-lès-Durance	985	7	992
93	Provence-Alpes-Côte d;Azur	13	2	33	061	Saint-Pierre-de-Mézoargues	242	10	252
93	Provence-Alpes-Côte d;Azur	13	2	31	100	Saint-Rémy-de-Provence	10617	202	10819
93	Provence-Alpes-Côte d;Azur	13	3	29	101	Saint-Savournin	3239	38	3277
93	Provence-Alpes-Côte d;Azur	13	4	36	102	Saint-Victoret	6561	65	6626
93	Provence-Alpes-Côte d;Azur	13	2	30	096	Saintes-Maries-de-la-Mer	2296	37	2333
93	Provence-Alpes-Côte d;Azur	13	1	32	103	Salon-de-Provence	43152	678	43830
93	Provence-Alpes-Côte d;Azur	13	4	48	104	Sausset-les-Pins	7606	133	7739
93	Provence-Alpes-Côte d;Azur	13	2	26	105	Sénas	6540	89	6629
93	Provence-Alpes-Côte d;Azur	13	1	52	106	Septèmes-les-Vallons	11209	49	11258
93	Provence-Alpes-Côte d;Azur	13	1	10	107	Simiane-Collongue	5435	96	5531
93	Provence-Alpes-Côte d;Azur	13	2	33	108	Tarascon	13297	129	13426
93	Provence-Alpes-Côte d;Azur	13	1	01	109	Le Tholonet	2240	52	2292
93	Provence-Alpes-Côte d;Azur	13	1	34	110	Trets	10288	175	10463
93	Provence-Alpes-Côte d;Azur	13	1	01	111	Vauvenargues	992	23	1015
93	Provence-Alpes-Côte d;Azur	13	1	51	112	Velaux	8515	175	8690
93	Provence-Alpes-Côte d;Azur	13	1	01	113	Venelles	8185	224	8409
93	Provence-Alpes-Côte d;Azur	13	1	51	114	Ventabren	4581	178	4759
93	Provence-Alpes-Côte d;Azur	13	2	09	115	Vernègues	1437	27	1464
93	Provence-Alpes-Côte d;Azur	13	2	26	116	Verquières	803	14	817
93	Provence-Alpes-Côte d;Azur	13	4	53	117	Vitrolles	35021	438	35459
25	Basse-Normandie	14	3	19	001	Ablon	1189	17	1206
25	Basse-Normandie	14	2	31	002	Acqueville	186	5	191
25	Basse-Normandie	14	1	03	003	Agy	240	2	242
25	Basse-Normandie	14	1	33	004	Aignerville	200	3	203
25	Basse-Normandie	14	2	06	005	Airan	686	12	698
25	Basse-Normandie	14	2	16	006	Amayé-sur-Orne	1026	15	1041
25	Basse-Normandie	14	2	37	007	Amayé-sur-Seulles	200	4	204
25	Basse-Normandie	14	2	13	008	Amblie	262	7	269
25	Basse-Normandie	14	2	47	009	Amfreville	1185	20	1205
25	Basse-Normandie	14	1	11	011	Anctoville	1067	21	1088
25	Basse-Normandie	14	3	15	012	Angerville	143	6	149
25	Basse-Normandie	14	2	31	013	Angoville	34	0	34
25	Basse-Normandie	14	2	13	014	Anguerny	768	31	799
25	Basse-Normandie	14	2	13	015	Anisy	666	24	690
25	Basse-Normandie	14	3	15	016	Annebault	415	8	423
25	Basse-Normandie	14	1	03	019	Arganchy	239	8	247
25	Basse-Normandie	14	2	34	020	Argences	3544	55	3599
25	Basse-Normandie	14	1	28	021	Arromanches-les-Bains	587	10	597
25	Basse-Normandie	14	1	28	022	Asnelles	579	12	591
25	Basse-Normandie	14	1	20	023	Asnières-en-Bessin	58	0	58
25	Basse-Normandie	14	3	15	024	Auberville	487	19	506
25	Basse-Normandie	14	2	17	025	Aubigny	324	14	338
25	Basse-Normandie	14	2	32	026	Audrieu	1042	13	1055
25	Basse-Normandie	14	4	01	027	Aunay-sur-Odon	3099	48	3147
25	Basse-Normandie	14	3	23	028	Auquainville	307	5	312
25	Basse-Normandie	14	3	23	029	Les Autels-Saint-Bazile	48	2	50
25	Basse-Normandie	14	2	09	030	Authie	1394	41	1435
25	Basse-Normandie	14	3	24	031	Les Authieux-Papion	62	0	62
25	Basse-Normandie	14	3	05	032	Les Authieux-sur-Calonne	294	4	298
25	Basse-Normandie	14	3	10	033	Auvillars	220	2	222
25	Basse-Normandie	14	2	16	034	Avenay	519	4	523
25	Basse-Normandie	14	1	02	035	Balleroy	901	80	981
25	Basse-Normandie	14	2	34	036	Banneville-la-Campagne	142	1	143
25	Basse-Normandie	14	2	37	037	Banneville-sur-Ajon	379	15	394
25	Basse-Normandie	14	1	28	038	Banville	657	11	668
25	Basse-Normandie	14	2	07	039	Barbery	729	7	736
25	Basse-Normandie	14	1	03	040	Barbeville	180	2	182
25	Basse-Normandie	14	3	19	041	Barneville-la-Bertran	140	4	144
25	Basse-Normandie	14	2	16	042	Baron-sur-Odon	842	32	874
25	Basse-Normandie	14	2	25	043	Barou-en-Auge	95	1	96
25	Basse-Normandie	14	2	13	044	Basly	1093	10	1103
25	Basse-Normandie	14	3	15	045	Basseneville	260	4	264
25	Basse-Normandie	14	4	01	056	Bauquay	254	2	256
25	Basse-Normandie	14	2	47	046	Bavent	1734	29	1763
25	Basse-Normandie	14	1	03	047	Bayeux	13222	480	13702
25	Basse-Normandie	14	1	28	049	Bazenville	147	1	148
25	Basse-Normandie	14	1	02	050	La Bazoque	158	7	165
25	Basse-Normandie	14	3	10	231	Beaufour-Druval	433	8	441
25	Basse-Normandie	14	4	04	052	Beaulieu	174	1	175
25	Basse-Normandie	14	2	25	053	Beaumais	174	1	175
25	Basse-Normandie	14	4	30	054	Beaumesnil	210	7	217
25	Basse-Normandie	14	3	27	055	Beaumont-en-Auge	450	10	460
25	Basse-Normandie	14	2	06	057	Bellengreville	1596	22	1618
25	Basse-Normandie	14	3	23	058	Bellou	155	0	155
25	Basse-Normandie	14	3	35	059	Benerville-sur-Mer	483	36	519
25	Basse-Normandie	14	2	48	060	Bénouville	1984	44	2028
25	Basse-Normandie	14	4	04	061	Le Bény-Bocage	1033	19	1052
25	Basse-Normandie	14	2	13	062	Bény-sur-Mer	347	2	349
25	Basse-Normandie	14	1	33	063	Bernesq	195	3	198
25	Basse-Normandie	14	2	25	064	Bernières-d;Ailly	258	5	263
25	Basse-Normandie	14	4	36	065	Bernières-le-Patry	569	7	576
25	Basse-Normandie	14	2	14	066	Bernières-sur-Mer	2331	42	2373
25	Basse-Normandie	14	3	21	069	Beuvillers	1333	31	1364
25	Basse-Normandie	14	3	10	070	Beuvron-en-Auge	239	4	243
25	Basse-Normandie	14	2	48	068	Biéville-Beuville	2542	68	2610
25	Basse-Normandie	14	3	24	527	Biéville-Quétiéville	319	13	332
25	Basse-Normandie	14	4	01	073	La Bigne	197	4	201
25	Basse-Normandie	14	2	06	074	Billy	331	6	337
25	Basse-Normandie	14	3	24	075	Bissières	178	0	178
25	Basse-Normandie	14	2	48	076	Blainville-sur-Orne	5813	106	5919
25	Basse-Normandie	14	3	05	077	Blangy-le-Château	686	73	759
25	Basse-Normandie	14	1	33	078	Blay	373	3	376
25	Basse-Normandie	14	3	35	079	Blonville-sur-Mer	1602	41	1643
25	Basse-Normandie	14	2	31	080	Le Bô	105	4	109
25	Basse-Normandie	14	3	29	081	Boissey	224	0	224
25	Basse-Normandie	14	3	49	082	La Boissière	203	2	205
25	Basse-Normandie	14	3	10	083	Bonnebosq	716	20	736
25	Basse-Normandie	14	2	37	084	Bonnemaison	375	10	385
25	Basse-Normandie	14	3	05	085	Bonneville-la-Louvet	803	4	807
25	Basse-Normandie	14	3	27	086	Bonneville-sur-Touques	395	16	411
25	Basse-Normandie	14	2	17	087	Bonnoeil	113	0	113
25	Basse-Normandie	14	2	17	088	Bons-Tassilly	385	3	388
25	Basse-Normandie	14	2	16	089	Bougy	445	7	452
25	Basse-Normandie	14	2	07	090	Boulon	608	5	613
25	Basse-Normandie	14	3	15	091	Bourgeauville	139	2	141
25	Basse-Normandie	14	2	06	092	Bourguébus	1414	18	1432
25	Basse-Normandie	14	3	15	093	Branville	206	2	208
25	Basse-Normandie	14	4	01	096	Brémoy	216	8	224
25	Basse-Normandie	14	2	32	098	Bretteville-l;Orgueilleuse	2357	43	2400
25	Basse-Normandie	14	2	07	097	Bretteville-le-Rabet	258	3	261
25	Basse-Normandie	14	3	29	099	Bretteville-sur-Dives	295	7	302
25	Basse-Normandie	14	2	07	100	Bretteville-sur-Laize	1642	21	1663
25	Basse-Normandie	14	2	08	101	Bretteville-sur-Odon	4091	166	4257
25	Basse-Normandie	14	3	05	102	Le Breuil-en-Auge	977	27	1004
25	Basse-Normandie	14	1	33	103	Le Breuil-en-Bessin	399	5	404
25	Basse-Normandie	14	3	05	104	Le Brévedent	154	10	164
25	Basse-Normandie	14	3	23	105	La Brévière	121	6	127
25	Basse-Normandie	14	2	47	106	Bréville-les-Monts	656	5	661
25	Basse-Normandie	14	1	33	107	Bricqueville	143	1	144
25	Basse-Normandie	14	2	32	109	Brouay	472	6	478
25	Basse-Normandie	14	3	15	110	Brucourt	127	3	130
25	Basse-Normandie	14	2	07	116	Le Bû-sur-Rouvres	120	2	122
25	Basse-Normandie	14	1	02	111	Bucéels	382	5	387
25	Basse-Normandie	14	4	36	113	Burcy	372	12	384
25	Basse-Normandie	14	4	04	115	Bures-les-Monts	144	1	145
25	Basse-Normandie	14	2	47	117	Cabourg	3889	81	3970
25	Basse-Normandie	14	2	97	118	Caen	108954	2995	111949
25	Basse-Normandie	14	2	34	119	Cagny	1414	10	1424
25	Basse-Normandie	14	4	01	120	Cahagnes	1373	25	1398
25	Basse-Normandie	14	1	02	121	Cahagnolles	243	4	247
25	Basse-Normandie	14	2	16	122	La Caine	110	3	113
25	Basse-Normandie	14	2	13	123	Cairon	1616	46	1662
25	Basse-Normandie	14	1	20	124	La Cambe	635	8	643
25	Basse-Normandie	14	2	13	125	Cambes-en-Plaine	1387	55	1442
25	Basse-Normandie	14	3	10	126	Cambremer	1114	35	1149
25	Basse-Normandie	14	4	30	127	Campagnolles	449	9	458
25	Basse-Normandie	14	2	37	128	Campandré-Valcongrain	109	6	115
25	Basse-Normandie	14	4	04	129	Campeaux	555	8	563
25	Basse-Normandie	14	1	02	130	Campigny	186	3	189
25	Basse-Normandie	14	3	27	131	Canapville	219	5	224
25	Basse-Normandie	14	1	20	132	Canchy	219	3	222
25	Basse-Normandie	14	2	34	134	Canteloup	196	3	199
25	Basse-Normandie	14	2	32	135	Carcagny	302	4	306
25	Basse-Normandie	14	1	20	136	Cardonville	105	0	105
25	Basse-Normandie	14	2	09	137	Carpiquet	2374	36	2410
25	Basse-Normandie	14	1	20	138	Cartigny-l;Épinay	302	2	304
25	Basse-Normandie	14	4	04	139	Carville	374	3	377
25	Basse-Normandie	14	1	02	140	Castillon	322	10	332
25	Basse-Normandie	14	3	24	141	Castillon-en-Auge	151	3	154
25	Basse-Normandie	14	1	20	142	Castilly	287	4	291
25	Basse-Normandie	14	1	11	143	Caumont-l;Éventé	1350	12	1362
25	Basse-Normandie	14	2	31	144	Caumont-sur-Orne	84	0	84
25	Basse-Normandie	14	2	07	145	Cauvicourt	431	10	441
25	Basse-Normandie	14	2	31	146	Cauville	148	3	151
25	Basse-Normandie	14	3	26	147	Cernay	137	4	141
25	Basse-Normandie	14	3	26	148	Cerqueux	95	2	97
25	Basse-Normandie	14	2	06	149	Cesny-aux-Vignes	364	4	368
25	Basse-Normandie	14	2	31	150	Cesny-Bois-Halbout	644	11	655
25	Basse-Normandie	14	4	30	151	Champ-du-Boult	383	7	390
25	Basse-Normandie	14	4	12	152	La Chapelle-Engerbold	116	2	118
25	Basse-Normandie	14	3	23	153	La Chapelle-Haute-Grue	60	2	62
25	Basse-Normandie	14	3	26	154	La Chapelle-Yvon	537	10	547
25	Basse-Normandie	14	3	23	155	Cheffreville-Tonnencourt	261	4	265
25	Basse-Normandie	14	4	36	156	Chênedollé	245	7	252
25	Basse-Normandie	14	2	32	157	Cheux	1267	17	1284
25	Basse-Normandie	14	2	06	158	Chicheboville	512	7	519
25	Basse-Normandie	14	1	02	159	Chouain	208	4	212
25	Basse-Normandie	14	2	07	160	Cintheaux	188	3	191
25	Basse-Normandie	14	3	27	161	Clarbec	383	9	392
25	Basse-Normandie	14	2	31	162	Clécy	1260	17	1277
25	Basse-Normandie	14	2	34	163	Cléville	351	4	355
25	Basse-Normandie	14	2	06	164	Clinchamps-sur-Orne	1101	22	1123
25	Basse-Normandie	14	2	48	166	Colleville-Montgomery	2169	36	2205
25	Basse-Normandie	14	1	33	165	Colleville-sur-Mer	177	3	180
25	Basse-Normandie	14	2	47	167	Colombelles	5585	68	5653
25	Basse-Normandie	14	1	33	168	Colombières	205	0	205
25	Basse-Normandie	14	1	28	169	Colombiers-sur-Seulles	170	0	170
25	Basse-Normandie	14	2	13	170	Colomby-sur-Thaon	388	14	402
25	Basse-Normandie	14	2	31	171	Combray	135	4	139
25	Basse-Normandie	14	1	28	172	Commes	399	17	416
25	Basse-Normandie	14	2	07	173	Condé-sur-Ifs	446	9	455
25	Basse-Normandie	14	4	12	174	Condé-sur-Noireau	5422	198	5620
25	Basse-Normandie	14	1	02	175	Condé-sur-Seulles	238	7	245
25	Basse-Normandie	14	2	06	176	Conteville	103	1	104
25	Basse-Normandie	14	3	05	177	Coquainvilliers	852	17	869
25	Basse-Normandie	14	3	10	178	Corbon	66	1	67
25	Basse-Normandie	14	3	21	179	Cordebugle	139	2	141
25	Basse-Normandie	14	2	17	180	Cordey	138	3	141
25	Basse-Normandie	14	2	46	181	Cormelles-le-Royal	4690	85	4775
25	Basse-Normandie	14	1	11	182	Cormolain	394	4	398
25	Basse-Normandie	14	2	31	183	Cossesseville	107	4	111
25	Basse-Normandie	14	1	03	184	Cottun	181	4	185
25	Basse-Normandie	14	3	27	185	Coudray-Rabut	305	7	312
25	Basse-Normandie	14	2	13	186	Coulombs	366	4	370
25	Basse-Normandie	14	4	38	187	Coulonces	733	8	741
25	Basse-Normandie	14	4	01	188	Coulvain	365	6	371
25	Basse-Normandie	14	3	24	189	Coupesarte	37	0	37
25	Basse-Normandie	14	2	25	190	Courcy	151	5	156
25	Basse-Normandie	14	2	13	191	Courseulles-sur-Mer	4153	56	4209
25	Basse-Normandie	14	4	30	192	Courson	431	13	444
25	Basse-Normandie	14	3	21	193	Courtonne-la-Meurdrac	694	19	713
25	Basse-Normandie	14	3	26	194	Courtonne-les-Deux-Églises	648	13	661
25	Basse-Normandie	14	2	37	195	Courvaudon	212	3	215
25	Basse-Normandie	14	1	28	196	Crépon	218	4	222
25	Basse-Normandie	14	2	14	197	Cresserons	1208	43	1251
25	Basse-Normandie	14	3	15	198	Cresseveuille	279	4	283
25	Basse-Normandie	14	2	13	200	Creully	1651	19	1670
25	Basse-Normandie	14	3	24	201	Crèvecoeur-en-Auge	515	3	518
25	Basse-Normandie	14	3	19	202	Cricqueboeuf	198	6	204
25	Basse-Normandie	14	3	15	203	Cricqueville-en-Auge	185	1	186
25	Basse-Normandie	14	1	20	204	Cricqueville-en-Bessin	192	5	197
25	Basse-Normandie	14	2	32	205	Cristot	227	4	231
25	Basse-Normandie	14	2	25	206	Crocy	303	1	304
25	Basse-Normandie	14	2	31	207	Croisilles	519	9	528
25	Basse-Normandie	14	3	24	208	Croissanville	442	7	449
25	Basse-Normandie	14	1	33	209	Crouay	550	11	561
25	Basse-Normandie	14	3	26	210	La Croupte	132	0	132
25	Basse-Normandie	14	2	31	211	Culey-le-Patry	345	4	349
25	Basse-Normandie	14	2	13	212	Cully	165	2	167
25	Basse-Normandie	14	2	16	213	Curcy-sur-Orne	443	20	463
25	Basse-Normandie	14	1	03	214	Cussy	148	6	154
25	Basse-Normandie	14	2	34	215	Cuverville	2051	32	2083
25	Basse-Normandie	14	2	18	216	Damblainville	232	5	237
25	Basse-Normandie	14	4	01	217	Dampierre	118	2	120
25	Basse-Normandie	14	3	15	218	Danestal	283	0	283
25	Basse-Normandie	14	4	01	219	Danvou-la-Ferrière	165	2	167
25	Basse-Normandie	14	3	35	220	Deauville	3866	96	3962
25	Basse-Normandie	14	2	34	221	Démouville	3329	83	3412
25	Basse-Normandie	14	4	36	222	Le Désert	81	1	82
25	Basse-Normandie	14	2	17	223	Le Détroit	91	0	91
25	Basse-Normandie	14	1	20	224	Deux-Jumeaux	73	0	73
25	Basse-Normandie	14	3	15	225	Dives-sur-Mer	5949	174	6123
25	Basse-Normandie	14	2	31	226	Donnay	182	7	189
25	Basse-Normandie	14	3	15	227	Douville-en-Auge	224	7	231
25	Basse-Normandie	14	2	14	228	Douvres-la-Délivrande	4959	274	5233
25	Basse-Normandie	14	3	15	229	Dozulé	1923	32	1955
25	Basse-Normandie	14	3	27	230	Drubec	111	4	115
25	Basse-Normandie	14	2	32	232	Ducy-Sainte-Marguerite	142	4	146
25	Basse-Normandie	14	1	33	235	Écrammeville	199	2	201
25	Basse-Normandie	14	1	02	236	Ellon	414	3	417
25	Basse-Normandie	14	2	34	237	Émiéville	548	14	562
25	Basse-Normandie	14	3	27	238	Englesqueville-en-Auge	112	5	117
25	Basse-Normandie	14	1	20	239	Englesqueville-la-Percée	86	1	87
25	Basse-Normandie	14	2	25	240	Épaney	474	9	483
25	Basse-Normandie	14	2	37	241	Épinay-sur-Odon	642	16	658
25	Basse-Normandie	14	2	40	242	Épron	1532	55	1587
25	Basse-Normandie	14	3	19	243	Équemauville	1280	14	1294
25	Basse-Normandie	14	2	18	244	Eraines	311	10	321
25	Basse-Normandie	14	2	25	245	Ernes	297	6	303
25	Basse-Normandie	14	2	47	246	Escoville	725	10	735
25	Basse-Normandie	14	2	31	248	Espins	223	7	230
25	Basse-Normandie	14	2	16	249	Esquay-Notre-Dame	1382	10	1392
25	Basse-Normandie	14	1	28	250	Esquay-sur-Seulles	338	9	347
25	Basse-Normandie	14	2	31	251	Esson	457	9	466
25	Basse-Normandie	14	2	07	252	Estrées-la-Campagne	234	2	236
25	Basse-Normandie	14	4	36	253	Estry	355	5	360
25	Basse-Normandie	14	2	16	254	Éterville	1376	37	1413
25	Basse-Normandie	14	4	04	255	Étouvy	309	7	316
25	Basse-Normandie	14	1	33	256	Étréham	278	8	286
25	Basse-Normandie	14	2	16	257	Évrecy	1616	68	1684
25	Basse-Normandie	14	2	98	258	Falaise	8279	262	8541
25	Basse-Normandie	14	3	26	259	Familly	126	7	133
25	Basse-Normandie	14	3	21	260	Fauguernon	251	10	261
25	Basse-Normandie	14	3	05	261	Le Faulq	329	14	343
25	Basse-Normandie	14	4	04	264	La Ferrière-Harang	311	3	314
25	Basse-Normandie	14	3	23	265	Fervaques	725	30	755
25	Basse-Normandie	14	2	16	266	Feuguerolles-Bully	1357	26	1383
25	Basse-Normandie	14	2	07	268	Fierville-Bray	492	6	498
25	Basse-Normandie	14	3	05	269	Fierville-les-Parcs	222	4	226
25	Basse-Normandie	14	3	21	270	Firfol	449	8	457
25	Basse-Normandie	14	2	44	271	Fleury-sur-Orne	4118	71	4189
25	Basse-Normandie	14	1	20	272	La Folie	119	1	120
25	Basse-Normandie	14	3	26	273	La Folletière-Abenon	154	4	158
25	Basse-Normandie	14	2	16	274	Fontaine-Étoupefour	1932	64	1996
25	Basse-Normandie	14	2	13	275	Fontaine-Henry	478	2	480
25	Basse-Normandie	14	2	07	276	Fontaine-le-Pin	362	8	370
25	Basse-Normandie	14	2	06	277	Fontenay-le-Marmion	1551	27	1578
25	Basse-Normandie	14	2	32	278	Fontenay-le-Pesnel	950	9	959
25	Basse-Normandie	14	4	30	279	Fontenermont	142	8	150
25	Basse-Normandie	14	3	10	280	Formentin	214	2	216
25	Basse-Normandie	14	1	33	281	Formigny	257	5	262
25	Basse-Normandie	14	1	11	282	Foulognes	200	3	203
25	Basse-Normandie	14	2	25	283	Fourches	214	3	217
25	Basse-Normandie	14	2	17	284	Fourneaux-le-Val	175	3	178
25	Basse-Normandie	14	3	10	285	Le Fournet	59	1	60
25	Basse-Normandie	14	3	19	286	Fourneville	498	19	517
25	Basse-Normandie	14	2	06	287	Frénouville	1681	21	1702
25	Basse-Normandie	14	2	13	288	Le Fresne-Camilly	827	26	853
25	Basse-Normandie	14	2	18	289	Fresné-la-Mère	546	9	555
25	Basse-Normandie	14	2	07	290	Fresney-le-Puceux	733	10	743
25	Basse-Normandie	14	2	07	291	Fresney-le-Vieux	274	2	276
25	Basse-Normandie	14	3	26	292	Friardel	242	2	244
25	Basse-Normandie	14	3	21	293	Fumichon	273	4	277
25	Basse-Normandie	14	2	06	294	Garcelles-Secqueville	770	8	778
25	Basse-Normandie	14	4	30	296	Le Gast	232	3	235
25	Basse-Normandie	14	2	16	297	Gavrus	520	9	529
25	Basse-Normandie	14	1	20	298	Géfosse-Fontenay	130	2	132
25	Basse-Normandie	14	3	19	299	Genneville	759	15	774
25	Basse-Normandie	14	3	10	300	Gerrots	54	0	54
25	Basse-Normandie	14	2	34	301	Giberville	4921	47	4968
25	Basse-Normandie	14	3	27	302	Glanville	176	5	181
25	Basse-Normandie	14	3	21	303	Glos	886	18	904
25	Basse-Normandie	14	2	47	306	Gonneville-en-Auge	430	10	440
25	Basse-Normandie	14	3	19	304	Gonneville-sur-Honfleur	808	17	825
25	Basse-Normandie	14	3	15	305	Gonneville-sur-Mer	642	11	653
25	Basse-Normandie	14	2	16	307	Goupillières	166	4	170
25	Basse-Normandie	14	3	15	308	Goustranville	188	0	188
25	Basse-Normandie	14	2	07	309	Gouvix	803	12	815
25	Basse-Normandie	14	2	07	310	Grainville-Langannerie	676	8	684
25	Basse-Normandie	14	2	32	311	Grainville-sur-Odon	1008	10	1018
25	Basse-Normandie	14	1	20	312	Grandcamp-Maisy	1752	15	1767
25	Basse-Normandie	14	3	24	313	Grandchamp-le-Château	68	2	70
25	Basse-Normandie	14	3	15	316	Grangues	248	6	254
25	Basse-Normandie	14	4	04	317	La Graverie	1125	36	1161
25	Basse-Normandie	14	1	28	318	Graye-sur-Mer	646	7	653
25	Basse-Normandie	14	2	06	319	Grentheville	919	17	936
25	Basse-Normandie	14	2	07	320	Grimbosq	269	0	269
25	Basse-Normandie	14	1	03	322	Guéron	233	11	244
25	Basse-Normandie	14	2	16	324	Hamars	433	5	438
25	Basse-Normandie	14	2	14	325	Hermanville-sur-Mer	2732	45	2777
25	Basse-Normandie	14	3	21	326	Hermival-les-Vaux	843	34	877
25	Basse-Normandie	14	2	93	327	Hérouville-Saint-Clair	21434	395	21829
25	Basse-Normandie	14	2	47	328	Hérouvillette	1101	18	1119
25	Basse-Normandie	14	3	15	329	Heuland	90	1	91
25	Basse-Normandie	14	3	23	330	Heurtevent	203	5	208
25	Basse-Normandie	14	3	29	331	Hiéville	290	4	294
25	Basse-Normandie	14	2	18	332	La Hoguette	689	23	712
25	Basse-Normandie	14	3	19	333	Honfleur	8093	200	8293
25	Basse-Normandie	14	3	21	334	L; Hôtellerie	317	1	318
25	Basse-Normandie	14	3	10	335	Hotot-en-Auge	307	10	317
25	Basse-Normandie	14	1	11	336	Hottot-les-Bagues	484	7	491
25	Basse-Normandie	14	3	49	337	La Houblonnière	345	5	350
25	Basse-Normandie	14	3	15	338	Houlgate	2086	49	2135
25	Basse-Normandie	14	2	06	339	Hubert-Folie	352	5	357
25	Basse-Normandie	14	2	46	341	Ifs	11028	164	11192
25	Basse-Normandie	14	1	20	342	Isigny-sur-Mer	2803	46	2849
25	Basse-Normandie	14	2	17	343	Les Isles-Bardel	65	1	66
25	Basse-Normandie	14	2	34	344	Janville	362	9	371
25	Basse-Normandie	14	2	25	345	Jort	337	4	341
25	Basse-Normandie	14	1	02	346	Juaye-Mondaye	678	14	692
25	Basse-Normandie	14	4	01	347	Jurques	667	8	675
25	Basse-Normandie	14	2	32	348	Juvigny-sur-Seulles	70	0	70
25	Basse-Normandie	14	2	06	349	Laize-la-Ville	619	9	628
25	Basse-Normandie	14	1	11	350	La Lande-sur-Drôme	64	1	65
25	Basse-Normandie	14	4	30	352	Landelles-et-Coupigny	817	13	830
25	Basse-Normandie	14	2	37	353	Landes-sur-Ajon	392	3	395
25	Basse-Normandie	14	2	14	354	Langrune-sur-Mer	1779	32	1811
25	Basse-Normandie	14	2	13	355	Lantheuil	653	15	668
25	Basse-Normandie	14	2	13	356	Lasson	601	19	620
25	Basse-Normandie	14	4	12	357	Lassy	348	6	354
25	Basse-Normandie	14	3	10	358	Léaupartie	82	3	85
25	Basse-Normandie	14	3	24	359	Lécaude	151	3	154
25	Basse-Normandie	14	2	17	360	Leffard	171	4	175
25	Basse-Normandie	14	4	12	361	Lénault	189	3	192
25	Basse-Normandie	14	3	49	362	Lessard-et-le-Chêne	154	10	164
25	Basse-Normandie	14	1	02	364	Lingèvres	492	12	504
25	Basse-Normandie	14	2	14	365	Lion-sur-Mer	2639	29	2668
25	Basse-Normandie	14	3	99	366	Lisieux	21640	907	22547
25	Basse-Normandie	14	1	20	367	Lison	484	8	492
25	Basse-Normandie	14	3	23	368	Lisores	309	13	322
25	Basse-Normandie	14	1	02	369	Litteau	261	5	266
25	Basse-Normandie	14	3	23	371	Livarot	2269	48	2317
25	Basse-Normandie	14	1	11	372	Livry	782	18	800
25	Basse-Normandie	14	2	37	373	Le Locheur	273	4	277
25	Basse-Normandie	14	4	01	374	Les Loges	141	3	144
25	Basse-Normandie	14	2	17	375	Les Loges-Saulces	172	3	175
25	Basse-Normandie	14	1	11	376	Longraye	240	5	245
25	Basse-Normandie	14	1	28	377	Longues-sur-Mer	648	16	664
25	Basse-Normandie	14	1	20	378	Longueville	281	7	288
25	Basse-Normandie	14	2	37	379	Longvillers	349	5	354
25	Basse-Normandie	14	2	32	380	Loucelles	203	3	206
25	Basse-Normandie	14	2	25	381	Louvagny	67	1	68
25	Basse-Normandie	14	1	33	382	Louvières	68	2	70
25	Basse-Normandie	14	2	44	383	Louvigny	2701	68	2769
25	Basse-Normandie	14	2	14	384	Luc-sur-Mer	3099	50	3149
25	Basse-Normandie	14	1	28	385	Magny-en-Bessin	154	5	159
25	Basse-Normandie	14	2	07	386	Magny-la-Campagne	584	5	589
25	Basse-Normandie	14	3	24	387	Magny-le-Freule	302	4	306
25	Basse-Normandie	14	4	38	388	Maisoncelles-la-Jourdan	472	13	485
25	Basse-Normandie	14	2	37	389	Maisoncelles-Pelvey	261	5	266
25	Basse-Normandie	14	2	37	390	Maisoncelles-sur-Ajon	202	5	207
25	Basse-Normandie	14	1	33	391	Maisons	396	10	406
25	Basse-Normandie	14	2	16	393	Maizet	303	4	307
25	Basse-Normandie	14	2	07	394	Maizières	455	11	466
25	Basse-Normandie	14	4	04	395	Malloué	30	0	30
25	Basse-Normandie	14	2	16	396	Maltot	812	30	842
25	Basse-Normandie	14	1	33	397	Mandeville-en-Bessin	335	9	344
25	Basse-Normandie	14	3	05	398	Manerbe	505	15	520
25	Basse-Normandie	14	3	05	399	Manneville-la-Pipard	319	9	328
25	Basse-Normandie	14	1	28	400	Le Manoir	201	2	203
25	Basse-Normandie	14	1	28	401	Manvieux	118	4	122
25	Basse-Normandie	14	2	25	402	Le Marais-la-Chapelle	92	2	94
25	Basse-Normandie	14	3	21	403	Marolles	689	15	704
25	Basse-Normandie	14	2	31	404	Martainville	96	1	97
25	Basse-Normandie	14	2	17	405	Martigny-sur-l;Ante	333	14	347
25	Basse-Normandie	14	2	13	406	Martragny	369	8	377
25	Basse-Normandie	14	2	14	407	Mathieu	1940	81	2021
25	Basse-Normandie	14	2	06	408	May-sur-Orne	1823	39	1862
25	Basse-Normandie	14	2	47	409	Merville-Franceville-Plage	2109	25	2134
25	Basse-Normandie	14	3	24	410	Méry-Corbon	961	8	969
25	Basse-Normandie	14	2	31	411	Meslay	213	2	215
25	Basse-Normandie	14	2	37	412	Le Mesnil-au-Grain	63	3	66
25	Basse-Normandie	14	4	01	413	Le Mesnil-Auzouf	338	7	345
25	Basse-Normandie	14	3	23	414	Le Mesnil-Bacley	221	5	226
25	Basse-Normandie	14	4	30	415	Le Mesnil-Benoist	52	0	52
25	Basse-Normandie	14	4	30	416	Le Mesnil-Caussois	123	0	123
25	Basse-Normandie	14	4	30	417	Mesnil-Clinchamps	985	25	1010
25	Basse-Normandie	14	3	23	418	Le Mesnil-Durand	310	13	323
25	Basse-Normandie	14	3	49	419	Le Mesnil-Eudes	301	7	308
25	Basse-Normandie	14	3	23	420	Le Mesnil-Germain	265	5	270
25	Basse-Normandie	14	3	21	421	Le Mesnil-Guillaume	586	9	595
25	Basse-Normandie	14	3	24	422	Le Mesnil-Mauger	1052	19	1071
25	Basse-Normandie	14	2	32	423	Le Mesnil-Patry	299	6	305
25	Basse-Normandie	14	4	30	424	Le Mesnil-Robert	203	2	205
25	Basse-Normandie	14	3	49	425	Le Mesnil-Simon	155	3	158
25	Basse-Normandie	14	3	05	426	Le Mesnil-sur-Blangy	173	5	178
25	Basse-Normandie	14	2	17	427	Le Mesnil-Villement	291	2	293
25	Basse-Normandie	14	3	26	429	Meulles	396	7	403
25	Basse-Normandie	14	1	28	430	Meuvaines	150	8	158
25	Basse-Normandie	14	3	24	431	Mézidon-Canon	4944	48	4992
25	Basse-Normandie	14	2	37	432	Missy	544	6	550
25	Basse-Normandie	14	3	29	433	Mittois	165	2	167
25	Basse-Normandie	14	1	02	370	Le Molay-Littry	3086	45	3131
25	Basse-Normandie	14	3	49	435	Les Monceaux	181	3	184
25	Basse-Normandie	14	1	03	436	Monceaux-en-Bessin	514	12	526
25	Basse-Normandie	14	2	43	437	Mondeville	9450	219	9669
25	Basse-Normandie	14	2	32	438	Mondrainville	461	3	464
25	Basse-Normandie	14	1	20	439	Monfréville	108	1	109
25	Basse-Normandie	14	4	04	441	Mont-Bertrand	243	4	247
25	Basse-Normandie	14	4	04	440	Montamy	90	0	90
25	Basse-Normandie	14	4	36	442	Montchamp	553	12	565
25	Basse-Normandie	14	4	04	443	Montchauvet	366	6	372
25	Basse-Normandie	14	3	24	444	Monteille	165	5	170
25	Basse-Normandie	14	1	02	445	Montfiquet	83	1	84
25	Basse-Normandie	14	2	16	446	Montigny	97	1	98
25	Basse-Normandie	14	3	10	448	Montreuil-en-Auge	46	1	47
25	Basse-Normandie	14	2	37	449	Monts-en-Bessin	425	10	435
25	Basse-Normandie	14	3	29	450	Montviette	177	5	182
25	Basse-Normandie	14	2	25	452	Morteaux-Couliboeuf	550	14	564
25	Basse-Normandie	14	1	33	453	Mosles	370	2	372
25	Basse-Normandie	14	2	32	454	Mouen	1342	36	1378
25	Basse-Normandie	14	2	07	455	Moulines	252	2	254
25	Basse-Normandie	14	2	06	456	Moult	1848	16	1864
25	Basse-Normandie	14	2	25	457	Les Moutiers-en-Auge	120	2	122
25	Basse-Normandie	14	2	07	458	Les Moutiers-en-Cinglais	419	58	477
25	Basse-Normandie	14	3	23	459	Les Moutiers-Hubert	49	3	52
25	Basse-Normandie	14	3	21	460	Moyaux	1354	18	1372
25	Basse-Normandie	14	2	07	461	Mutrécy	347	5	352
25	Basse-Normandie	14	1	20	462	Neuilly-la-Forêt	464	16	480
25	Basse-Normandie	14	1	03	465	Nonant	470	15	485
25	Basse-Normandie	14	3	05	466	Norolles	249	15	264
25	Basse-Normandie	14	2	17	467	Noron-l;Abbaye	339	3	342
25	Basse-Normandie	14	1	02	468	Noron-la-Poterie	342	2	344
25	Basse-Normandie	14	2	25	469	Norrey-en-Auge	100	2	102
25	Basse-Normandie	14	3	10	474	Notre-Dame-d;Estrées	168	5	173
25	Basse-Normandie	14	3	23	471	Notre-Dame-de-Courson	423	2	425
25	Basse-Normandie	14	3	24	473	Notre-Dame-de-Livaye	130	1	131
25	Basse-Normandie	14	2	37	475	Noyers-Bocage	1094	20	1114
25	Basse-Normandie	14	2	25	476	Olendon	189	7	196
25	Basse-Normandie	14	4	01	477	Ondefontaine	319	3	322
25	Basse-Normandie	14	3	26	478	Orbec	2344	86	2430
25	Basse-Normandie	14	1	20	480	Osmanville	625	9	634
25	Basse-Normandie	14	1	20	481	Les Oubeaux	226	4	230
25	Basse-Normandie	14	3	29	697	L; Oudon	1535	188	1723
25	Basse-Normandie	14	2	06	482	Ouézy	243	4	247
25	Basse-Normandie	14	2	16	483	Ouffières	189	1	190
25	Basse-Normandie	14	3	21	484	Ouilly-du-Houley	208	2	210
25	Basse-Normandie	14	2	07	486	Ouilly-le-Tesson	539	7	546
25	Basse-Normandie	14	3	21	487	Ouilly-le-Vicomte	871	26	897
25	Basse-Normandie	14	2	48	488	Ouistreham	9381	143	9524
25	Basse-Normandie	14	3	29	489	Ouville-la-Bien-Tournée	212	9	221
25	Basse-Normandie	14	2	37	491	Parfouru-sur-Odon	175	8	183
25	Basse-Normandie	14	3	19	492	Pennedepie	326	5	331
25	Basse-Normandie	14	3	24	493	Percy-en-Auge	249	2	251
25	Basse-Normandie	14	3	15	494	Périers-en-Auge	141	5	146
25	Basse-Normandie	14	2	48	495	Périers-sur-le-Dan	490	10	500
25	Basse-Normandie	14	4	12	496	Périgny	55	2	57
25	Basse-Normandie	14	2	25	497	Perrières	309	3	312
25	Basse-Normandie	14	2	18	498	Pertheville-Ners	250	1	251
25	Basse-Normandie	14	2	47	499	Petiville	523	10	533
25	Basse-Normandie	14	3	27	500	Pierrefitte-en-Auge	155	2	157
25	Basse-Normandie	14	2	17	501	Pierrefitte-en-Cinglais	260	2	262
25	Basse-Normandie	14	2	17	502	Pierrepont	94	1	95
25	Basse-Normandie	14	4	36	503	Pierres	197	6	203
25	Basse-Normandie	14	3	21	504	Le Pin	731	21	752
25	Basse-Normandie	14	2	31	505	Placy	133	4	137
25	Basse-Normandie	14	1	02	506	Planquery	212	8	220
25	Basse-Normandie	14	4	01	508	Le Plessis-Grimoult	359	6	365
25	Basse-Normandie	14	2	14	509	Plumetot	221	2	223
25	Basse-Normandie	14	2	31	510	La Pommeraye	46	0	46
25	Basse-Normandie	14	4	30	511	Pont-Bellanger	65	0	65
25	Basse-Normandie	14	2	17	764	Pont-d;Ouilly	1016	19	1035
25	Basse-Normandie	14	4	30	513	Pont-Farcy	538	5	543
25	Basse-Normandie	14	3	27	514	Pont-l;Évêque	4347	79	4426
25	Basse-Normandie	14	4	12	512	Pontécoulant	92	1	93
25	Basse-Normandie	14	1	28	515	Port-en-Bessin-Huppain	2116	35	2151
25	Basse-Normandie	14	2	17	516	Potigny	1783	33	1816
25	Basse-Normandie	14	2	06	517	Poussy-la-Campagne	94	1	95
25	Basse-Normandie	14	3	49	520	Le Pré-d;Auge	850	16	866
25	Basse-Normandie	14	2	16	519	Préaux-Bocage	118	5	123
25	Basse-Normandie	14	3	26	518	Préaux-Saint-Sébastien	36	1	37
25	Basse-Normandie	14	4	36	521	Presles	264	1	265
25	Basse-Normandie	14	3	49	522	Prêtreville	436	14	450
25	Basse-Normandie	14	4	12	523	Proussy	411	12	423
25	Basse-Normandie	14	3	15	524	Putot-en-Auge	293	14	307
25	Basse-Normandie	14	2	32	525	Putot-en-Bessin	389	11	400
25	Basse-Normandie	14	3	19	528	Quetteville	375	11	386
25	Basse-Normandie	14	1	03	529	Ranchy	205	2	207
25	Basse-Normandie	14	2	47	530	Ranville	1633	19	1652
25	Basse-Normandie	14	2	17	531	Rapilly	44	0	44
25	Basse-Normandie	14	4	04	532	Le Reculey	259	8	267
25	Basse-Normandie	14	3	10	533	Repentigny	89	2	91
25	Basse-Normandie	14	3	27	534	Reux	348	6	354
25	Basse-Normandie	14	2	13	535	Reviers	564	10	574
25	Basse-Normandie	14	3	19	536	La Rivière-Saint-Sauveur	1951	47	1998
25	Basse-Normandie	14	2	06	538	Rocquancourt	815	4	819
25	Basse-Normandie	14	4	36	539	La Rocque	94	4	98
25	Basse-Normandie	14	3	21	540	Rocques	315	19	334
25	Basse-Normandie	14	3	10	541	La Roque-Baignard	117	4	121
25	Basse-Normandie	14	2	13	542	Rosel	545	15	560
25	Basse-Normandie	14	2	32	543	Rots	1435	30	1465
25	Basse-Normandie	14	4	01	544	Roucamps	194	0	194
25	Basse-Normandie	14	4	38	545	Roullours	871	29	900
25	Basse-Normandie	14	2	07	546	Rouvres	225	6	231
25	Basse-Normandie	14	1	33	547	Rubercy	134	2	136
25	Basse-Normandie	14	2	13	548	Rucqueville	124	3	127
25	Basse-Normandie	14	4	36	549	Rully	218	3	221
25	Basse-Normandie	14	3	10	550	Rumesnil	93	4	97
25	Basse-Normandie	14	1	33	551	Russy	178	2	180
25	Basse-Normandie	14	1	28	552	Ryes	496	20	516
25	Basse-Normandie	14	2	37	553	Saint-Agnan-le-Malherbe	119	4	123
25	Basse-Normandie	14	2	06	554	Saint-Aignan-de-Cramesnil	505	6	511
25	Basse-Normandie	14	3	05	555	Saint-André-d;Hébertot	455	10	465
25	Basse-Normandie	14	2	06	556	Saint-André-sur-Orne	1904	27	1931
25	Basse-Normandie	14	3	35	557	Saint-Arnoult	1176	23	1199
25	Basse-Normandie	14	2	48	558	Saint-Aubin-d;Arquenay	793	19	812
25	Basse-Normandie	14	4	30	559	Saint-Aubin-des-Bois	224	9	233
25	Basse-Normandie	14	2	14	562	Saint-Aubin-sur-Mer	2154	29	2183
25	Basse-Normandie	14	3	27	563	Saint-Benoît-d;Hébertot	372	7	379
25	Basse-Normandie	14	4	36	564	Saint-Charles-de-Percy	193	6	199
25	Basse-Normandie	14	1	28	565	Saint-Côme-de-Fresné	237	4	241
25	Basse-Normandie	14	2	09	566	Saint-Contest	2443	90	2533
25	Basse-Normandie	14	3	26	570	Saint-Cyr-du-Ronceray	620	9	629
25	Basse-Normandie	14	3	26	571	Saint-Denis-de-Mailloc	324	8	332
25	Basse-Normandie	14	2	31	572	Saint-Denis-de-Méré	835	18	853
25	Basse-Normandie	14	4	04	573	Saint-Denis-Maisoncelles	101	0	101
25	Basse-Normandie	14	3	49	574	Saint-Désir	1662	102	1764
25	Basse-Normandie	14	3	27	575	Saint-Étienne-la-Thillaye	492	12	504
25	Basse-Normandie	14	2	13	577	Saint-Gabriel-Brécy	301	54	355
25	Basse-Normandie	14	3	19	578	Saint-Gatien-des-Bois	1363	17	1380
25	Basse-Normandie	14	4	01	579	Saint-Georges-d;Aunay	711	15	726
25	Basse-Normandie	14	3	29	580	Saint-Georges-en-Auge	96	3	99
25	Basse-Normandie	14	1	11	581	Saint-Germain-d;Ectot	337	3	340
25	Basse-Normandie	14	3	49	582	Saint-Germain-de-Livet	785	20	805
25	Basse-Normandie	14	3	23	583	Saint-Germain-de-Montgommery	159	5	164
25	Basse-Normandie	14	4	38	584	Saint-Germain-de-Tallevende-la-Lande-Vaumont	1969	73	2042
25	Basse-Normandie	14	4	12	585	Saint-Germain-du-Crioult	912	25	937
25	Basse-Normandie	14	1	20	586	Saint-Germain-du-Pert	180	6	186
25	Basse-Normandie	14	2	09	587	Saint-Germain-la-Blanche-Herbe	2475	49	2524
25	Basse-Normandie	14	2	17	588	Saint-Germain-Langot	311	3	314
25	Basse-Normandie	14	2	07	589	Saint-Germain-le-Vasson	983	14	997
25	Basse-Normandie	14	3	27	593	Saint-Hymer	671	19	690
25	Basse-Normandie	14	3	49	595	Saint-Jean-de-Livet	200	5	205
25	Basse-Normandie	14	4	01	596	Saint-Jean-des-Essartiers	210	4	214
25	Basse-Normandie	14	4	12	597	Saint-Jean-le-Blanc	341	7	348
25	Basse-Normandie	14	3	15	598	Saint-Jouin	195	7	202
25	Basse-Normandie	14	3	26	599	Saint-Julien-de-Mailloc	495	9	504
25	Basse-Normandie	14	3	24	600	Saint-Julien-le-Faucon	719	9	728
25	Basse-Normandie	14	3	27	601	Saint-Julien-sur-Calonne	190	2	192
25	Basse-Normandie	14	2	31	602	Saint-Lambert	248	1	249
25	Basse-Normandie	14	2	07	603	Saint-Laurent-de-Condel	506	8	514
25	Basse-Normandie	14	3	24	604	Saint-Laurent-du-Mont	194	7	201
25	Basse-Normandie	14	1	33	605	Saint-Laurent-sur-Mer	246	5	251
25	Basse-Normandie	14	3	15	606	Saint-Léger-Dubosq	175	4	179
25	Basse-Normandie	14	2	37	607	Saint-Louet-sur-Seulles	189	0	189
25	Basse-Normandie	14	3	24	608	Saint-Loup-de-Fribois	183	3	186
25	Basse-Normandie	14	1	03	609	Saint-Loup-Hors	315	4	319
25	Basse-Normandie	14	4	30	611	Saint-Manvieu-Bocage	569	18	587
25	Basse-Normandie	14	2	32	610	Saint-Manvieu-Norrey	1729	110	1839
25	Basse-Normandie	14	1	20	613	Saint-Marcouf	96	1	97
25	Basse-Normandie	14	3	27	620	Saint-Martin-aux-Chartrains	405	20	425
25	Basse-Normandie	14	3	26	621	Saint-Martin-de-Bienfaite-la-Cressonnière	506	7	513
25	Basse-Normandie	14	1	02	622	Saint-Martin-de-Blagny	126	2	128
25	Basse-Normandie	14	2	06	623	Saint-Martin-de-Fontenay	2504	34	2538
25	Basse-Normandie	14	3	22	625	Saint-Martin-de-la-Lieue	832	22	854
25	Basse-Normandie	14	3	26	626	Saint-Martin-de-Mailloc	883	15	898
25	Basse-Normandie	14	2	17	627	Saint-Martin-de-Mieux	428	8	436
25	Basse-Normandie	14	2	16	628	Saint-Martin-de-Sallen	597	6	603
25	Basse-Normandie	14	4	04	629	Saint-Martin-des-Besaces	1161	19	1180
25	Basse-Normandie	14	1	03	630	Saint-Martin-des-Entrées	623	23	646
25	Basse-Normandie	14	4	04	632	Saint-Martin-Don	247	2	249
25	Basse-Normandie	14	3	23	633	Saint-Martin-du-Mesnil-Oury	102	2	104
25	Basse-Normandie	14	3	23	634	Saint-Michel-de-Livet	200	6	206
25	Basse-Normandie	14	2	31	635	Saint-Omer	171	1	172
25	Basse-Normandie	14	4	04	636	Saint-Ouen-des-Besaces	355	5	360
25	Basse-Normandie	14	2	34	637	Saint-Ouen-du-Mesnil-Oger	206	5	211
25	Basse-Normandie	14	3	23	638	Saint-Ouen-le-Houx	82	2	84
25	Basse-Normandie	14	3	10	639	Saint-Ouen-le-Pin	285	2	287
25	Basse-Normandie	14	2	34	640	Saint-Pair	233	6	239
25	Basse-Normandie	14	1	02	643	Saint-Paul-du-Vernay	736	13	749
25	Basse-Normandie	14	3	05	644	Saint-Philbert-des-Champs	688	19	707
25	Basse-Normandie	14	3	15	645	Saint-Pierre-Azif	176	3	179
25	Basse-Normandie	14	2	17	646	Saint-Pierre-Canivet	377	4	381
25	Basse-Normandie	14	3	26	647	Saint-Pierre-de-Mailloc	496	17	513
25	Basse-Normandie	14	3	49	648	Saint-Pierre-des-Ifs	470	4	474
25	Basse-Normandie	14	2	17	649	Saint-Pierre-du-Bû	462	8	470
25	Basse-Normandie	14	4	01	650	Saint-Pierre-du-Fresne	199	1	200
25	Basse-Normandie	14	2	34	651	Saint-Pierre-du-Jonquet	210	1	211
25	Basse-Normandie	14	1	20	652	Saint-Pierre-du-Mont	74	1	75
25	Basse-Normandie	14	4	12	653	Saint-Pierre-la-Vieille	363	12	375
25	Basse-Normandie	14	3	29	654	Saint-Pierre-sur-Dives	3654	26	3680
25	Basse-Normandie	14	4	04	655	Saint-Pierre-Tarentaine	353	2	355
25	Basse-Normandie	14	2	31	656	Saint-Rémy	1079	18	1097
25	Basse-Normandie	14	3	15	657	Saint-Samson	333	3	336
25	Basse-Normandie	14	4	30	658	Saint-Sever-Calvados	1368	44	1412
25	Basse-Normandie	14	2	07	659	Saint-Sylvain	1289	14	1303
25	Basse-Normandie	14	3	15	660	Saint-Vaast-en-Auge	103	2	105
25	Basse-Normandie	14	2	32	661	Saint-Vaast-sur-Seulles	137	1	138
25	Basse-Normandie	14	4	12	662	Saint-Vigor-des-Mézerets	241	4	245
25	Basse-Normandie	14	1	03	663	Saint-Vigor-le-Grand	2011	59	2070
25	Basse-Normandie	14	2	32	568	Sainte-Croix-Grand-Tonne	295	4	299
25	Basse-Normandie	14	1	28	569	Sainte-Croix-sur-Mer	239	7	246
25	Basse-Normandie	14	3	23	576	Sainte-Foy-de-Montgommery	203	5	208
25	Basse-Normandie	14	1	11	590	Sainte-Honorine-de-Ducy	133	1	134
25	Basse-Normandie	14	1	33	591	Sainte-Honorine-des-Pertes	587	17	604
25	Basse-Normandie	14	2	16	592	Sainte-Honorine-du-Fay	1306	30	1336
25	Basse-Normandie	14	1	20	614	Sainte-Marguerite-d;Elle	757	12	769
25	Basse-Normandie	14	3	29	616	Sainte-Marguerite-de-Viette	394	6	400
25	Basse-Normandie	14	3	23	615	Sainte-Marguerite-des-Loges	190	6	196
25	Basse-Normandie	14	4	04	618	Sainte-Marie-Laumont	626	22	648
25	Basse-Normandie	14	4	30	619	Sainte-Marie-Outre-l;Eau	81	2	83
25	Basse-Normandie	14	1	11	664	Sallen	297	10	307
25	Basse-Normandie	14	2	47	665	Sallenelles	282	8	290
25	Basse-Normandie	14	2	34	666	Sannerville	1701	32	1733
25	Basse-Normandie	14	1	33	667	Saon	235	1	236
25	Basse-Normandie	14	1	33	668	Saonnet	253	4	257
25	Basse-Normandie	14	2	25	669	Sassy	184	2	186
25	Basse-Normandie	14	2	13	670	Secqueville-en-Bessin	355	5	360
25	Basse-Normandie	14	4	30	671	Sept-Frères	351	8	359
25	Basse-Normandie	14	1	11	672	Sept-Vents	409	9	418
25	Basse-Normandie	14	2	07	674	Soignolles	106	1	107
25	Basse-Normandie	14	2	06	675	Soliers	2156	25	2181
25	Basse-Normandie	14	1	28	676	Sommervieu	1068	34	1102
25	Basse-Normandie	14	2	17	677	Soulangy	258	6	264
25	Basse-Normandie	14	2	17	678	Soumont-Saint-Quentin	560	15	575
25	Basse-Normandie	14	1	03	679	Subles	655	18	673
25	Basse-Normandie	14	1	03	680	Sully	126	3	129
25	Basse-Normandie	14	1	33	681	Surrain	162	0	162
25	Basse-Normandie	14	3	27	682	Surville	455	25	480
25	Basse-Normandie	14	2	32	684	Tessel	221	4	225
25	Basse-Normandie	14	2	13	685	Thaon	1492	23	1515
25	Basse-Normandie	14	4	36	686	Le Theil-Bocage	244	8	252
25	Basse-Normandie	14	3	19	687	Le Theil-en-Auge	182	2	184
25	Basse-Normandie	14	3	29	688	Thiéville	312	8	320
25	Basse-Normandie	14	2	31	689	Thury-Harcourt	2022	41	2063
25	Basse-Normandie	14	1	28	690	Tierceville	174	2	176
25	Basse-Normandie	14	2	06	691	Tilly-la-Campagne	125	3	128
25	Basse-Normandie	14	2	32	692	Tilly-sur-Seulles	1537	28	1565
25	Basse-Normandie	14	3	26	693	Tordouet	271	7	278
25	Basse-Normandie	14	3	05	694	Le Torquesne	437	11	448
25	Basse-Normandie	14	1	11	695	Torteval-Quesnay	349	4	353
25	Basse-Normandie	14	3	23	696	Tortisambert	150	3	153
25	Basse-Normandie	14	2	34	698	Touffréville	290	10	300
25	Basse-Normandie	14	3	35	699	Touques	3995	90	4085
25	Basse-Normandie	14	1	33	700	Tour-en-Bessin	590	8	598
25	Basse-Normandie	14	3	35	701	Tourgéville	933	20	953
25	Basse-Normandie	14	2	37	702	Tournay-sur-Odon	365	8	373
25	Basse-Normandie	14	2	31	703	Tournebu	376	7	383
25	Basse-Normandie	14	4	04	704	Le Tourneur	599	9	608
25	Basse-Normandie	14	1	02	705	Tournières	182	1	183
25	Basse-Normandie	14	3	27	706	Tourville-en-Auge	250	11	261
25	Basse-Normandie	14	2	16	707	Tourville-sur-Odon	1103	26	1129
25	Basse-Normandie	14	2	37	708	Tracy-Bocage	345	6	351
25	Basse-Normandie	14	1	28	709	Tracy-sur-Mer	357	4	361
25	Basse-Normandie	14	2	17	710	Tréprel	109	1	110
25	Basse-Normandie	14	1	33	711	Trévières	935	17	952
25	Basse-Normandie	14	2	34	712	Troarn	3700	84	3784
25	Basse-Normandie	14	2	16	713	Trois-Monts	402	5	407
25	Basse-Normandie	14	1	02	714	Le Tronquay	751	14	765
25	Basse-Normandie	14	3	35	715	Trouville-sur-Mer	4821	146	4967
25	Basse-Normandie	14	1	02	716	Trungy	222	4	226
25	Basse-Normandie	14	4	38	717	Truttemer-le-Grand	631	20	651
25	Basse-Normandie	14	4	38	718	Truttemer-le-Petit	102	1	103
25	Basse-Normandie	14	2	07	719	Urville	502	7	509
25	Basse-Normandie	14	2	17	720	Ussy	863	16	879
25	Basse-Normandie	14	2	16	721	Vacognes-Neuilly	507	14	521
25	Basse-Normandie	14	1	11	722	La Vacquerie	288	4	292
25	Basse-Normandie	14	3	10	723	Valsemé	280	9	289
25	Basse-Normandie	14	2	47	724	Varaville	888	13	901
25	Basse-Normandie	14	4	36	726	Vassy	1786	51	1837
25	Basse-Normandie	14	1	02	727	Vaubadon	438	8	446
25	Basse-Normandie	14	1	03	728	Vaucelles	369	8	377
25	Basse-Normandie	14	3	29	729	Vaudeloges	211	4	215
25	Basse-Normandie	14	4	38	730	Vaudry	1513	59	1572
25	Basse-Normandie	14	3	27	731	Vauville	235	9	244
25	Basse-Normandie	14	1	28	732	Vaux-sur-Aure	323	10	333
25	Basse-Normandie	14	2	13	733	Vaux-sur-Seulles	292	6	298
25	Basse-Normandie	14	2	32	734	Vendes	303	6	309
25	Basse-Normandie	14	2	25	735	Vendeuvre	736	13	749
25	Basse-Normandie	14	1	28	739	Ver-sur-Mer	1572	22	1594
25	Basse-Normandie	14	2	18	737	Versainville	414	10	424
25	Basse-Normandie	14	2	16	738	Verson	3596	100	3696
25	Basse-Normandie	14	3	26	740	La Vespière	973	17	990
25	Basse-Normandie	14	2	31	741	Le Vey	91	3	94
25	Basse-Normandie	14	2	25	742	Vicques	55	0	55
25	Basse-Normandie	14	3	10	743	Victot-Pontfol	119	2	121
25	Basse-Normandie	14	1	28	744	Vienne-en-Bessin	281	7	288
25	Basse-Normandie	14	1	33	745	Vierville-sur-Mer	246	4	250
25	Basse-Normandie	14	4	36	746	Viessoix	808	15	823
25	Basse-Normandie	14	2	16	747	Vieux	636	13	649
25	Basse-Normandie	14	3	27	748	Vieux-Bourg	84	3	87
25	Basse-Normandie	14	2	07	749	Vieux-Fumé	440	11	451
25	Basse-Normandie	14	3	29	750	Vieux-Pont-en-Auge	300	6	306
25	Basse-Normandie	14	2	25	751	Vignats	272	3	275
25	Basse-Normandie	14	2	37	752	Villers-Bocage	3001	50	3051
25	Basse-Normandie	14	2	17	753	Villers-Canivet	731	13	744
25	Basse-Normandie	14	3	35	754	Villers-sur-Mer	2713	46	2759
25	Basse-Normandie	14	3	35	755	Villerville	765	23	788
25	Basse-Normandie	14	2	31	756	La Villette	194	3	197
25	Basse-Normandie	14	1	28	757	Villiers-le-Sec	291	2	293
25	Basse-Normandie	14	2	13	758	Villons-les-Buissons	705	16	721
25	Basse-Normandie	14	2	37	760	Villy-Bocage	772	14	786
25	Basse-Normandie	14	2	18	759	Villy-lez-Falaise	256	18	274
25	Basse-Normandie	14	2	34	761	Vimont	749	14	763
25	Basse-Normandie	14	4	38	762	Vire	11999	639	12638
25	Basse-Normandie	14	1	20	763	Vouilly	164	0	164
83	Auvergne	15	3	12	025	Albepierre-Bredons	222	8	230
83	Auvergne	15	3	01	001	Allanche	891	31	922
83	Auvergne	15	3	20	002	Alleuze	211	6	217
83	Auvergne	15	2	14	003	Ally	658	17	675
83	Auvergne	15	3	19	004	Andelat	440	12	452
83	Auvergne	15	3	19	005	Anglards-de-Saint-Flour	336	11	347
83	Auvergne	15	2	22	006	Anglards-de-Salers	815	15	830
83	Auvergne	15	3	05	007	Anterrieux	127	7	134
83	Auvergne	15	2	17	008	Antignac	282	7	289
83	Auvergne	15	2	15	009	Apchon	212	6	218
83	Auvergne	15	2	09	010	Arches	182	8	190
83	Auvergne	15	1	07	011	Arnac	152	3	155
83	Auvergne	15	1	26	012	Arpajon-sur-Cère	6053	273	6326
83	Auvergne	15	3	08	013	Auriac-l;Église	205	8	213
83	Auvergne	15	1	98	014	Aurillac	27924	1753	29677
83	Auvergne	15	2	09	015	Auzers	186	6	192
83	Auvergne	15	1	07	016	Ayrens	564	10	574
83	Auvergne	15	1	23	017	Badailhac	123	3	126
83	Auvergne	15	2	14	018	Barriac-les-Bosquets	163	5	168
83	Auvergne	15	2	17	019	Bassignac	224	9	233
83	Auvergne	15	2	04	020	Beaulieu	102	2	104
83	Auvergne	15	1	18	269	Besse	128	4	132
83	Auvergne	15	1	10	021	Boisset	607	9	616
83	Auvergne	15	3	08	022	Bonnac	162	3	165
83	Auvergne	15	2	14	024	Brageac	72	2	74
83	Auvergne	15	3	13	026	Brezons	205	1	206
83	Auvergne	15	1	11	027	Calvinet	483	9	492
83	Auvergne	15	1	23	028	Carlat	325	3	328
83	Auvergne	15	1	11	029	Cassaniouze	509	26	535
83	Auvergne	15	1	21	030	Cayrols	267	6	273
83	Auvergne	15	3	12	031	Celles	239	6	245
83	Auvergne	15	3	16	032	Celoux	78	2	80
83	Auvergne	15	3	13	033	Cézens	251	0	251
83	Auvergne	15	3	16	034	Chaliers	197	4	201
83	Auvergne	15	3	12	035	Chalinargues	430	5	435
83	Auvergne	15	2	09	036	Chalvignac	433	10	443
83	Auvergne	15	2	17	037	Champagnac	1062	55	1117
83	Auvergne	15	2	04	038	Champs-sur-Tarentaine-Marchal	1038	29	1067
83	Auvergne	15	3	06	040	Chanterelle	123	6	129
83	Auvergne	15	3	12	041	La Chapelle-d;Alagnon	239	7	246
83	Auvergne	15	3	08	042	La Chapelle-Laurent	334	8	342
83	Auvergne	15	3	01	043	Charmensac	86	3	89
83	Auvergne	15	3	12	044	Chastel-sur-Murat	139	5	144
83	Auvergne	15	3	05	045	Chaudes-Aigues	926	28	954
83	Auvergne	15	2	14	046	Chaussenac	234	5	239
83	Auvergne	15	3	12	047	Chavagnac	104	0	104
83	Auvergne	15	3	16	048	Chazelles	35	1	36
83	Auvergne	15	3	12	049	Cheylade	277	8	285
83	Auvergne	15	3	12	050	Le Claux	213	6	219
83	Auvergne	15	3	16	051	Clavières	234	9	243
83	Auvergne	15	2	15	052	Collandres	173	6	179
83	Auvergne	15	3	19	053	Coltines	454	5	459
83	Auvergne	15	3	06	054	Condat	996	35	1031
83	Auvergne	15	3	19	055	Coren	429	11	440
83	Auvergne	15	1	27	056	Crandelles	715	32	747
83	Auvergne	15	1	07	057	Cros-de-Montvert	218	3	221
83	Auvergne	15	1	23	058	Cros-de-Ronesque	130	3	133
83	Auvergne	15	3	20	059	Cussac	137	1	138
83	Auvergne	15	3	05	060	Deux-Verges	57	2	59
83	Auvergne	15	3	12	061	Dienne	261	6	267
83	Auvergne	15	2	09	063	Drugeac	353	6	359
83	Auvergne	15	2	14	064	Escorailles	71	0	71
83	Auvergne	15	3	05	065	Espinasse	72	1	73
83	Auvergne	15	2	22	066	Le Falgoux	144	6	150
83	Auvergne	15	2	22	067	Le Fau	26	1	27
83	Auvergne	15	3	16	068	Faverolles	302	16	318
83	Auvergne	15	3	08	069	Ferrières-Saint-Mary	251	6	257
83	Auvergne	15	2	22	070	Fontanges	214	4	218
83	Auvergne	15	1	10	071	Fournoulès	63	3	66
83	Auvergne	15	1	18	072	Freix-Anglards	195	5	200
83	Auvergne	15	3	05	073	Fridefont	96	3	99
83	Auvergne	15	1	25	074	Giou-de-Mamou	743	33	776
83	Auvergne	15	1	18	075	Girgols	77	0	77
83	Auvergne	15	1	07	076	Glénat	212	5	217
83	Auvergne	15	3	13	077	Gourdièges	64	1	65
83	Auvergne	15	3	05	078	Jabrun	147	11	158
83	Auvergne	15	2	09	079	Jaleyrac	374	10	384
83	Auvergne	15	1	23	081	Jou-sous-Monjou	112	5	117
83	Auvergne	15	3	01	080	Joursac	153	11	164
83	Auvergne	15	1	11	082	Junhac	328	6	334
83	Auvergne	15	1	27	083	Jussac	1871	56	1927
83	Auvergne	15	1	11	084	Labesserette	264	12	276
83	Auvergne	15	1	26	085	Labrousse	416	8	424
83	Auvergne	15	3	13	086	Lacapelle-Barrès	58	1	59
83	Auvergne	15	1	11	087	Lacapelle-del-Fraisse	309	11	320
83	Auvergne	15	1	07	088	Lacapelle-Viescamp	468	2	470
83	Auvergne	15	1	11	089	Ladinhac	493	8	501
83	Auvergne	15	1	11	090	Lafeuillade-en-Vézie	579	19	598
83	Auvergne	15	3	01	091	Landeyrat	102	2	104
83	Auvergne	15	2	04	092	Lanobre	1421	44	1465
83	Auvergne	15	1	11	093	Lapeyrugue	102	3	105
83	Auvergne	15	1	07	094	Laroquebrou	814	12	826
83	Auvergne	15	1	25	095	Laroquevieille	375	7	382
83	Auvergne	15	1	25	096	Lascelle	306	3	309
83	Auvergne	15	3	19	097	Lastic	108	7	115
83	Auvergne	15	3	08	098	Laurie	96	1	97
83	Auvergne	15	3	20	099	Lavastrie	239	5	244
83	Auvergne	15	3	12	100	Laveissenet	97	0	97
83	Auvergne	15	3	12	101	Laveissière	587	17	604
83	Auvergne	15	3	12	102	Lavigerie	104	1	105
83	Auvergne	15	1	11	103	Leucamp	235	3	238
83	Auvergne	15	1	10	104	Leynhac	356	10	366
83	Auvergne	15	3	08	105	Leyvaux	31	0	31
83	Auvergne	15	3	05	106	Lieutadès	204	12	216
83	Auvergne	15	3	16	107	Lorcières	187	3	190
83	Auvergne	15	3	16	108	Loubaresse	406	11	417
83	Auvergne	15	3	06	110	Lugarde	159	3	162
83	Auvergne	15	2	17	111	Madic	216	8	224
83	Auvergne	15	3	13	112	Malbo	133	2	135
83	Auvergne	15	1	25	113	Mandailles-Saint-Julien	197	4	201
83	Auvergne	15	3	06	114	Marcenat	515	11	526
83	Auvergne	15	3	06	116	Marchastel	154	10	164
83	Auvergne	15	1	21	117	Marcolès	616	50	666
83	Auvergne	15	1	25	118	Marmanhac	733	31	764
83	Auvergne	15	3	08	119	Massiac	1829	97	1926
83	Auvergne	15	2	09	120	Mauriac	3836	269	4105
83	Auvergne	15	3	05	121	Maurines	100	4	104
83	Auvergne	15	1	10	122	Maurs	2182	83	2265
83	Auvergne	15	2	09	123	Méallet	168	5	173
83	Auvergne	15	2	15	124	Menet	506	15	521
83	Auvergne	15	3	19	125	Mentières	126	0	126
83	Auvergne	15	3	08	126	Molèdes	98	5	103
83	Auvergne	15	3	08	127	Molompize	299	10	309
83	Auvergne	15	2	17	128	La Monselie	121	4	125
83	Auvergne	15	3	06	129	Montboudif	186	5	191
83	Auvergne	15	3	19	130	Montchamp	130	1	131
83	Auvergne	15	2	17	131	Le Monteil	260	4	264
83	Auvergne	15	3	06	132	Montgreleix	42	1	43
83	Auvergne	15	1	10	133	Montmurat	136	4	140
83	Auvergne	15	1	11	134	Montsalvy	875	22	897
83	Auvergne	15	1	07	135	Montvert	118	4	122
83	Auvergne	15	1	10	136	Mourjou	317	4	321
83	Auvergne	15	2	09	137	Moussages	269	7	276
83	Auvergne	15	3	12	138	Murat	1983	104	2087
83	Auvergne	15	3	13	139	Narnhac	75	1	76
83	Auvergne	15	1	27	140	Naucelles	1917	82	1999
83	Auvergne	15	3	12	141	Neussargues-Moissac	968	18	986
83	Auvergne	15	3	20	142	Neuvéglise	1108	23	1131
83	Auvergne	15	1	07	143	Nieudan	106	5	111
83	Auvergne	15	1	21	144	Omps	300	4	304
83	Auvergne	15	3	13	145	Oradour	279	15	294
83	Auvergne	15	1	23	146	Pailherols	159	7	166
83	Auvergne	15	1	21	147	Parlan	327	9	336
83	Auvergne	15	3	20	148	Paulhac	456	9	465
83	Auvergne	15	3	13	149	Paulhenc	258	4	262
83	Auvergne	15	1	21	150	Pers	302	6	308
83	Auvergne	15	3	01	151	Peyrusse	164	7	171
83	Auvergne	15	3	13	152	Pierrefort	900	23	923
83	Auvergne	15	2	14	153	Pleaux	1590	41	1631
83	Auvergne	15	1	23	154	Polminhac	1092	54	1146
83	Auvergne	15	3	01	155	Pradiers	92	3	95
83	Auvergne	15	1	26	156	Prunet	569	16	585
83	Auvergne	15	1	10	157	Quézac	323	51	374
83	Auvergne	15	3	16	158	Rageade	111	4	115
83	Auvergne	15	1	23	159	Raulhac	314	12	326
83	Auvergne	15	1	27	160	Reilhac	1064	34	1098
83	Auvergne	15	3	19	161	Rézentières	125	3	128
83	Auvergne	15	2	15	162	Riom-ès-Montagnes	2698	72	2770
83	Auvergne	15	1	21	163	Roannes-Saint-Mary	1007	22	1029
83	Auvergne	15	3	19	164	Roffiac	584	15	599
83	Auvergne	15	1	07	165	Rouffiac	217	4	221
83	Auvergne	15	1	21	268	Le Rouget	981	22	1003
83	Auvergne	15	1	21	166	Roumégoux	260	3	263
83	Auvergne	15	1	10	167	Rouziers	132	0	132
83	Auvergne	15	3	16	168	Ruynes-en-Margeride	630	19	649
83	Auvergne	15	2	17	169	Saignes	902	20	922
83	Auvergne	15	3	06	170	Saint-Amandin	239	10	249
83	Auvergne	15	1	10	172	Saint-Antoine	120	2	122
83	Auvergne	15	3	06	173	Saint-Bonnet-de-Condat	100	6	106
83	Auvergne	15	2	22	174	Saint-Bonnet-de-Salers	314	11	325
83	Auvergne	15	1	18	175	Saint-Cernin	1076	36	1112
83	Auvergne	15	2	22	176	Saint-Chamant	256	6	262
83	Auvergne	15	1	25	178	Saint-Cirgues-de-Jordanne	140	4	144
83	Auvergne	15	1	18	179	Saint-Cirgues-de-Malbert	227	4	231
83	Auvergne	15	1	23	180	Saint-Clément	64	4	68
83	Auvergne	15	1	10	181	Saint-Constant	559	6	565
83	Auvergne	15	1	07	182	Saint-Étienne-Cantalès	140	10	150
83	Auvergne	15	1	23	183	Saint-Étienne-de-Carlat	132	3	135
83	Auvergne	15	2	15	185	Saint-Étienne-de-Chomeil	210	6	216
83	Auvergne	15	1	10	184	Saint-Étienne-de-Maurs	785	9	794
83	Auvergne	15	3	99	187	Saint-Flour	6711	610	7321
83	Auvergne	15	3	19	188	Saint-Georges	1083	28	1111
83	Auvergne	15	1	07	189	Saint-Gérons	210	4	214
83	Auvergne	15	2	15	190	Saint-Hippolyte	108	2	110
83	Auvergne	15	1	18	191	Saint-Illide	660	10	670
83	Auvergne	15	1	23	192	Saint-Jacques-des-Blats	322	5	327
83	Auvergne	15	1	10	194	Saint-Julien-de-Toursac	148	3	151
83	Auvergne	15	3	16	195	Saint-Just	208	7	215
83	Auvergne	15	1	21	196	Saint-Mamet-la-Salvetat	1536	33	1569
83	Auvergne	15	3	16	197	Saint-Marc	83	2	85
83	Auvergne	15	3	05	199	Saint-Martial	64	2	66
83	Auvergne	15	2	14	200	Saint-Martin-Cantalès	166	0	166
83	Auvergne	15	3	13	201	Saint-Martin-sous-Vigouroux	243	4	247
83	Auvergne	15	2	22	202	Saint-Martin-Valmeroux	846	36	882
83	Auvergne	15	3	08	203	Saint-Mary-le-Plain	154	3	157
83	Auvergne	15	2	22	205	Saint-Paul-de-Salers	117	1	118
83	Auvergne	15	1	03	204	Saint-Paul-des-Landes	1473	39	1512
83	Auvergne	15	2	17	206	Saint-Pierre	168	3	171
83	Auvergne	15	3	08	207	Saint-Poncy	329	6	335
83	Auvergne	15	2	22	208	Saint-Projet-de-Salers	126	5	131
83	Auvergne	15	3	05	209	Saint-Rémy-de-Chaudes-Aigues	109	5	114
83	Auvergne	15	1	07	211	Saint-Santin-Cantalès	318	6	324
83	Auvergne	15	1	10	212	Saint-Santin-de-Maurs	365	4	369
83	Auvergne	15	3	01	213	Saint-Saturnin	220	7	227
83	Auvergne	15	1	21	214	Saint-Saury	204	4	208
83	Auvergne	15	1	25	215	Saint-Simon	1082	37	1119
83	Auvergne	15	3	05	216	Saint-Urcize	487	15	502
83	Auvergne	15	1	07	217	Saint-Victor	109	2	111
83	Auvergne	15	2	22	218	Saint-Vincent-de-Salers	73	2	75
83	Auvergne	15	3	01	171	Sainte-Anastasie	140	2	142
83	Auvergne	15	2	14	186	Sainte-Eulalie	204	7	211
83	Auvergne	15	3	13	198	Sainte-Marie	113	3	116
83	Auvergne	15	2	22	219	Salers	358	7	365
83	Auvergne	15	2	09	220	Salins	154	7	161
83	Auvergne	15	1	03	221	Sansac-de-Marmiesse	1294	35	1329
83	Auvergne	15	1	11	222	Sansac-Veinazès	213	6	219
83	Auvergne	15	2	17	223	Sauvat	193	7	200
83	Auvergne	15	1	21	224	La Ségalassière	122	6	128
83	Auvergne	15	3	01	225	Ségur-les-Villas	227	3	230
83	Auvergne	15	1	11	226	Sénezergues	195	3	198
83	Auvergne	15	3	20	227	Sériers	135	2	137
83	Auvergne	15	1	07	228	Siran	511	11	522
83	Auvergne	15	3	16	229	Soulages	89	2	91
83	Auvergne	15	2	09	230	Sourniac	192	12	204
83	Auvergne	15	3	19	231	Talizat	580	17	597
83	Auvergne	15	3	20	232	Tanavelle	244	8	252
83	Auvergne	15	1	27	233	Teissières-de-Cornet	223	6	229
83	Auvergne	15	1	26	234	Teissières-lès-Bouliès	318	8	326
83	Auvergne	15	3	20	235	Les Ternes	575	14	589
83	Auvergne	15	1	23	236	Thiézac	612	7	619
83	Auvergne	15	3	19	237	Tiviers	157	3	160
83	Auvergne	15	1	18	238	Tournemire	139	1	140
83	Auvergne	15	2	04	240	Trémouille	189	4	193
83	Auvergne	15	3	05	241	La Trinitat	44	1	45
83	Auvergne	15	1	10	242	Le Trioulou	88	2	90
83	Auvergne	15	2	15	243	Trizac	529	14	543
83	Auvergne	15	3	20	244	Ussel	484	7	491
83	Auvergne	15	3	19	245	Vabres	223	7	230
83	Auvergne	15	2	15	246	Valette	262	12	274
83	Auvergne	15	3	08	247	Valjouze	25	0	25
83	Auvergne	15	3	20	248	Valuéjols	542	8	550
83	Auvergne	15	2	22	249	Le Vaulmier	70	3	73
83	Auvergne	15	2	17	250	Vebret	489	12	501
83	Auvergne	15	3	16	251	Védrines-Saint-Loup	143	2	145
83	Auvergne	15	1	25	252	Velzic	394	14	408
83	Auvergne	15	3	01	253	Vernols	67	2	69
83	Auvergne	15	2	17	254	Veyrières	128	4	132
83	Auvergne	15	1	26	255	Vézac	1135	37	1172
83	Auvergne	15	3	01	256	Vèze	66	2	68
83	Auvergne	15	1	26	257	Vezels-Roussy	149	2	151
83	Auvergne	15	1	23	258	Vic-sur-Cère	1982	40	2022
83	Auvergne	15	3	19	259	Vieillespesse	257	11	268
83	Auvergne	15	1	11	260	Vieillevie	107	5	112
83	Auvergne	15	2	09	261	Le Vigean	826	30	856
83	Auvergne	15	3	20	262	Villedieu	528	21	549
83	Auvergne	15	3	12	263	Virargues	141	7	148
83	Auvergne	15	1	21	264	Vitrac	290	10	300
83	Auvergne	15	2	17	265	Ydes	1844	84	1928
83	Auvergne	15	1	25	266	Yolet	575	26	601
83	Auvergne	15	1	03	267	Ytrac	3902	97	3999
54	Poitou-Charentes	16	3	15	001	Abzac	496	16	512
54	Poitou-Charentes	16	3	24	002	Les Adjots	492	10	502
54	Poitou-Charentes	16	1	22	003	Agris	828	12	840
54	Poitou-Charentes	16	1	21	004	Aignes-et-Puypéroux	261	35	296
54	Poitou-Charentes	16	3	01	005	Aigre	1076	14	1090
54	Poitou-Charentes	16	3	11	007	Alloue	535	4	539
54	Poitou-Charentes	16	1	25	008	Ambérac	321	10	331
54	Poitou-Charentes	16	3	14	009	Ambernac	411	9	420
54	Poitou-Charentes	16	2	27	010	Ambleville	187	3	190
54	Poitou-Charentes	16	1	25	011	Anais	584	11	595
54	Poitou-Charentes	16	2	27	012	Angeac-Champagne	507	13	520
54	Poitou-Charentes	16	2	12	013	Angeac-Charente	369	7	376
54	Poitou-Charentes	16	2	06	014	Angeduc	127	1	128
54	Poitou-Charentes	16	1	98	015	Angoulême	41613	2606	44219
54	Poitou-Charentes	16	3	14	016	Ansac-sur-Vienne	827	32	859
54	Poitou-Charentes	16	2	23	017	Anville	202	2	204
54	Poitou-Charentes	16	2	33	018	Ars	712	25	737
54	Poitou-Charentes	16	1	16	019	Asnières-sur-Nouère	1167	26	1193
54	Poitou-Charentes	16	1	04	020	Aubeterre-sur-Dronne	418	0	418
54	Poitou-Charentes	16	1	07	021	Aubeville	150	0	150
54	Poitou-Charentes	16	2	23	339	Auge-Saint-Médard	299	8	307
54	Poitou-Charentes	16	3	18	023	Aunac	370	10	380
54	Poitou-Charentes	16	1	25	024	Aussac-Vadalle	449	11	460
54	Poitou-Charentes	16	2	05	025	Baignes-Sainte-Radegonde	1326	25	1351
54	Poitou-Charentes	16	1	35	026	Balzac	1303	40	1343
54	Poitou-Charentes	16	3	01	027	Barbezières	122	6	128
54	Poitou-Charentes	16	2	06	028	Barbezieux-Saint-Hilaire	4768	193	4961
54	Poitou-Charentes	16	1	10	029	Bardenac	253	8	261
54	Poitou-Charentes	16	2	06	030	Barret	905	29	934
54	Poitou-Charentes	16	3	24	031	Barro	366	12	378
54	Poitou-Charentes	16	2	17	032	Bassac	572	7	579
54	Poitou-Charentes	16	3	18	033	Bayers	134	4	138
54	Poitou-Charentes	16	1	10	034	Bazac	158	6	164
54	Poitou-Charentes	16	3	26	035	Beaulieu-sur-Sonnette	276	4	280
54	Poitou-Charentes	16	1	07	036	Bécheresse	281	5	286
54	Poitou-Charentes	16	1	04	037	Bellon	166	4	170
54	Poitou-Charentes	16	3	11	038	Benest	352	4	356
54	Poitou-Charentes	16	3	29	039	Bernac	477	14	491
54	Poitou-Charentes	16	2	06	040	Berneuil	329	3	332
54	Poitou-Charentes	16	1	07	041	Bessac	114	5	119
54	Poitou-Charentes	16	3	01	042	Bessé	148	5	153
54	Poitou-Charentes	16	2	23	043	Bignac	233	6	239
54	Poitou-Charentes	16	3	24	044	Bioussac	228	6	234
54	Poitou-Charentes	16	2	12	045	Birac	333	2	335
54	Poitou-Charentes	16	1	07	046	Blanzac-Porcheresse	835	29	864
54	Poitou-Charentes	16	1	28	047	Blanzaguet-Saint-Cybard	259	2	261
54	Poitou-Charentes	16	2	08	048	Boisbreteau	124	0	124
54	Poitou-Charentes	16	1	04	049	Bonnes	378	3	381
54	Poitou-Charentes	16	2	12	050	Bonneuil	269	7	276
54	Poitou-Charentes	16	2	23	051	Bonneville	156	3	159
54	Poitou-Charentes	16	2	05	053	Bors (Canton de Baignes-Sainte-Radegonde)	133	0	133
54	Poitou-Charentes	16	1	21	052	Bors (Canton de Montmoreau-Saint-Cybard)	245	1	246
54	Poitou-Charentes	16	3	11	054	Le Bouchage	167	1	168
54	Poitou-Charentes	16	1	32	055	Bouëx	933	20	953
54	Poitou-Charentes	16	2	27	056	Bourg-Charente	789	11	800
54	Poitou-Charentes	16	2	12	057	Bouteville	334	9	343
54	Poitou-Charentes	16	2	13	058	Boutiers-Saint-Trojan	1388	49	1437
54	Poitou-Charentes	16	3	29	059	Brettes	196	4	200
54	Poitou-Charentes	16	2	13	060	Bréville	519	12	531
54	Poitou-Charentes	16	1	22	061	Brie	4002	84	4086
54	Poitou-Charentes	16	2	06	062	Brie-sous-Barbezieux	117	4	121
54	Poitou-Charentes	16	1	10	063	Brie-sous-Chalais	163	2	165
54	Poitou-Charentes	16	3	15	064	Brigueuil	1052	18	1070
54	Poitou-Charentes	16	3	15	065	Brillac	638	8	646
54	Poitou-Charentes	16	2	08	066	Brossac	530	17	547
54	Poitou-Charentes	16	1	22	067	Bunzac	474	12	486
54	Poitou-Charentes	16	3	18	068	Cellefrouin	552	7	559
54	Poitou-Charentes	16	3	18	069	Cellettes	446	14	460
54	Poitou-Charentes	16	3	09	070	Chabanais	1877	31	1908
54	Poitou-Charentes	16	3	09	071	Chabrac	555	10	565
54	Poitou-Charentes	16	1	07	072	Chadurie	525	12	537
54	Poitou-Charentes	16	1	10	073	Chalais	1844	127	1971
54	Poitou-Charentes	16	2	06	074	Challignac	299	10	309
54	Poitou-Charentes	16	3	11	076	Champagne-Mouton	963	26	989
54	Poitou-Charentes	16	1	07	075	Champagne-Vigny	230	6	236
54	Poitou-Charentes	16	1	16	077	Champmillon	525	16	541
54	Poitou-Charentes	16	1	35	078	Champniers	5168	338	5506
54	Poitou-Charentes	16	2	05	079	Chantillac	289	5	294
54	Poitou-Charentes	16	1	25	081	La Chapelle	199	5	204
54	Poitou-Charentes	16	1	28	082	Charmant	316	17	333
54	Poitou-Charentes	16	3	01	083	Charmé	368	9	377
54	Poitou-Charentes	16	1	19	084	Charras	353	2	355
54	Poitou-Charentes	16	3	26	085	Chasseneuil-sur-Bonnieure	2986	256	3242
54	Poitou-Charentes	16	3	09	086	Chassenon	879	18	897
54	Poitou-Charentes	16	3	11	087	Chassiecq	166	3	169
54	Poitou-Charentes	16	2	17	088	Chassors	1153	17	1170
54	Poitou-Charentes	16	2	33	089	Châteaubernard	3829	108	3937
54	Poitou-Charentes	16	2	12	090	Châteauneuf-sur-Charente	3418	72	3490
54	Poitou-Charentes	16	2	08	091	Châtignac	215	2	217
54	Poitou-Charentes	16	1	28	092	Chavenat	224	6	230
54	Poitou-Charentes	16	1	22	093	Chazelles	1500	40	1540
54	Poitou-Charentes	16	3	18	094	Chenommet	154	2	156
54	Poitou-Charentes	16	3	18	095	Chenon	151	0	151
54	Poitou-Charentes	16	3	20	096	Cherves-Châtelars	432	6	438
54	Poitou-Charentes	16	2	13	097	Cherves-Richemont	2399	74	2473
54	Poitou-Charentes	16	3	29	098	La Chèvrerie	139	5	144
54	Poitou-Charentes	16	2	08	099	Chillac	208	2	210
54	Poitou-Charentes	16	3	09	100	Chirac	739	16	755
54	Poitou-Charentes	16	1	07	101	Claix	936	17	953
54	Poitou-Charentes	16	2	97	102	Cognac	18557	778	19335
54	Poitou-Charentes	16	1	28	103	Combiers	120	1	121
54	Poitou-Charentes	16	3	24	104	Condac	468	16	484
54	Poitou-Charentes	16	2	05	105	Condéon	564	15	579
54	Poitou-Charentes	16	3	99	106	Confolens	2711	194	2905
54	Poitou-Charentes	16	1	22	107	Coulgens	495	18	513
54	Poitou-Charentes	16	1	25	108	Coulonges	149	5	154
54	Poitou-Charentes	16	2	23	109	Courbillac	655	11	666
54	Poitou-Charentes	16	3	29	110	Courcôme	432	10	442
54	Poitou-Charentes	16	1	21	111	Courgeac	212	2	214
54	Poitou-Charentes	16	1	10	112	Courlac	66	1	67
54	Poitou-Charentes	16	1	30	113	La Couronne	7123	553	7676
54	Poitou-Charentes	16	3	24	114	Couture	168	1	169
54	Poitou-Charentes	16	1	07	115	Cressac-Saint-Genis	148	3	151
54	Poitou-Charentes	16	2	27	116	Criteuil-la-Magdeleine	428	11	439
54	Poitou-Charentes	16	1	10	117	Curac	123	6	129
54	Poitou-Charentes	16	1	21	118	Deviat	166	5	171
54	Poitou-Charentes	16	1	28	119	Dignac	1312	36	1348
54	Poitou-Charentes	16	1	32	120	Dirac	1536	34	1570
54	Poitou-Charentes	16	1	16	121	Douzat	433	6	439
54	Poitou-Charentes	16	3	01	122	Ébréon	156	4	160
54	Poitou-Charentes	16	1	16	123	Échallat	491	11	502
54	Poitou-Charentes	16	1	19	124	Écuras	624	16	640
54	Poitou-Charentes	16	1	28	125	Édon	260	15	275
54	Poitou-Charentes	16	3	29	127	Empuré	126	3	129
54	Poitou-Charentes	16	3	14	128	Épenède	216	1	217
54	Poitou-Charentes	16	2	12	129	Éraville	209	0	209
54	Poitou-Charentes	16	1	04	130	Les Essards	204	4	208
54	Poitou-Charentes	16	3	15	131	Esse	489	11	500
54	Poitou-Charentes	16	3	09	132	Étagnac	975	24	999
54	Poitou-Charentes	16	1	07	133	Étriac	190	5	195
54	Poitou-Charentes	16	3	09	134	Exideuil	1078	28	1106
54	Poitou-Charentes	16	1	19	135	Eymouthiers	306	15	321
54	Poitou-Charentes	16	3	29	136	La Faye	617	6	623
54	Poitou-Charentes	16	1	19	137	Feuillade	303	7	310
54	Poitou-Charentes	16	1	30	138	Fléac	3629	147	3776
54	Poitou-Charentes	16	2	17	139	Fleurac	234	1	235
54	Poitou-Charentes	16	3	18	140	Fontclaireau	399	14	413
54	Poitou-Charentes	16	3	18	141	Fontenille	338	11	349
54	Poitou-Charentes	16	3	29	142	La Forêt-de-Tessé	211	9	220
54	Poitou-Charentes	16	1	28	143	Fouquebrune	660	26	686
54	Poitou-Charentes	16	3	01	144	Fouqueure	440	6	446
54	Poitou-Charentes	16	2	17	145	Foussignac	606	10	616
54	Poitou-Charentes	16	1	32	146	Garat	1871	67	1938
54	Poitou-Charentes	16	1	28	147	Gardes-le-Pontaroux	261	8	269
54	Poitou-Charentes	16	2	23	148	Genac	723	20	743
54	Poitou-Charentes	16	3	26	149	Genouillac	610	13	623
54	Poitou-Charentes	16	2	27	150	Gensac-la-Pallue	1599	47	1646
54	Poitou-Charentes	16	2	27	151	Genté	897	32	929
54	Poitou-Charentes	16	2	33	152	Gimeux	745	21	766
54	Poitou-Charentes	16	1	35	154	Gond-Pontouvre	5937	168	6105
54	Poitou-Charentes	16	2	27	153	Gondeville	523	10	533
54	Poitou-Charentes	16	3	01	155	Les Gours	125	2	127
54	Poitou-Charentes	16	2	23	156	Gourville	639	10	649
54	Poitou-Charentes	16	3	26	157	Le Grand-Madieu	156	3	159
54	Poitou-Charentes	16	1	19	158	Grassac	296	4	300
54	Poitou-Charentes	16	2	12	297	Graves-Saint-Amant	337	6	343
54	Poitou-Charentes	16	2	06	160	Guimps	472	10	482
54	Poitou-Charentes	16	2	08	161	Guizengeard	152	0	152
54	Poitou-Charentes	16	1	28	162	Gurat	190	2	192
54	Poitou-Charentes	16	1	16	163	Hiersac	1086	28	1114
54	Poitou-Charentes	16	3	14	164	Hiesse	244	7	251
54	Poitou-Charentes	16	2	17	165	Houlette	390	6	396
54	Poitou-Charentes	16	1	31	166	L; Isle-d;Espagnac	5284	184	5468
54	Poitou-Charentes	16	2	17	167	Jarnac	4434	246	4680
54	Poitou-Charentes	16	1	22	168	Jauldes	750	11	761
54	Poitou-Charentes	16	2	33	169	Javrezac	635	15	650
54	Poitou-Charentes	16	1	21	170	Juignac	399	8	407
54	Poitou-Charentes	16	2	27	171	Juillac-le-Coq	668	25	693
54	Poitou-Charentes	16	1	28	172	Juillaguet	139	3	142
54	Poitou-Charentes	16	3	18	173	Juillé	185	3	188
54	Poitou-Charentes	16	2	17	174	Julienne	447	10	457
54	Poitou-Charentes	16	1	07	175	Jurignac	526	4	530
54	Poitou-Charentes	16	2	06	176	Lachaise	299	9	308
54	Poitou-Charentes	16	2	06	177	Ladiville	118	1	119
54	Poitou-Charentes	16	2	06	178	Lagarde-sur-le-Né	187	3	190
54	Poitou-Charentes	16	2	05	179	Lamérac	196	3	199
54	Poitou-Charentes	16	1	04	180	Laprade	230	5	235
54	Poitou-Charentes	16	3	20	183	Lésignac-Durand	177	4	181
54	Poitou-Charentes	16	3	14	181	Lessac	594	11	605
54	Poitou-Charentes	16	3	15	182	Lesterps	479	15	494
54	Poitou-Charentes	16	3	18	184	Lichères	87	1	88
54	Poitou-Charentes	16	3	01	185	Ligné	173	0	173
54	Poitou-Charentes	16	2	27	186	Lignières-Sonneville	617	13	630
54	Poitou-Charentes	16	1	16	187	Linars	2060	124	2184
54	Poitou-Charentes	16	3	20	188	Le Lindois	343	1	344
54	Poitou-Charentes	16	3	29	189	Londigny	256	3	259
54	Poitou-Charentes	16	3	29	190	Longré	216	1	217
54	Poitou-Charentes	16	3	18	191	Lonnes	163	3	166
54	Poitou-Charentes	16	2	33	193	Louzac-Saint-André	1039	30	1069
54	Poitou-Charentes	16	3	01	194	Lupsault	123	3	126
54	Poitou-Charentes	16	3	26	195	Lussac	278	3	281
54	Poitou-Charentes	16	3	18	196	Luxé	800	10	810
54	Poitou-Charentes	16	3	29	197	La Magdeleine	127	4	131
54	Poitou-Charentes	16	1	28	198	Magnac-Lavalette-Villars	442	17	459
54	Poitou-Charentes	16	1	31	199	Magnac-sur-Touvre	3054	80	3134
54	Poitou-Charentes	16	1	25	200	Maine-de-Boixe	467	5	472
54	Poitou-Charentes	16	1	07	201	Mainfonds	191	2	193
54	Poitou-Charentes	16	2	27	202	Mainxe	694	12	706
54	Poitou-Charentes	16	1	19	203	Mainzac	113	2	115
54	Poitou-Charentes	16	2	12	204	Malaville	420	8	428
54	Poitou-Charentes	16	3	14	205	Manot	574	17	591
54	Poitou-Charentes	16	3	18	206	Mansle	1565	46	1611
54	Poitou-Charentes	16	2	23	207	Marcillac-Lanville	594	22	616
54	Poitou-Charentes	16	2	23	208	Mareuil	406	6	412
54	Poitou-Charentes	16	1	22	209	Marillac-le-Franc	767	19	786
54	Poitou-Charentes	16	1	25	210	Marsac	815	18	833
54	Poitou-Charentes	16	1	19	211	Marthon	603	6	609
54	Poitou-Charentes	16	3	20	212	Massignac	386	6	392
54	Poitou-Charentes	16	3	20	213	Mazerolles	371	2	373
54	Poitou-Charentes	16	3	26	214	Mazières	100	4	104
54	Poitou-Charentes	16	1	10	215	Médillac	153	2	155
54	Poitou-Charentes	16	2	17	216	Mérignac	718	14	732
54	Poitou-Charentes	16	2	33	217	Merpins	1007	25	1032
54	Poitou-Charentes	16	2	13	218	Mesnac	409	9	418
54	Poitou-Charentes	16	2	17	220	Les Métairies	605	11	616
54	Poitou-Charentes	16	2	23	221	Mons	262	3	265
54	Poitou-Charentes	16	1	10	222	Montboyer	402	5	407
54	Poitou-Charentes	16	1	19	223	Montbron	2158	42	2200
54	Poitou-Charentes	16	2	06	224	Montchaude	522	6	528
54	Poitou-Charentes	16	3	20	225	Montemboeuf	682	37	719
54	Poitou-Charentes	16	1	25	226	Montignac-Charente	715	18	733
54	Poitou-Charentes	16	1	04	227	Montignac-le-Coq	131	3	134
54	Poitou-Charentes	16	2	23	228	Montigné	152	2	154
54	Poitou-Charentes	16	3	29	229	Montjean	256	7	263
54	Poitou-Charentes	16	1	21	230	Montmoreau-Saint-Cybard	1059	86	1145
54	Poitou-Charentes	16	3	15	231	Montrollet	301	3	304
54	Poitou-Charentes	16	1	31	232	Mornac	2227	53	2280
54	Poitou-Charentes	16	2	12	233	Mosnac	470	9	479
54	Poitou-Charentes	16	1	16	234	Moulidars	735	12	747
54	Poitou-Charentes	16	1	07	236	Mouthiers-sur-Boëme	2473	54	2527
54	Poitou-Charentes	16	3	18	237	Mouton	234	5	239
54	Poitou-Charentes	16	3	18	238	Moutonneau	102	3	105
54	Poitou-Charentes	16	3	20	239	Mouzon	133	2	135
54	Poitou-Charentes	16	1	04	240	Nabinaud	81	2	83
54	Poitou-Charentes	16	1	25	241	Nanclars	201	11	212
54	Poitou-Charentes	16	3	24	242	Nanteuil-en-Vallée	1471	20	1491
54	Poitou-Charentes	16	2	17	243	Nercillac	1022	32	1054
54	Poitou-Charentes	16	1	30	244	Nersac	2398	56	2454
54	Poitou-Charentes	16	3	26	245	Nieuil	920	15	935
54	Poitou-Charentes	16	1	21	246	Nonac	306	13	319
54	Poitou-Charentes	16	2	12	247	Nonaville	200	1	201
54	Poitou-Charentes	16	3	01	248	Oradour	200	11	211
54	Poitou-Charentes	16	3	15	249	Oradour-Fanais	380	7	387
54	Poitou-Charentes	16	1	19	250	Orgedeuil	230	3	233
54	Poitou-Charentes	16	2	08	251	Oriolles	265	5	270
54	Poitou-Charentes	16	1	10	252	Orival	155	4	159
54	Poitou-Charentes	16	3	29	253	Paizay-Naudouin-Embourie	415	3	418
54	Poitou-Charentes	16	1	21	254	Palluaud	247	5	252
54	Poitou-Charentes	16	3	26	255	Parzac	131	2	133
54	Poitou-Charentes	16	2	08	256	Passirac	246	9	255
54	Poitou-Charentes	16	1	07	257	Péreuil	396	6	402
54	Poitou-Charentes	16	1	07	258	Pérignac	507	14	521
54	Poitou-Charentes	16	3	09	259	La Péruse	501	55	556
54	Poitou-Charentes	16	1	04	260	Pillac	256	8	264
54	Poitou-Charentes	16	3	26	261	Les Pins	446	12	458
54	Poitou-Charentes	16	2	23	262	Plaizac	151	7	158
54	Poitou-Charentes	16	1	07	263	Plassac-Rouffiac	370	4	374
54	Poitou-Charentes	16	3	14	264	Pleuville	395	5	400
54	Poitou-Charentes	16	1	21	267	Poullignac	80	1	81
54	Poitou-Charentes	16	3	24	268	Poursac	203	8	211
54	Poitou-Charentes	16	1	22	269	Pranzac	941	15	956
54	Poitou-Charentes	16	3	09	270	Pressignac	413	3	416
54	Poitou-Charentes	16	1	30	271	Puymoyen	2430	246	2676
54	Poitou-Charentes	16	3	18	272	Puyréaux	490	2	492
54	Poitou-Charentes	16	3	29	273	Raix	149	3	152
54	Poitou-Charentes	16	1	22	274	Rancogne	384	6	390
54	Poitou-Charentes	16	3	01	275	Ranville-Breuillaud	182	3	185
54	Poitou-Charentes	16	2	05	276	Reignac	662	21	683
54	Poitou-Charentes	16	2	17	277	Réparsac	626	9	635
54	Poitou-Charentes	16	1	10	279	Rioux-Martin	234	10	244
54	Poitou-Charentes	16	1	22	280	Rivières	1833	40	1873
54	Poitou-Charentes	16	1	22	281	La Rochefoucauld	2997	118	3115
54	Poitou-Charentes	16	1	22	282	La Rochette	556	11	567
54	Poitou-Charentes	16	1	28	283	Ronsenac	576	14	590
54	Poitou-Charentes	16	1	04	284	Rouffiac	115	2	117
54	Poitou-Charentes	16	1	28	285	Rougnac	441	8	449
54	Poitou-Charentes	16	2	23	286	Rouillac	1833	40	1873
54	Poitou-Charentes	16	1	30	287	Roullet-Saint-Estèphe	3939	103	4042
54	Poitou-Charentes	16	3	26	192	Roumazières-Loubert	2527	54	2581
54	Poitou-Charentes	16	3	20	289	Roussines	285	7	292
54	Poitou-Charentes	16	1	19	290	Rouzède	243	11	254
54	Poitou-Charentes	16	1	31	291	Ruelle-sur-Touvre	7370	291	7661
54	Poitou-Charentes	16	3	24	292	Ruffec	3545	143	3688
54	Poitou-Charentes	16	3	20	293	Saint-Adjutory	414	5	419
54	Poitou-Charentes	16	1	21	294	Saint-Amant	683	12	695
54	Poitou-Charentes	16	1	25	295	Saint-Amant-de-Boixe	1398	20	1418
54	Poitou-Charentes	16	3	18	296	Saint-Amant-de-Bonnieure	338	5	343
54	Poitou-Charentes	16	1	16	298	Saint-Amant-de-Nouère	420	7	427
54	Poitou-Charentes	16	3	18	300	Saint-Angeau	713	8	721
54	Poitou-Charentes	16	2	06	301	Saint-Aulais-la-Chapelle	226	2	228
54	Poitou-Charentes	16	1	10	302	Saint-Avit	189	1	190
54	Poitou-Charentes	16	2	06	303	Saint-Bonnet	372	4	376
54	Poitou-Charentes	16	2	13	304	Saint-Brice	1030	30	1060
54	Poitou-Charentes	16	3	15	306	Saint-Christophe	315	6	321
54	Poitou-Charentes	16	3	18	307	Saint-Ciers-sur-Bonnieure	297	9	306
54	Poitou-Charentes	16	3	26	308	Saint-Claud	1070	11	1081
54	Poitou-Charentes	16	3	11	310	Saint-Coutant	217	3	220
54	Poitou-Charentes	16	2	23	312	Saint-Cybardeaux	816	25	841
54	Poitou-Charentes	16	1	21	314	Saint-Eutrope	176	4	180
54	Poitou-Charentes	16	2	08	315	Saint-Félix	118	2	120
54	Poitou-Charentes	16	2	27	316	Saint-Fort-sur-le-Né	414	6	420
54	Poitou-Charentes	16	3	01	317	Saint-Fraigne	455	9	464
54	Poitou-Charentes	16	3	18	318	Saint-Front	344	6	350
54	Poitou-Charentes	16	1	16	320	Saint-Genis-d;Hiersac	883	19	902
54	Poitou-Charentes	16	3	24	321	Saint-Georges	54	1	55
54	Poitou-Charentes	16	3	15	322	Saint-Germain-de-Confolens	90	2	92
54	Poitou-Charentes	16	1	19	323	Saint-Germain-de-Montbron	489	9	498
54	Poitou-Charentes	16	3	24	325	Saint-Gourson	142	3	145
54	Poitou-Charentes	16	3	18	326	Saint-Groux	140	1	141
54	Poitou-Charentes	16	1	21	328	Saint-Laurent-de-Belzagot	366	20	386
54	Poitou-Charentes	16	3	26	329	Saint-Laurent-de-Céris	778	22	800
54	Poitou-Charentes	16	2	33	330	Saint-Laurent-de-Cognac	876	12	888
54	Poitou-Charentes	16	2	08	331	Saint-Laurent-des-Combes	97	0	97
54	Poitou-Charentes	16	1	07	332	Saint-Léger	119	0	119
54	Poitou-Charentes	16	1	21	334	Saint-Martial	140	7	147
54	Poitou-Charentes	16	3	29	335	Saint-Martin-du-Clocher	132	1	133
54	Poitou-Charentes	16	3	26	336	Saint-Mary	373	7	380
54	Poitou-Charentes	16	3	15	337	Saint-Maurice-des-Lions	952	12	964
54	Poitou-Charentes	16	2	06	338	Saint-Médard	297	7	304
54	Poitou-Charentes	16	2	27	340	Saint-Même-les-Carrières	1099	24	1123
54	Poitou-Charentes	16	1	30	341	Saint-Michel	3277	112	3389
54	Poitou-Charentes	16	2	06	342	Saint-Palais-du-Né	282	4	286
54	Poitou-Charentes	16	2	27	343	Saint-Preuil	302	9	311
54	Poitou-Charentes	16	1	22	344	Saint-Projet-Saint-Constant	1147	79	1226
54	Poitou-Charentes	16	1	10	346	Saint-Quentin-de-Chalais	283	6	289
54	Poitou-Charentes	16	3	09	345	Saint-Quentin-sur-Charente	214	3	217
54	Poitou-Charentes	16	1	04	347	Saint-Romain	541	5	546
54	Poitou-Charentes	16	1	16	348	Saint-Saturnin	1319	43	1362
54	Poitou-Charentes	16	1	04	350	Saint-Séverin	817	20	837
54	Poitou-Charentes	16	2	12	351	Saint-Simeux	566	7	573
54	Poitou-Charentes	16	2	12	352	Saint-Simon	204	2	206
54	Poitou-Charentes	16	1	19	353	Saint-Sornin	846	14	860
54	Poitou-Charentes	16	2	13	355	Saint-Sulpice-de-Cognac	1270	18	1288
54	Poitou-Charentes	16	3	24	356	Saint-Sulpice-de-Ruffec	34	0	34
54	Poitou-Charentes	16	2	08	357	Saint-Vallier	144	1	145
54	Poitou-Charentes	16	1	35	358	Saint-Yrieix-sur-Charente	7025	292	7317
54	Poitou-Charentes	16	3	18	309	Sainte-Colombe	178	5	183
54	Poitou-Charentes	16	2	17	349	Sainte-Sévère	531	9	540
54	Poitou-Charentes	16	2	08	354	Sainte-Souline	121	6	127
54	Poitou-Charentes	16	2	27	359	Salles-d;Angles	1081	18	1099
54	Poitou-Charentes	16	2	06	360	Salles-de-Barbezieux	454	76	530
54	Poitou-Charentes	16	3	29	361	Salles-de-Villefagnan	343	14	357
54	Poitou-Charentes	16	1	21	362	Salles-Lavalette	365	7	372
54	Poitou-Charentes	16	3	09	363	Saulgond	523	12	535
54	Poitou-Charentes	16	3	20	364	Sauvagnac	77	1	78
54	Poitou-Charentes	16	2	08	365	Sauvignac	98	0	98
54	Poitou-Charentes	16	2	27	366	Segonzac	2143	80	2223
54	Poitou-Charentes	16	1	28	368	Sers	783	23	806
54	Poitou-Charentes	16	2	17	369	Sigogne	983	21	1004
54	Poitou-Charentes	16	1	16	370	Sireuil	1175	38	1213
54	Poitou-Charentes	16	2	23	371	Sonneville	206	6	212
54	Poitou-Charentes	16	1	19	372	Souffrignac	145	2	147
54	Poitou-Charentes	16	3	29	373	Souvigné	241	3	244
54	Poitou-Charentes	16	1	32	374	Soyaux	9561	655	10216
54	Poitou-Charentes	16	3	26	375	Suaux	377	7	384
54	Poitou-Charentes	16	3	09	376	Suris	287	10	297
54	Poitou-Charentes	16	3	18	377	La Tâche	104	2	106
54	Poitou-Charentes	16	3	24	378	Taizé-Aizie	586	24	610
54	Poitou-Charentes	16	1	22	379	Taponnat-Fleurignac	1489	37	1526
54	Poitou-Charentes	16	2	05	380	Le Tâtre	359	10	369
54	Poitou-Charentes	16	3	29	381	Theil-Rabier	161	7	168
54	Poitou-Charentes	16	1	28	382	Torsac	770	16	786
54	Poitou-Charentes	16	1	25	383	Tourriers	749	9	758
54	Poitou-Charentes	16	2	05	384	Touvérac	774	14	788
54	Poitou-Charentes	16	1	31	385	Touvre	1114	23	1137
54	Poitou-Charentes	16	2	12	386	Touzac	447	10	457
54	Poitou-Charentes	16	2	17	387	Triac-Lautrait	455	63	518
54	Poitou-Charentes	16	1	16	388	Trois-Palis	813	16	829
54	Poitou-Charentes	16	3	11	389	Turgon	90	2	92
54	Poitou-Charentes	16	3	01	390	Tusson	261	20	281
54	Poitou-Charentes	16	3	29	391	Tuzie	161	1	162
54	Poitou-Charentes	16	3	18	392	Valence	231	7	238
54	Poitou-Charentes	16	1	25	393	Vars	1940	44	1984
54	Poitou-Charentes	16	1	28	394	Vaux-Lavalette	99	4	103
54	Poitou-Charentes	16	2	23	395	Vaux-Rouillac	298	7	305
54	Poitou-Charentes	16	3	18	396	Ventouse	123	5	128
54	Poitou-Charentes	16	3	01	397	Verdille	350	5	355
54	Poitou-Charentes	16	3	20	398	Verneuil	96	2	98
54	Poitou-Charentes	16	2	27	399	Verrières	362	18	380
54	Poitou-Charentes	16	3	24	400	Verteuil-sur-Charente	609	29	638
54	Poitou-Charentes	16	1	25	401	Vervant	141	0	141
54	Poitou-Charentes	16	2	12	402	Vibrac	317	1	318
54	Poitou-Charentes	16	3	11	403	Le Vieux-Cérier	136	2	138
54	Poitou-Charentes	16	3	24	404	Vieux-Ruffec	116	1	117
54	Poitou-Charentes	16	2	06	405	Vignolles	187	2	189
54	Poitou-Charentes	16	1	22	406	Vilhonneur	355	10	365
54	Poitou-Charentes	16	1	28	408	Villebois-Lavalette	733	26	759
54	Poitou-Charentes	16	3	29	409	Villefagnan	1049	33	1082
54	Poitou-Charentes	16	3	24	410	Villegats	231	8	239
54	Poitou-Charentes	16	3	01	411	Villejésus	571	16	587
54	Poitou-Charentes	16	1	25	412	Villejoubert	332	6	338
54	Poitou-Charentes	16	3	29	413	Villiers-le-Roux	122	4	126
54	Poitou-Charentes	16	3	18	414	Villognon	370	7	377
54	Poitou-Charentes	16	1	16	415	Vindelle	996	25	1021
54	Poitou-Charentes	16	3	20	416	Vitrac-Saint-Vincent	515	12	527
54	Poitou-Charentes	16	2	12	417	Viville	130	5	135
54	Poitou-Charentes	16	1	30	418	Voeuil-et-Giget	1603	54	1657
54	Poitou-Charentes	16	1	25	419	Vouharte	328	12	340
54	Poitou-Charentes	16	1	07	420	Voulgézac	266	7	273
54	Poitou-Charentes	16	1	19	421	Vouthon	363	3	366
54	Poitou-Charentes	16	1	32	422	Vouzan	668	5	673
54	Poitou-Charentes	16	1	25	423	Xambes	295	6	301
54	Poitou-Charentes	16	1	10	424	Yviers	516	2	518
54	Poitou-Charentes	16	1	22	425	Yvrac-et-Malleyrand	517	10	527
54	Poitou-Charentes	17	1	11	002	Agudelle	106	3	109
54	Poitou-Charentes	17	2	01	003	Aigrefeuille-d;Aunis	3707	67	3774
54	Poitou-Charentes	17	1	16	005	Allas-Bocage	199	5	204
54	Poitou-Charentes	17	1	02	006	Allas-Champagne	254	5	259
54	Poitou-Charentes	17	3	10	007	Anais	326	9	335
54	Poitou-Charentes	17	3	13	008	Andilly	1980	34	2014
54	Poitou-Charentes	17	3	07	009	Angliers	802	5	807
54	Poitou-Charentes	17	3	46	010	Angoulins	3739	116	3855
54	Poitou-Charentes	17	5	33	011	Annepont	340	11	351
54	Poitou-Charentes	17	5	38	012	Annezay	160	2	162
54	Poitou-Charentes	17	5	29	013	Antezant-la-Chapelle	358	12	370
54	Poitou-Charentes	17	4	08	015	Arces	661	14	675
54	Poitou-Charentes	17	1	02	016	Archiac	811	22	833
54	Poitou-Charentes	17	5	33	017	Archingeay	651	13	664
54	Poitou-Charentes	17	2	01	018	Ardillières	792	12	804
54	Poitou-Charentes	17	3	03	019	Ars-en-Ré	1330	27	1357
54	Poitou-Charentes	17	1	02	020	Arthenac	328	6	334
54	Poitou-Charentes	17	2	40	021	Arvert	3117	86	3203
54	Poitou-Charentes	17	5	29	022	Asnières-la-Giraud	922	22	944
54	Poitou-Charentes	17	5	28	023	Aujac	325	3	328
54	Poitou-Charentes	17	5	04	024	Aulnay	1464	34	1498
54	Poitou-Charentes	17	5	28	025	Aumagne	697	25	722
54	Poitou-Charentes	17	5	28	026	Authon-Ébéon	390	7	397
54	Poitou-Charentes	17	4	20	027	Avy	472	11	483
54	Poitou-Charentes	17	3	46	028	Aytré	8914	161	9075
54	Poitou-Charentes	17	5	15	029	Bagnizeau	187	1	188
54	Poitou-Charentes	17	4	36	030	Balanzac	510	10	520
54	Poitou-Charentes	17	5	15	031	Ballans	207	1	208
54	Poitou-Charentes	17	2	01	032	Ballon	740	7	747
54	Poitou-Charentes	17	1	18	033	La Barde	438	7	445
54	Poitou-Charentes	17	4	08	034	Barzan	455	4	459
54	Poitou-Charentes	17	5	15	035	Bazauges	136	5	141
54	Poitou-Charentes	17	2	26	036	Beaugeay	718	5	723
54	Poitou-Charentes	17	5	15	037	Beauvais-sur-Matha	681	18	699
54	Poitou-Charentes	17	1	19	038	Bedenac	633	11	644
54	Poitou-Charentes	17	4	20	039	Belluire	218	3	221
54	Poitou-Charentes	17	5	29	040	La Benâte	418	17	435
54	Poitou-Charentes	17	3	07	041	Benon	1010	8	1018
54	Poitou-Charentes	17	5	28	042	Bercloux	430	10	440
54	Poitou-Charentes	17	5	12	043	Bernay-Saint-Martin	763	16	779
54	Poitou-Charentes	17	4	09	044	Berneuil	1091	14	1105
54	Poitou-Charentes	17	4	32	045	Beurlay	1003	22	1025
54	Poitou-Charentes	17	5	29	046	Bignay	424	9	433
54	Poitou-Charentes	17	4	20	047	Biron	234	0	234
54	Poitou-Charentes	17	5	15	048	Blanzac-lès-Matha	334	5	339
54	Poitou-Charentes	17	5	04	049	Blanzay-sur-Boutonne	94	4	98
54	Poitou-Charentes	17	1	27	050	Bois	543	123	666
54	Poitou-Charentes	17	3	30	051	Le Bois-Plage-en-Ré	2358	56	2414
54	Poitou-Charentes	17	1	16	052	Boisredon	684	11	695
54	Poitou-Charentes	17	5	33	053	Bords	1287	25	1312
54	Poitou-Charentes	17	1	18	054	Boresse-et-Martron	198	5	203
54	Poitou-Charentes	17	1	18	055	Boscamnant	408	4	412
54	Poitou-Charentes	17	4	20	056	Bougneau	571	11	582
54	Poitou-Charentes	17	2	01	057	Bouhet	871	5	876
54	Poitou-Charentes	17	2	14	058	Bourcefranc-le-Chapus	3381	107	3488
54	Poitou-Charentes	17	3	10	059	Bourgneuf	1062	16	1078
54	Poitou-Charentes	17	4	08	060	Boutenac-Touvent	207	6	213
54	Poitou-Charentes	17	1	17	061	Bran	123	2	125
54	Poitou-Charentes	17	2	31	486	La Brée-les-Bains	756	18	774
54	Poitou-Charentes	17	5	15	062	Bresdon	259	4	263
54	Poitou-Charentes	17	2	37	063	Breuil-la-Réorte	416	9	425
54	Poitou-Charentes	17	2	21	065	Breuil-Magné	1655	46	1701
54	Poitou-Charentes	17	2	43	064	Breuillet	2634	68	2702
54	Poitou-Charentes	17	1	02	066	Brie-sous-Archiac	257	9	266
54	Poitou-Charentes	17	5	15	067	Brie-sous-Matha	204	4	208
54	Poitou-Charentes	17	4	08	068	Brie-sous-Mortagne	252	5	257
54	Poitou-Charentes	17	4	20	069	Brives-sur-Charente	230	10	240
54	Poitou-Charentes	17	5	28	070	Brizambourg	874	12	886
54	Poitou-Charentes	17	5	15	071	La Brousse	509	3	512
54	Poitou-Charentes	17	4	05	072	Burie	1278	22	1300
54	Poitou-Charentes	17	1	19	074	Bussac-Forêt	989	26	1015
54	Poitou-Charentes	17	4	34	073	Bussac-sur-Charente	1300	36	1336
54	Poitou-Charentes	17	2	39	075	Cabariot	1307	54	1361
54	Poitou-Charentes	17	1	02	076	Celles	315	7	322
54	Poitou-Charentes	17	1	18	077	Cercoux	1191	18	1209
54	Poitou-Charentes	17	4	20	078	Chadenac	393	11	404
54	Poitou-Charentes	17	2	40	079	Chaillevette	1458	26	1484
54	Poitou-Charentes	17	2	01	080	Chambon	910	11	921
54	Poitou-Charentes	17	1	17	081	Chamouillac	336	9	345
54	Poitou-Charentes	17	1	11	082	Champagnac	530	15	545
54	Poitou-Charentes	17	2	26	083	Champagne	656	25	681
54	Poitou-Charentes	17	1	27	084	Champagnolles	554	14	568
54	Poitou-Charentes	17	5	33	085	Champdolent	399	8	407
54	Poitou-Charentes	17	4	51	086	Chaniers	3453	89	3542
54	Poitou-Charentes	17	5	38	087	Chantemerle-sur-la-Soie	140	3	143
54	Poitou-Charentes	17	4	51	089	La Chapelle-des-Pots	974	25	999
54	Poitou-Charentes	17	3	13	091	Charron	2337	34	2371
54	Poitou-Charentes	17	1	17	092	Chartuzac	166	3	169
54	Poitou-Charentes	17	2	06	093	Le Château-d;Oléron	3920	97	4017
54	Poitou-Charentes	17	3	46	094	Châtelaillon-Plage	6029	147	6176
54	Poitou-Charentes	17	1	19	095	Chatenet	233	3	236
54	Poitou-Charentes	17	1	11	096	Chaunac	86	0	86
54	Poitou-Charentes	17	4	36	097	Le Chay	728	16	744
54	Poitou-Charentes	17	4	08	098	Chenac-Saint-Seurin-d;Uzet	612	13	625
54	Poitou-Charentes	17	1	19	099	Chepniers	658	13	671
54	Poitou-Charentes	17	4	05	100	Chérac	1090	24	1114
54	Poitou-Charentes	17	5	04	101	Cherbonnières	337	13	350
54	Poitou-Charentes	17	4	35	102	Chermignac	1261	16	1277
54	Poitou-Charentes	17	5	38	103	Chervettes	127	2	129
54	Poitou-Charentes	17	1	19	104	Chevanceaux	1022	92	1114
54	Poitou-Charentes	17	5	04	105	Chives	370	4	374
54	Poitou-Charentes	17	1	02	106	Cierzac	249	5	254
54	Poitou-Charentes	17	2	01	107	Ciré-d;Aunis	1176	17	1193
54	Poitou-Charentes	17	1	27	108	Clam	379	9	388
54	Poitou-Charentes	17	3	10	109	Clavette	1184	20	1204
54	Poitou-Charentes	17	1	18	110	Clérac	932	23	955
54	Poitou-Charentes	17	1	27	111	Clion	803	7	810
54	Poitou-Charentes	17	4	36	112	La Clisse	589	11	600
54	Poitou-Charentes	17	1	18	113	La Clotte	686	11	697
54	Poitou-Charentes	17	5	12	114	Coivert	236	3	239
54	Poitou-Charentes	17	4	51	115	Colombiers	334	11	345
54	Poitou-Charentes	17	1	16	116	Consac	238	13	251
54	Poitou-Charentes	17	5	04	117	Contré	121	2	123
54	Poitou-Charentes	17	1	17	118	Corignac	341	11	352
54	Poitou-Charentes	17	4	36	119	Corme-Écluse	1050	26	1076
54	Poitou-Charentes	17	4	36	120	Corme-Royal	1628	43	1671
54	Poitou-Charentes	17	3	03	121	La Couarde-sur-Mer	1251	26	1277
54	Poitou-Charentes	17	4	20	122	Coulonges	231	1	232
54	Poitou-Charentes	17	5	12	124	Courant	371	4	375
54	Poitou-Charentes	17	5	29	125	Courcelles	438	15	453
54	Poitou-Charentes	17	5	15	126	Courcerac	294	3	297
54	Poitou-Charentes	17	4	51	128	Courcoury	713	12	725
54	Poitou-Charentes	17	1	16	129	Courpignac	416	8	424
54	Poitou-Charentes	17	3	07	127	Courçon	1664	27	1691
54	Poitou-Charentes	17	1	17	130	Coux	478	10	488
54	Poitou-Charentes	17	4	08	131	Cozes	2005	35	2040
54	Poitou-Charentes	17	3	07	132	Cramchaban	611	10	621
54	Poitou-Charentes	17	4	09	133	Cravans	730	84	814
54	Poitou-Charentes	17	4	32	134	Crazannes	438	9	447
54	Poitou-Charentes	17	5	15	135	Cressé	231	2	233
54	Poitou-Charentes	17	3	10	136	Croix-Chapeau	1154	14	1168
54	Poitou-Charentes	17	5	12	137	La Croix-Comtesse	204	4	208
54	Poitou-Charentes	17	5	04	138	Dampierre-sur-Boutonne	285	9	294
54	Poitou-Charentes	17	5	12	139	Doeuil-sur-le-Mignon	336	3	339
54	Poitou-Charentes	17	2	06	140	Dolus-d;Oléron	3173	89	3262
54	Poitou-Charentes	17	4	05	141	Dompierre-sur-Charente	495	11	506
54	Poitou-Charentes	17	3	49	142	Dompierre-sur-Mer	5329	106	5435
54	Poitou-Charentes	17	4	34	143	Le Douhet	707	18	725
54	Poitou-Charentes	17	4	20	145	Échebrune	497	13	510
54	Poitou-Charentes	17	2	26	146	Échillais	3314	78	3392
54	Poitou-Charentes	17	4	05	147	Écoyeux	1232	22	1254
54	Poitou-Charentes	17	4	35	148	Écurat	472	16	488
54	Poitou-Charentes	17	5	04	149	Les Éduts	66	1	67
54	Poitou-Charentes	17	5	29	150	Les Églises-d;Argenteuil	539	13	552
54	Poitou-Charentes	17	2	43	151	L; Éguille	897	25	922
54	Poitou-Charentes	17	4	08	152	Épargnes	819	6	825
54	Poitou-Charentes	17	3	44	153	Esnandes	2063	35	2098
54	Poitou-Charentes	17	4	32	154	Les Essards	615	13	628
54	Poitou-Charentes	17	2	40	155	Étaules	2358	49	2407
54	Poitou-Charentes	17	1	17	156	Expiremont	125	4	129
54	Poitou-Charentes	17	5	33	157	Fenioux	146	2	148
54	Poitou-Charentes	17	3	07	158	Ferrières	776	11	787
54	Poitou-Charentes	17	4	20	159	Fléac-sur-Seugne	371	8	379
54	Poitou-Charentes	17	4	08	160	Floirac	322	4	326
54	Poitou-Charentes	17	3	30	161	La Flotte	2889	60	2949
54	Poitou-Charentes	17	5	04	162	Fontaine-Chalendray	230	1	231
54	Poitou-Charentes	17	1	11	163	Fontaines-d;Ozillac	508	14	522
54	Poitou-Charentes	17	4	34	164	Fontcouverte	2218	76	2294
54	Poitou-Charentes	17	5	29	165	Fontenet	381	9	390
54	Poitou-Charentes	17	2	01	166	Forges	1197	15	1212
54	Poitou-Charentes	17	1	18	167	Le Fouilloux	740	6	746
54	Poitou-Charentes	17	2	21	168	Fouras	4095	81	4176
54	Poitou-Charentes	17	5	28	169	La Frédière	78	2	80
54	Poitou-Charentes	17	4	32	171	Geay	680	16	696
54	Poitou-Charentes	17	4	09	172	Gémozac	2723	73	2796
54	Poitou-Charentes	17	1	18	173	La Genétouze	212	7	219
54	Poitou-Charentes	17	2	39	174	Genouillé	789	17	806
54	Poitou-Charentes	17	1	02	175	Germignac	627	6	633
54	Poitou-Charentes	17	5	15	176	Gibourne	116	1	117
54	Poitou-Charentes	17	5	04	177	Le Gicq	123	2	125
54	Poitou-Charentes	17	1	27	178	Givrezac	78	3	81
54	Poitou-Charentes	17	4	51	179	Les Gonds	1511	44	1555
54	Poitou-Charentes	17	5	15	180	Gourvillette	106	2	108
54	Poitou-Charentes	17	2	06	485	Le Grand-Village-Plage	1013	22	1035
54	Poitou-Charentes	17	5	33	181	Grandjean	264	6	270
54	Poitou-Charentes	17	3	07	182	La Grève-sur-Mignon	484	12	496
54	Poitou-Charentes	17	4	08	183	Grézac	823	10	833
54	Poitou-Charentes	17	2	26	184	La Gripperie-Saint-Symphorien	539	10	549
54	Poitou-Charentes	17	2	14	185	Le Gua	2053	56	2109
54	Poitou-Charentes	17	3	07	186	Le Gué-d;Alleré	662	11	673
54	Poitou-Charentes	17	1	11	187	Guitinières	419	12	431
54	Poitou-Charentes	17	5	15	188	Haimps	488	8	496
54	Poitou-Charentes	17	2	14	189	Hiers-Brouage	655	14	669
54	Poitou-Charentes	17	3	50	190	L; Houmeau	2267	70	2337
54	Poitou-Charentes	17	2	21	004	Île-d;Aix	232	13	245
54	Poitou-Charentes	17	4	51	191	La Jard	327	0	327
54	Poitou-Charentes	17	1	02	192	Jarnac-Champagne	726	24	750
54	Poitou-Charentes	17	3	10	193	La Jarne	2418	42	2460
54	Poitou-Charentes	17	3	10	194	La Jarrie	2744	91	2835
54	Poitou-Charentes	17	5	12	195	La Jarrie-Audouin	284	9	293
54	Poitou-Charentes	17	4	09	196	Jazennes	482	15	497
54	Poitou-Charentes	17	1	11	197	Jonzac	3480	351	3831
54	Poitou-Charentes	17	5	28	198	Juicq	218	2	220
54	Poitou-Charentes	17	1	17	199	Jussas	116	2	118
54	Poitou-Charentes	17	3	50	200	Lagord	7230	199	7429
54	Poitou-Charentes	17	3	07	201	La Laigne	373	5	378
54	Poitou-Charentes	17	5	29	202	Landes	584	25	609
54	Poitou-Charentes	17	2	01	203	Landrais	699	13	712
54	Poitou-Charentes	17	1	11	204	Léoville	322	5	327
54	Poitou-Charentes	17	2	21	205	Loire-les-Marais	339	13	352
54	Poitou-Charentes	17	5	04	206	Loiré-sur-Nie	300	11	311
54	Poitou-Charentes	17	3	03	207	Loix	713	14	727
54	Poitou-Charentes	17	3	13	208	Longèves	800	13	813
54	Poitou-Charentes	17	1	02	209	Lonzac	250	7	257
54	Poitou-Charentes	17	1	27	210	Lorignac	472	9	481
54	Poitou-Charentes	17	5	12	211	Loulay	786	18	804
54	Poitou-Charentes	17	5	15	212	Louzignac	161	6	167
54	Poitou-Charentes	17	5	12	213	Lozay	155	4	159
54	Poitou-Charentes	17	4	36	214	Luchat	434	8	442
54	Poitou-Charentes	17	1	11	215	Lussac	51	2	53
54	Poitou-Charentes	17	2	39	216	Lussant	922	42	964
54	Poitou-Charentes	17	5	15	217	Macqueville	296	5	301
54	Poitou-Charentes	17	3	13	218	Marans	4623	65	4688
54	Poitou-Charentes	17	2	14	219	Marennes	5607	135	5742
54	Poitou-Charentes	17	4	20	220	Marignac	398	7	405
54	Poitou-Charentes	17	2	37	221	Marsais	920	11	931
54	Poitou-Charentes	17	3	44	222	Marsilly	2619	43	2662
54	Poitou-Charentes	17	5	15	223	Massac	168	4	172
54	Poitou-Charentes	17	5	15	224	Matha	2166	80	2246
54	Poitou-Charentes	17	2	40	225	Les Mathes	1740	39	1779
54	Poitou-Charentes	17	5	29	226	Mazeray	862	21	883
54	Poitou-Charentes	17	4	20	227	Mazerolles	261	17	278
54	Poitou-Charentes	17	4	36	228	Médis	2739	54	2793
54	Poitou-Charentes	17	1	19	229	Mérignac	222	2	224
54	Poitou-Charentes	17	4	08	230	Meschers-sur-Gironde	2814	62	2876
54	Poitou-Charentes	17	1	17	231	Messac	113	4	117
54	Poitou-Charentes	17	4	09	232	Meursac	1400	17	1417
54	Poitou-Charentes	17	1	11	233	Meux	295	6	301
54	Poitou-Charentes	17	5	12	234	Migré	348	6	354
54	Poitou-Charentes	17	4	05	235	Migron	683	11	694
54	Poitou-Charentes	17	1	16	236	Mirambeau	1504	45	1549
54	Poitou-Charentes	17	2	26	237	Moëze	553	10	563
54	Poitou-Charentes	17	1	11	238	Moings	170	0	170
54	Poitou-Charentes	17	5	15	239	Mons	468	3	471
54	Poitou-Charentes	17	1	17	240	Montendre	3151	115	3266
54	Poitou-Charentes	17	1	18	241	Montguyon	1460	36	1496
54	Poitou-Charentes	17	4	20	242	Montils	766	24	790
54	Poitou-Charentes	17	1	19	243	Montlieu-la-Garde	1341	24	1365
54	Poitou-Charentes	17	4	09	244	Montpellier-de-Médillan	639	6	645
54	Poitou-Charentes	17	3	10	245	Montroy	645	14	659
54	Poitou-Charentes	17	2	39	246	Moragne	472	9	481
54	Poitou-Charentes	17	2	43	247	Mornac-sur-Seudre	839	15	854
54	Poitou-Charentes	17	4	08	248	Mortagne-sur-Gironde	1023	19	1042
54	Poitou-Charentes	17	1	11	249	Mortiers	181	4	185
54	Poitou-Charentes	17	1	27	250	Mosnac	480	13	493
54	Poitou-Charentes	17	5	33	252	Le Mung	273	6	279
54	Poitou-Charentes	17	2	39	253	Muron	1235	38	1273
54	Poitou-Charentes	17	5	38	254	Nachamps	206	6	212
54	Poitou-Charentes	17	4	36	255	Nancras	678	14	692
54	Poitou-Charentes	17	5	28	256	Nantillé	348	6	354
54	Poitou-Charentes	17	5	04	257	Néré	753	18	771
54	Poitou-Charentes	17	1	02	258	Neuillac	303	6	309
54	Poitou-Charentes	17	1	02	259	Neulles	147	3	150
54	Poitou-Charentes	17	1	18	260	Neuvicq	426	8	434
54	Poitou-Charentes	17	5	15	261	Neuvicq-le-Château	363	36	399
54	Poitou-Charentes	17	1	16	263	Nieul-le-Virouil	584	8	592
54	Poitou-Charentes	17	4	35	262	Nieul-lès-Saintes	1048	35	1083
54	Poitou-Charentes	17	3	50	264	Nieul-sur-Mer	5640	175	5815
54	Poitou-Charentes	17	2	14	265	Nieulle-sur-Seudre	1127	15	1142
54	Poitou-Charentes	17	5	33	266	Les Nouillers	636	5	641
54	Poitou-Charentes	17	3	07	267	Nuaillé-d;Aunis	1076	15	1091
54	Poitou-Charentes	17	5	04	268	Nuaillé-sur-Boutonne	201	12	213
54	Poitou-Charentes	17	1	19	269	Orignolles	641	11	652
54	Poitou-Charentes	17	1	11	270	Ozillac	665	14	679
54	Poitou-Charentes	17	5	04	271	Paillé	336	6	342
54	Poitou-Charentes	17	2	37	272	Péré	371	13	384
54	Poitou-Charentes	17	4	20	273	Pérignac	976	18	994
54	Poitou-Charentes	17	3	49	274	Périgny	7284	217	7501
54	Poitou-Charentes	17	4	35	275	Pessines	772	23	795
54	Poitou-Charentes	17	1	19	276	Le Pin	70	0	70
54	Poitou-Charentes	17	4	36	278	Pisany	521	8	529
54	Poitou-Charentes	17	1	27	279	Plassac	630	9	639
54	Poitou-Charentes	17	4	32	280	Plassay	692	16	708
54	Poitou-Charentes	17	1	19	281	Polignac	146	0	146
54	Poitou-Charentes	17	1	17	282	Pommiers-Moulons	196	0	196
54	Poitou-Charentes	17	4	20	283	Pons	4333	241	4574
54	Poitou-Charentes	17	4	32	284	Pont-l;Abbé-d;Arnoult	1727	274	2001
54	Poitou-Charentes	17	4	32	285	Port-d;Envaux	1102	36	1138
54	Poitou-Charentes	17	2	26	484	Port-des-Barques	1885	46	1931
54	Poitou-Charentes	17	3	03	286	Les Portes-en-Ré	651	18	669
54	Poitou-Charentes	17	1	19	287	Pouillac	246	5	251
54	Poitou-Charentes	17	5	29	288	Poursay-Garnaud	302	4	306
54	Poitou-Charentes	17	4	35	289	Préguillac	436	21	457
54	Poitou-Charentes	17	5	15	290	Prignac	276	6	282
54	Poitou-Charentes	17	3	44	291	Puilboreau	5361	121	5482
54	Poitou-Charentes	17	5	38	292	Puy-du-Lac	419	8	427
54	Poitou-Charentes	17	2	37	293	Puyravault	617	10	627
54	Poitou-Charentes	17	5	38	294	Puyrolland	195	5	200
54	Poitou-Charentes	17	1	11	295	Réaux	447	13	460
54	Poitou-Charentes	17	4	09	296	Rétaud	1027	32	1059
54	Poitou-Charentes	17	4	09	298	Rioux	924	16	940
54	Poitou-Charentes	17	3	30	297	Rivedoux-Plage	2302	64	2366
54	Poitou-Charentes	17	2	97	299	Rochefort	25140	822	25962
54	Poitou-Charentes	17	3	98	300	La Rochelle	75170	2705	77875
54	Poitou-Charentes	17	5	04	301	Romazières	72	0	72
54	Poitou-Charentes	17	4	32	302	Romegoux	622	22	644
54	Poitou-Charentes	17	3	07	303	La Ronde	1078	20	1098
54	Poitou-Charentes	17	4	20	304	Rouffiac	486	4	490
54	Poitou-Charentes	17	1	17	305	Rouffignac	443	9	452
54	Poitou-Charentes	17	2	96	306	Royan	17946	728	18674
54	Poitou-Charentes	17	4	36	307	Sablonceaux	1251	27	1278
54	Poitou-Charentes	17	2	26	308	Saint-Agnant	2499	96	2595
54	Poitou-Charentes	17	1	18	309	Saint-Aigulin	1919	40	1959
54	Poitou-Charentes	17	4	09	310	Saint-André-de-Lidon	962	16	978
54	Poitou-Charentes	17	2	40	311	Saint-Augustin	1250	31	1281
54	Poitou-Charentes	17	1	16	312	Saint-Bonnet-sur-Gironde	869	16	885
54	Poitou-Charentes	17	4	05	313	Saint-Bris-des-Bois	406	4	410
54	Poitou-Charentes	17	4	05	314	Saint-Césaire	924	11	935
54	Poitou-Charentes	17	3	10	315	Saint-Christophe	1230	15	1245
54	Poitou-Charentes	17	1	02	316	Saint-Ciers-Champagne	415	9	424
54	Poitou-Charentes	17	1	16	317	Saint-Ciers-du-Taillon	532	6	538
54	Poitou-Charentes	17	3	03	318	Saint-Clément-des-Baleines	720	11	731
54	Poitou-Charentes	17	2	39	320	Saint-Coutant-le-Grand	378	7	385
54	Poitou-Charentes	17	5	38	321	Saint-Crépin	287	3	290
54	Poitou-Charentes	17	3	07	322	Saint-Cyr-du-Doret	595	5	600
54	Poitou-Charentes	17	2	31	323	Saint-Denis-d;Oléron	1358	38	1396
54	Poitou-Charentes	17	5	29	277	Saint-Denis-du-Pin	729	65	794
54	Poitou-Charentes	17	1	16	324	Saint-Dizant-du-Bois	116	1	117
54	Poitou-Charentes	17	1	27	325	Saint-Dizant-du-Gua	522	6	528
54	Poitou-Charentes	17	1	02	326	Saint-Eugène	293	12	305
54	Poitou-Charentes	17	5	12	327	Saint-Félix	310	6	316
54	Poitou-Charentes	17	1	27	328	Saint-Fort-sur-Gironde	854	16	870
54	Poitou-Charentes	17	2	26	329	Saint-Froult	361	3	364
54	Poitou-Charentes	17	1	27	331	Saint-Genis-de-Saintonge	1262	58	1320
54	Poitou-Charentes	17	1	27	332	Saint-Georges-Antignac	400	11	411
54	Poitou-Charentes	17	2	31	337	Saint-Georges-d;Oléron	3489	73	3562
54	Poitou-Charentes	17	2	25	333	Saint-Georges-de-Didonne	5071	111	5182
54	Poitou-Charentes	17	5	04	334	Saint-Georges-de-Longuepierre	233	1	234
54	Poitou-Charentes	17	1	16	335	Saint-Georges-des-Agoûts	259	2	261
54	Poitou-Charentes	17	4	35	336	Saint-Georges-des-Coteaux	2560	88	2648
54	Poitou-Charentes	17	2	37	338	Saint-Georges-du-Bois	1743	40	1783
54	Poitou-Charentes	17	1	11	339	Saint-Germain-de-Lusignan	1251	125	1376
54	Poitou-Charentes	17	2	37	340	Saint-Germain-de-Marencennes	1189	76	1265
54	Poitou-Charentes	17	1	02	341	Saint-Germain-de-Vibrac	203	3	206
54	Poitou-Charentes	17	1	27	342	Saint-Germain-du-Seudre	359	3	362
54	Poitou-Charentes	17	1	27	343	Saint-Grégoire-d;Ardennes	134	0	134
54	Poitou-Charentes	17	5	28	344	Saint-Hilaire-de-Villefranche	1187	33	1220
54	Poitou-Charentes	17	1	16	345	Saint-Hilaire-du-Bois	302	9	311
54	Poitou-Charentes	17	2	39	346	Saint-Hippolyte	1329	90	1419
54	Poitou-Charentes	17	5	29	347	Saint-Jean-d;Angély	7669	601	8270
54	Poitou-Charentes	17	2	26	348	Saint-Jean-d;Angle	595	7	602
54	Poitou-Charentes	17	3	07	349	Saint-Jean-de-Liversay	2422	33	2455
54	Poitou-Charentes	17	5	29	350	Saint-Julien-de-l;Escap	859	23	882
54	Poitou-Charentes	17	2	14	351	Saint-Just-Luzac	1871	54	1925
54	Poitou-Charentes	17	5	38	352	Saint-Laurent-de-la-Barrière	97	1	98
54	Poitou-Charentes	17	2	21	353	Saint-Laurent-de-la-Prée	1858	28	1886
54	Poitou-Charentes	17	4	20	354	Saint-Léger	602	16	618
54	Poitou-Charentes	17	5	38	356	Saint-Loup	295	7	302
54	Poitou-Charentes	17	1	02	357	Saint-Maigrin	564	19	583
54	Poitou-Charentes	17	5	04	358	Saint-Mandé-sur-Brédoire	307	7	314
54	Poitou-Charentes	17	2	37	359	Saint-Mard	1066	19	1085
54	Poitou-Charentes	17	5	12	361	Saint-Martial	124	3	127
54	Poitou-Charentes	17	1	16	362	Saint-Martial-de-Mirambeau	220	5	225
54	Poitou-Charentes	17	1	11	363	Saint-Martial-de-Vitaterne	601	11	612
54	Poitou-Charentes	17	1	02	364	Saint-Martial-sur-Né	411	8	419
54	Poitou-Charentes	17	1	18	365	Saint-Martin-d;Ary	493	7	500
54	Poitou-Charentes	17	1	18	366	Saint-Martin-de-Coux	418	14	432
54	Poitou-Charentes	17	5	04	367	Saint-Martin-de-Juillers	170	2	172
54	Poitou-Charentes	17	3	30	369	Saint-Martin-de-Ré	2526	36	2562
54	Poitou-Charentes	17	1	11	371	Saint-Maurice-de-Tavernole	132	4	136
54	Poitou-Charentes	17	1	11	372	Saint-Médard	81	1	82
54	Poitou-Charentes	17	3	10	373	Saint-Médard-d;Aunis	1820	28	1848
54	Poitou-Charentes	17	2	26	375	Saint-Nazaire-sur-Charente	1146	11	1157
54	Poitou-Charentes	17	5	15	377	Saint-Ouen	131	1	132
54	Poitou-Charentes	17	3	13	376	Saint-Ouen-d;Aunis	1201	37	1238
54	Poitou-Charentes	17	1	19	378	Saint-Palais-de-Négrignac	400	10	410
54	Poitou-Charentes	17	1	27	379	Saint-Palais-de-Phiolin	227	2	229
54	Poitou-Charentes	17	2	43	380	Saint-Palais-sur-Mer	3958	124	4082
54	Poitou-Charentes	17	5	29	381	Saint-Pardoult	224	7	231
54	Poitou-Charentes	17	2	37	382	Saint-Pierre-d;Amilly	455	10	465
54	Poitou-Charentes	17	2	31	385	Saint-Pierre-d;Oléron	6687	153	6840
54	Poitou-Charentes	17	5	04	383	Saint-Pierre-de-Juillers	353	10	363
54	Poitou-Charentes	17	5	12	384	Saint-Pierre-de-l;Isle	275	3	278
54	Poitou-Charentes	17	1	18	386	Saint-Pierre-du-Palais	364	18	382
54	Poitou-Charentes	17	4	32	387	Saint-Porchaire	1644	34	1678
54	Poitou-Charentes	17	4	09	388	Saint-Quantin-de-Rançanne	280	6	286
54	Poitou-Charentes	17	3	10	391	Saint-Rogatien	1920	50	1970
54	Poitou-Charentes	17	4	36	393	Saint-Romain-de-Benet	1620	25	1645
54	Poitou-Charentes	17	4	08	392	Saint-Romain-sur-Gironde	48	0	48
54	Poitou-Charentes	17	2	37	394	Saint-Saturnin-du-Bois	880	18	898
54	Poitou-Charentes	17	4	05	395	Saint-Sauvant	512	18	530
54	Poitou-Charentes	17	3	07	396	Saint-Sauveur-d;Aunis	1591	32	1623
54	Poitou-Charentes	17	5	33	397	Saint-Savinien	2432	126	2558
54	Poitou-Charentes	17	4	20	398	Saint-Seurin-de-Palenne	150	2	152
54	Poitou-Charentes	17	4	20	400	Saint-Sever-de-Saintonge	625	18	643
54	Poitou-Charentes	17	5	12	401	Saint-Séverin-sur-Boutonne	118	1	119
54	Poitou-Charentes	17	1	27	402	Saint-Sigismond-de-Clermont	163	9	172
54	Poitou-Charentes	17	1	11	403	Saint-Simon-de-Bordes	682	12	694
54	Poitou-Charentes	17	4	09	404	Saint-Simon-de-Pellouaille	532	10	542
54	Poitou-Charentes	17	1	16	405	Saint-Sorlin-de-Conac	210	2	212
54	Poitou-Charentes	17	2	14	406	Saint-Sornin	296	13	309
54	Poitou-Charentes	17	4	32	408	Saint-Sulpice-d;Arnoult	677	13	690
54	Poitou-Charentes	17	2	43	409	Saint-Sulpice-de-Royan	2798	55	2853
54	Poitou-Charentes	17	1	16	410	Saint-Thomas-de-Conac	559	8	567
54	Poitou-Charentes	17	2	06	411	Saint-Trojan-les-Bains	1473	46	1519
54	Poitou-Charentes	17	4	34	412	Saint-Vaize	562	22	584
54	Poitou-Charentes	17	3	10	413	Saint-Vivien	1101	14	1115
54	Poitou-Charentes	17	3	44	414	Saint-Xandre	4488	192	4680
54	Poitou-Charentes	17	1	19	319	Sainte-Colombe	115	1	116
54	Poitou-Charentes	17	4	32	330	Sainte-Gemme	1246	18	1264
54	Poitou-Charentes	17	1	02	355	Sainte-Lheurine	497	14	511
54	Poitou-Charentes	17	3	30	360	Sainte-Marie-de-Ré	3186	92	3278
54	Poitou-Charentes	17	5	28	374	Sainte-Même	250	1	251
54	Poitou-Charentes	17	4	32	389	Sainte-Radegonde	541	23	564
54	Poitou-Charentes	17	1	16	390	Sainte-Ramée	140	7	147
54	Poitou-Charentes	17	3	10	407	Sainte-Soulle	3577	79	3656
54	Poitou-Charentes	17	4	99	415	Saintes	26011	1419	27430
54	Poitou-Charentes	17	5	04	416	Saleignes	64	1	65
54	Poitou-Charentes	17	1	16	417	Salignac-de-Mirambeau	158	2	160
54	Poitou-Charentes	17	4	20	418	Salignac-sur-Charente	622	17	639
54	Poitou-Charentes	17	3	10	420	Salles-sur-Mer	2029	57	2086
54	Poitou-Charentes	17	4	36	421	Saujon	6796	127	6923
54	Poitou-Charentes	17	5	04	422	Seigné	98	4	102
54	Poitou-Charentes	17	1	16	423	Semillac	69	1	70
54	Poitou-Charentes	17	1	16	424	Semoussac	284	5	289
54	Poitou-Charentes	17	4	08	425	Semussac	2041	38	2079
54	Poitou-Charentes	17	4	05	426	Le Seure	237	8	245
54	Poitou-Charentes	17	5	15	427	Siecq	212	6	218
54	Poitou-Charentes	17	5	15	428	Sonnac	526	10	536
54	Poitou-Charentes	17	2	26	429	Soubise	2909	50	2959
54	Poitou-Charentes	17	1	16	430	Soubran	391	6	397
54	Poitou-Charentes	17	4	32	431	Soulignonne	728	15	743
54	Poitou-Charentes	17	1	17	432	Souméras	348	10	358
54	Poitou-Charentes	17	1	17	433	Sousmoulins	215	6	221
54	Poitou-Charentes	17	2	37	434	Surgères	6508	212	6720
54	Poitou-Charentes	17	5	33	435	Taillant	164	6	170
54	Poitou-Charentes	17	5	33	436	Taillebourg	730	17	747
54	Poitou-Charentes	17	4	08	437	Talmont-sur-Gironde	88	2	90
54	Poitou-Charentes	17	4	09	438	Tanzac	303	2	305
54	Poitou-Charentes	17	3	07	439	Taugon	813	14	827
54	Poitou-Charentes	17	5	29	440	Ternant	332	9	341
54	Poitou-Charentes	17	4	09	441	Tesson	1039	14	1053
54	Poitou-Charentes	17	4	09	442	Thaims	368	11	379
54	Poitou-Charentes	17	2	01	443	Thairé	1493	24	1517
54	Poitou-Charentes	17	4	35	444	Thénac	1630	228	1858
54	Poitou-Charentes	17	4	36	445	Thézac	316	5	321
54	Poitou-Charentes	17	5	15	446	Thors	426	2	428
54	Poitou-Charentes	17	2	01	447	Le Thou	1643	17	1660
54	Poitou-Charentes	17	5	38	448	Tonnay-Boutonne	1158	19	1177
54	Poitou-Charentes	17	2	39	449	Tonnay-Charente	7758	266	8024
54	Poitou-Charentes	17	5	38	450	Torxé	244	11	255
54	Poitou-Charentes	17	5	15	451	Les Touches-de-Périgny	545	7	552
54	Poitou-Charentes	17	2	40	452	La Tremblade	4584	109	4693
54	Poitou-Charentes	17	4	32	453	Trizay	1342	18	1360
54	Poitou-Charentes	17	1	17	454	Tugéras-Saint-Maurice	360	7	367
54	Poitou-Charentes	17	4	32	455	La Vallée	694	17	711
54	Poitou-Charentes	17	2	37	457	Vandré	773	13	786
54	Poitou-Charentes	17	1	17	458	Vanzac	170	1	171
54	Poitou-Charentes	17	5	29	459	Varaize	579	18	597
54	Poitou-Charentes	17	4	35	460	Varzay	793	18	811
54	Poitou-Charentes	17	2	43	461	Vaux-sur-Mer	3876	103	3979
54	Poitou-Charentes	17	4	34	462	Vénérand	697	11	708
54	Poitou-Charentes	17	2	21	463	Vergeroux	1019	18	1037
54	Poitou-Charentes	17	5	29	465	La Vergne	628	35	663
54	Poitou-Charentes	17	5	12	464	Vergné	135	4	139
54	Poitou-Charentes	17	3	10	466	Vérines	1987	37	2024
54	Poitou-Charentes	17	5	29	467	Vervant	212	5	217
54	Poitou-Charentes	17	1	11	468	Vibrac	154	7	161
54	Poitou-Charentes	17	4	09	469	Villars-en-Pons	564	4	568
54	Poitou-Charentes	17	4	05	470	Villars-les-Bois	261	3	264
54	Poitou-Charentes	17	5	04	471	La Villedieu	221	2	223
54	Poitou-Charentes	17	3	13	472	Villedoux	1425	20	1445
54	Poitou-Charentes	17	5	04	473	Villemorin	99	3	102
54	Poitou-Charentes	17	5	12	474	Villeneuve-la-Comtesse	734	16	750
54	Poitou-Charentes	17	1	11	476	Villexavier	281	5	286
54	Poitou-Charentes	17	5	04	477	Villiers-Couture	149	1	150
54	Poitou-Charentes	17	5	04	478	Vinax	65	3	68
54	Poitou-Charentes	17	4	09	479	Virollet	271	0	271
54	Poitou-Charentes	17	2	01	480	Virson	729	15	744
54	Poitou-Charentes	17	5	29	481	Voissay	170	4	174
54	Poitou-Charentes	17	2	37	482	Vouhé	649	18	667
54	Poitou-Charentes	17	2	21	483	Yves	1438	27	1465
24	Centre	18	1	15	001	Achères	371	10	381
24	Centre	18	2	27	002	Ainay-le-Vieil	227	7	234
24	Centre	18	1	01	003	Les Aix-d;Angillon	1945	29	1974
24	Centre	18	1	23	004	Allogny	1018	21	1039
24	Centre	18	3	20	005	Allouis	948	16	964
24	Centre	18	1	17	006	Annoix	231	5	236
24	Centre	18	2	14	007	Apremont-sur-Allier	73	0	73
24	Centre	18	2	27	009	Arcomps	301	7	308
24	Centre	18	2	11	010	Ardenais	204	6	210
24	Centre	18	3	02	011	Argent-sur-Sauldre	2209	53	2262
24	Centre	18	1	24	012	Argenvières	480	9	489
24	Centre	18	2	07	013	Arpheuilles	340	13	353
24	Centre	18	1	17	008	Arçay	533	9	542
24	Centre	18	1	28	014	Assigny	152	7	159
24	Centre	18	3	03	015	Aubigny-sur-Nère	5769	151	5920
24	Centre	18	1	01	016	Aubinges	359	15	374
24	Centre	18	2	26	017	Augy-sur-Aubois	302	9	311
24	Centre	18	1	04	018	Avord	2675	36	2711
24	Centre	18	1	01	019	Azy	484	6	490
24	Centre	18	1	25	020	Bannay	771	15	786
24	Centre	18	2	07	021	Bannegon	261	5	266
24	Centre	18	1	28	022	Barlieu	412	8	420
24	Centre	18	1	04	023	Baugy	1425	24	1449
24	Centre	18	2	09	024	Beddes	96	1	97
24	Centre	18	1	24	025	Beffes	697	16	713
24	Centre	18	1	16	026	Belleville-sur-Loire	1042	29	1071
24	Centre	18	1	04	027	Bengy-sur-Craon	671	61	732
24	Centre	18	3	20	028	Berry-Bouy	1216	31	1247
24	Centre	18	2	07	029	Bessais-le-Fromental	313	4	317
24	Centre	18	3	02	030	Blancafort	1140	40	1180
24	Centre	18	2	21	031	Blet	649	16	665
24	Centre	18	1	16	032	Boulleret	1355	45	1400
24	Centre	18	1	98	033	Bourges	66381	2209	68590
24	Centre	18	2	22	034	Bouzais	291	7	298
24	Centre	18	1	01	035	Brécy	844	22	866
24	Centre	18	3	19	036	Brinay	521	21	542
24	Centre	18	3	02	037	Brinon-sur-Sauldre	1033	19	1052
24	Centre	18	2	22	038	Bruère-Allichamps	629	13	642
24	Centre	18	1	25	039	Bué	364	11	375
24	Centre	18	2	12	040	Bussy	365	3	368
24	Centre	18	2	27	041	La Celette	183	1	184
24	Centre	18	2	22	042	La Celle	354	10	364
24	Centre	18	2	18	043	La Celle-Condé	198	2	200
24	Centre	18	3	19	044	Cerbois	445	8	453
24	Centre	18	2	12	045	Chalivoy-Milon	463	25	488
24	Centre	18	2	10	046	Chambon	159	3	162
24	Centre	18	3	06	047	La Chapelle-d;Angillon	665	11	676
24	Centre	18	2	14	048	La Chapelle-Hugon	387	9	396
24	Centre	18	1	24	049	La Chapelle-Montlinard	496	16	512
24	Centre	18	1	35	050	La Chapelle-Saint-Ursin	3205	89	3294
24	Centre	18	1	15	051	La Chapelotte	184	1	185
24	Centre	18	2	07	052	Charenton-du-Cher	1110	27	1137
24	Centre	18	1	24	053	Charentonnay	322	2	324
24	Centre	18	2	21	054	Charly	218	7	225
24	Centre	18	1	08	055	Chârost	1035	1	1036
24	Centre	18	1	04	056	Chassy	256	3	259
24	Centre	18	2	09	057	Châteaumeillant	2015	46	2061
24	Centre	18	2	10	058	Châteauneuf-sur-Cher	1500	37	1537
24	Centre	18	2	11	059	Le Châtelet	1124	43	1167
24	Centre	18	2	26	060	Chaumont	50	1	51
24	Centre	18	1	24	061	Chaumoux-Marcilly	101	5	106
24	Centre	18	2	14	062	Le Chautay	257	10	267
24	Centre	18	2	10	063	Chavannes	183	4	187
24	Centre	18	3	19	064	Chéry	221	6	227
24	Centre	18	2	18	065	Chezal-Benoît	872	12	884
24	Centre	18	1	08	066	Civray	995	16	1011
24	Centre	18	3	02	067	Clémont	708	11	719
24	Centre	18	2	12	068	Cogny	39	0	39
24	Centre	18	2	22	069	Colombiers	405	13	418
24	Centre	18	1	28	070	Concressault	224	7	231
24	Centre	18	2	12	071	Contres	35	0	35
24	Centre	18	2	21	072	Cornusse	276	3	279
24	Centre	18	2	10	073	Corquoy	239	3	242
24	Centre	18	1	25	074	Couargues	197	6	203
24	Centre	18	2	14	075	Cours-les-Barres	1082	22	1104
24	Centre	18	2	07	076	Coust	455	8	463
24	Centre	18	1	24	077	Couy	380	10	390
24	Centre	18	1	25	079	Crézancy-en-Sancerre	478	15	493
24	Centre	18	2	10	078	Crézançay-sur-Cher	65	0	65
24	Centre	18	2	21	080	Croisy	155	6	161
24	Centre	18	1	04	081	Crosses	329	6	335
24	Centre	18	2	14	082	Cuffy	1123	26	1149
24	Centre	18	2	09	083	Culan	791	10	801
24	Centre	18	1	28	084	Dampierre-en-Crot	215	4	219
24	Centre	18	3	13	085	Dampierre-en-Graçay	238	3	241
24	Centre	18	2	22	086	Drevant	574	17	591
24	Centre	18	2	12	087	Dun-sur-Auron	4440	74	4514
24	Centre	18	3	06	088	Ennordres	215	9	224
24	Centre	18	2	27	089	Épineuil-le-Fleuriel	463	10	473
24	Centre	18	1	24	090	Étréchy	431	7	438
24	Centre	18	2	22	091	Farges-Allichamps	225	0	225
24	Centre	18	1	04	092	Farges-en-Septaine	987	13	1000
24	Centre	18	2	27	093	Faverdines	146	5	151
24	Centre	18	1	25	094	Feux	348	2	350
24	Centre	18	2	21	095	Flavigny	200	3	203
24	Centre	18	3	20	096	Foëcy	2059	46	2105
24	Centre	18	1	23	097	Fussy	1965	45	2010
24	Centre	18	1	25	098	Gardefort	139	5	144
24	Centre	18	1	24	099	Garigny	213	7	220
24	Centre	18	3	13	100	Genouilly	715	18	733
24	Centre	18	2	14	101	Germigny-l;Exempt	327	13	340
24	Centre	18	2	26	102	Givardon	310	4	314
24	Centre	18	3	13	103	Graçay	1500	25	1525
24	Centre	18	1	24	104	Groises	143	0	143
24	Centre	18	1	04	105	Gron	475	8	483
24	Centre	18	2	26	106	Grossouvre	286	5	291
24	Centre	18	2	22	107	La Groutte	128	5	133
24	Centre	18	2	14	108	La Guerche-sur-l;Aubois	3339	43	3382
24	Centre	18	1	15	109	Henrichemont	1802	55	1857
24	Centre	18	1	24	110	Herry	1029	17	1046
24	Centre	18	1	15	111	Humbligny	172	0	172
24	Centre	18	2	11	112	Ids-Saint-Roch	312	14	326
24	Centre	18	2	21	113	Ignol	172	3	175
24	Centre	18	2	18	114	Ineuil	234	12	246
24	Centre	18	3	06	115	Ivoy-le-Pré	889	18	907
24	Centre	18	1	25	116	Jalognes	281	16	297
24	Centre	18	1	28	117	Jars	481	17	498
24	Centre	18	2	14	118	Jouet-sur-l;Aubois	1495	26	1521
24	Centre	18	1	04	119	Jussy-Champagne	225	7	232
24	Centre	18	1	24	120	Jussy-le-Chaudrier	634	7	641
24	Centre	18	2	12	121	Lantan	106	2	108
24	Centre	18	1	17	122	Lapan	168	0	168
24	Centre	18	1	04	123	Laverdines	54	2	56
24	Centre	18	3	19	124	Lazenay	357	5	362
24	Centre	18	1	16	125	Léré	1189	33	1222
24	Centre	18	1	17	126	Levet	1366	27	1393
24	Centre	18	2	18	127	Lignières	1485	64	1549
24	Centre	18	3	19	128	Limeux	150	2	152
24	Centre	18	1	17	129	Lissay-Lochy	218	11	229
24	Centre	18	2	27	130	Loye-sur-Arnon	303	6	309
24	Centre	18	2	21	131	Lugny-Bourbonnais	33	6	39
24	Centre	18	1	24	132	Lugny-Champagne	170	1	171
24	Centre	18	1	08	133	Lunery	1446	53	1499
24	Centre	18	3	19	134	Lury-sur-Arnon	676	9	685
24	Centre	18	2	11	135	Maisonnais	231	3	234
24	Centre	18	1	08	137	Mareuil-sur-Arnon	563	19	582
24	Centre	18	1	35	138	Marmagne	2041	57	2098
24	Centre	18	1	24	139	Marseilles-lès-Aubigny	675	5	680
24	Centre	18	2	22	136	Marçais	316	9	325
24	Centre	18	3	30	140	Massay	1404	23	1427
24	Centre	18	3	20	141	Mehun-sur-Yèvre	6820	113	6933
24	Centre	18	2	22	142	Meillant	713	23	736
24	Centre	18	2	21	143	Menetou-Couture	347	5	352
24	Centre	18	1	25	144	Menetou-Râtel	481	7	488
24	Centre	18	1	23	145	Menetou-Salon	1665	32	1697
24	Centre	18	1	25	146	Ménétréol-sous-Sancerre	396	14	410
24	Centre	18	3	03	147	Ménétréol-sur-Sauldre	250	2	252
24	Centre	18	3	19	148	Méreau	2396	63	2459
24	Centre	18	3	06	149	Méry-ès-Bois	604	14	618
24	Centre	18	3	30	150	Méry-sur-Cher	700	21	721
24	Centre	18	1	15	151	Montigny	380	4	384
24	Centre	18	2	18	152	Montlouis	114	1	115
24	Centre	18	2	11	153	Morlac	335	3	338
24	Centre	18	2	21	154	Mornay-Berry	210	2	212
24	Centre	18	2	26	155	Mornay-sur-Allier	439	10	449
24	Centre	18	1	01	156	Morogues	436	8	444
24	Centre	18	1	08	157	Morthomiers	731	16	747
24	Centre	18	1	04	158	Moulins-sur-Yèvre	697	21	718
24	Centre	18	3	30	159	Nançay	882	40	922
24	Centre	18	2	21	160	Nérondes	1560	20	1580
24	Centre	18	2	26	161	Neuilly-en-Dun	283	1	284
24	Centre	18	1	15	162	Neuilly-en-Sancerre	237	10	247
24	Centre	18	1	15	163	Neuvy-Deux-Clochers	316	2	318
24	Centre	18	2	26	164	Neuvy-le-Barrois	159	3	162
24	Centre	18	3	30	165	Neuvy-sur-Barangeon	1251	53	1304
24	Centre	18	1	04	166	Nohant-en-Goût	561	12	573
24	Centre	18	3	13	167	Nohant-en-Graçay	313	4	317
24	Centre	18	1	28	168	Le Noyer	260	2	262
24	Centre	18	2	22	169	Nozières	230	5	235
24	Centre	18	3	03	170	Oizon	712	20	732
24	Centre	18	2	22	171	Orcenais	267	4	271
24	Centre	18	2	22	172	Orval	1911	35	1946
24	Centre	18	2	12	173	Osmery	280	8	288
24	Centre	18	1	04	174	Osmoy	297	11	308
24	Centre	18	2	21	175	Ourouer-les-Bourdelins	645	12	657
24	Centre	18	1	01	176	Parassy	416	12	428
24	Centre	18	2	12	177	Parnay	50	0	50
24	Centre	18	2	27	178	La Perche	257	3	260
24	Centre	18	1	23	179	Pigny	797	14	811
24	Centre	18	1	17	180	Plaimpied-Givaudins	1744	57	1801
24	Centre	18	1	08	181	Plou	484	6	490
24	Centre	18	1	08	182	Poisieux	214	2	216
24	Centre	18	2	07	183	Le Pondy	134	1	135
24	Centre	18	1	24	184	Précy	329	8	337
24	Centre	18	3	06	185	Presly	253	6	259
24	Centre	18	3	19	186	Preuilly	459	6	465
24	Centre	18	2	09	187	Préveranges	583	12	595
24	Centre	18	1	08	188	Primelles	251	5	256
24	Centre	18	1	23	189	Quantilly	432	13	445
24	Centre	18	3	19	190	Quincy	876	27	903
24	Centre	18	2	12	191	Raymond	221	3	224
24	Centre	18	2	09	192	Reigny	257	10	267
24	Centre	18	2	11	193	Rezay	225	11	236
24	Centre	18	1	01	194	Rians	1036	28	1064
24	Centre	18	2	26	195	Sagonne	235	2	237
24	Centre	18	2	26	196	Saint-Aignan-des-Noyers	100	2	102
24	Centre	18	2	22	197	Saint-Amand-Montrond	10761	443	11204
24	Centre	18	1	08	198	Saint-Ambroix	411	7	418
24	Centre	18	2	18	199	Saint-Baudel	299	4	303
24	Centre	18	1	25	200	Saint-Bouize	332	8	340
24	Centre	18	1	17	201	Saint-Caprais	670	6	676
24	Centre	18	1	01	202	Saint-Céols	18	0	18
24	Centre	18	2	09	203	Saint-Christophe-le-Chaudry	98	1	99
24	Centre	18	2	12	204	Saint-Denis-de-Palin	336	6	342
24	Centre	18	1	35	205	Saint-Doulchard	9197	293	9490
24	Centre	18	1	23	206	Saint-Éloy-de-Gy	1529	47	1576
24	Centre	18	1	08	207	Saint-Florent-sur-Cher	6608	170	6778
24	Centre	18	2	27	209	Saint-Georges-de-Poisieux	419	7	426
24	Centre	18	3	13	210	Saint-Georges-sur-la-Prée	636	13	649
24	Centre	18	1	23	211	Saint-Georges-sur-Moulon	747	23	770
24	Centre	18	2	12	212	Saint-Germain-des-Bois	573	8	581
24	Centre	18	1	01	213	Saint-Germain-du-Puy	4830	101	4931
24	Centre	18	3	30	214	Saint-Hilaire-de-Court	670	18	688
24	Centre	18	2	21	215	Saint-Hilaire-de-Gondilly	183	5	188
24	Centre	18	2	18	216	Saint-Hilaire-en-Lignières	498	9	507
24	Centre	18	2	09	217	Saint-Jeanvrin	165	3	168
24	Centre	18	1	17	218	Saint-Just	598	28	626
24	Centre	18	3	30	219	Saint-Laurent	436	5	441
24	Centre	18	1	24	220	Saint-Léger-le-Petit	399	3	402
24	Centre	18	2	10	221	Saint-Loup-des-Chaumes	299	4	303
24	Centre	18	1	23	223	Saint-Martin-d;Auxigny	2176	52	2228
24	Centre	18	1	24	224	Saint-Martin-des-Champs	336	7	343
24	Centre	18	2	09	225	Saint-Maur	249	7	256
24	Centre	18	1	01	226	Saint-Michel-de-Volangis	470	12	482
24	Centre	18	3	13	228	Saint-Outrille	215	7	222
24	Centre	18	1	23	229	Saint-Palais	619	18	637
24	Centre	18	2	11	230	Saint-Pierre-les-Bois	322	6	328
24	Centre	18	2	07	231	Saint-Pierre-les-Étieux	738	18	756
24	Centre	18	2	09	232	Saint-Priest-la-Marche	235	9	244
24	Centre	18	1	25	233	Saint-Satur	1603	50	1653
24	Centre	18	2	09	234	Saint-Saturnin	422	13	435
24	Centre	18	2	10	236	Saint-Symphorien	132	3	135
24	Centre	18	2	27	238	Saint-Vitte	137	3	140
24	Centre	18	1	16	208	Sainte-Gemme-en-Sancerrois	405	11	416
24	Centre	18	1	17	222	Sainte-Lunaise	24	8	32
24	Centre	18	3	03	227	Sainte-Montaine	195	3	198
24	Centre	18	1	01	235	Sainte-Solange	1180	33	1213
24	Centre	18	3	20	237	Sainte-Thorette	472	11	483
24	Centre	18	1	04	239	Saligny-le-Vif	171	5	176
24	Centre	18	1	24	240	Sancergues	703	13	716
24	Centre	18	1	25	241	Sancerre	1607	41	1648
24	Centre	18	2	26	242	Sancoins	3309	66	3375
24	Centre	18	1	16	243	Santranges	426	5	431
24	Centre	18	1	08	244	Saugy	79	0	79
24	Centre	18	2	27	245	Saulzais-le-Potier	541	9	550
24	Centre	18	1	16	246	Savigny-en-Sancerre	1082	21	1103
24	Centre	18	1	04	247	Savigny-en-Septaine	659	23	682
24	Centre	18	1	17	248	Senneçay	450	5	455
24	Centre	18	1	25	249	Sens-Beaujeu	430	7	437
24	Centre	18	2	10	250	Serruelles	50	0	50
24	Centre	18	1	24	251	Sévry	73	1	74
24	Centre	18	2	09	252	Sidiailles	309	7	316
24	Centre	18	1	01	253	Soulangis	472	11	483
24	Centre	18	1	17	254	Soye-en-Septaine	572	18	590
24	Centre	18	1	08	255	Le Subdray	943	117	1060
24	Centre	18	1	28	256	Subligny	348	5	353
24	Centre	18	1	25	258	Sury-en-Vaux	729	17	746
24	Centre	18	1	28	259	Sury-ès-Bois	279	4	283
24	Centre	18	1	16	257	Sury-près-Léré	558	17	575
24	Centre	18	2	21	260	Tendron	114	1	115
24	Centre	18	2	07	261	Thaumiers	418	15	433
24	Centre	18	1	25	262	Thauvenay	346	15	361
24	Centre	18	3	30	263	Thénioux	663	13	676
24	Centre	18	1	28	264	Thou	78	1	79
24	Centre	18	2	14	265	Torteron	804	14	818
24	Centre	18	2	18	266	Touchay	282	10	292
24	Centre	18	1	17	267	Trouy	3827	108	3935
24	Centre	18	2	10	268	Uzay-le-Venon	415	11	426
24	Centre	18	1	28	269	Vailly-sur-Sauldre	790	13	803
24	Centre	18	2	10	270	Vallenay	705	10	715
24	Centre	18	1	23	271	Vasselay	1177	45	1222
24	Centre	18	1	25	272	Veaugues	658	11	669
24	Centre	18	2	10	273	Venesmes	884	24	908
24	Centre	18	1	25	274	Verdigny	284	14	298
24	Centre	18	2	26	275	Vereaux	176	3	179
24	Centre	18	2	07	276	Vernais	216	3	219
24	Centre	18	2	12	277	Verneuil	40	2	42
24	Centre	18	2	27	278	Vesdun	620	17	637
24	Centre	18	3	99	279	Vierzon	26946	729	27675
24	Centre	18	1	23	280	Vignoux-sous-les-Aix	713	22	735
24	Centre	18	3	30	281	Vignoux-sur-Barangeon	2107	45	2152
24	Centre	18	1	04	282	Villabon	559	12	571
24	Centre	18	2	18	283	Villecelin	112	0	112
24	Centre	18	1	28	284	Villegenon	237	6	243
24	Centre	18	1	08	285	Villeneuve-sur-Cher	435	3	438
24	Centre	18	1	04	286	Villequiers	526	3	529
24	Centre	18	1	25	287	Vinon	265	3	268
24	Centre	18	1	17	288	Vorly	251	3	254
24	Centre	18	1	04	289	Vornay	562	12	574
24	Centre	18	3	30	290	Vouzeron	550	21	571
74	Limousin	19	2	24	001	Affieux	371	10	381
74	Limousin	19	3	11	002	Aix	385	16	401
74	Limousin	19	1	04	003	Albignac	244	5	249
74	Limousin	19	2	01	004	Albussac	693	3	696
74	Limousin	19	1	09	005	Allassac	3796	110	3906
74	Limousin	19	3	17	006	Alleyrat	104	6	110
74	Limousin	19	2	16	007	Altillac	854	24	878
74	Limousin	19	3	17	008	Ambrugeat	203	10	213
74	Limousin	19	2	36	009	Les Angles-sur-Corrèze	103	6	109
74	Limousin	19	2	01	010	Argentat	3042	222	3264
74	Limousin	19	1	15	011	Arnac-Pompadour	1227	13	1240
74	Limousin	19	1	03	012	Astaillac	221	9	230
74	Limousin	19	1	04	013	Aubazines	874	15	889
74	Limousin	19	2	21	014	Auriac	228	3	231
74	Limousin	19	1	02	015	Ayen	720	20	740
74	Limousin	19	2	08	016	Bar	323	14	337
74	Limousin	19	2	16	017	Bassignac-le-Bas	90	4	94
74	Limousin	19	2	21	018	Bassignac-le-Haut	204	4	208
74	Limousin	19	1	03	019	Beaulieu-sur-Dordogne	1253	31	1284
74	Limousin	19	2	22	020	Beaumont	111	4	115
74	Limousin	19	3	23	021	Bellechassagne	74	9	83
74	Limousin	19	1	15	022	Benayes	267	8	275
74	Limousin	19	1	04	023	Beynat	1263	23	1286
74	Limousin	19	1	15	024	Beyssac	697	15	712
74	Limousin	19	1	15	025	Beyssenac	369	2	371
74	Limousin	19	1	03	026	Bilhac	212	11	223
74	Limousin	19	3	07	027	Bonnefond	115	4	119
74	Limousin	19	3	05	028	Bort-les-Orgues	2988	117	3105
74	Limousin	19	1	18	029	Branceilles	260	7	267
74	Limousin	19	1	02	030	Brignac-la-Plaine	864	31	895
74	Limousin	19	1	98	031	Brive-la-Gaillarde	48949	1323	50272
74	Limousin	19	1	03	032	Brivezac	182	8	190
74	Limousin	19	3	07	033	Bugeat	886	25	911
74	Limousin	19	2	16	034	Camps-Saint-Mathurin-Léobazel	245	8	253
74	Limousin	19	1	12	035	Chabrignac	559	8	567
74	Limousin	19	2	24	036	Chamberet	1325	25	1350
74	Limousin	19	2	22	037	Chamboulive	1184	17	1201
74	Limousin	19	2	35	038	Chameyrat	1581	50	1631
74	Limousin	19	2	10	039	Champagnac-la-Noaille	230	5	235
74	Limousin	19	2	20	040	Champagnac-la-Prune	171	3	174
74	Limousin	19	2	36	041	Chanac-les-Mines	494	12	506
74	Limousin	19	2	22	042	Chanteix	580	16	596
74	Limousin	19	1	34	043	La Chapelle-aux-Brocs	406	6	412
74	Limousin	19	1	03	044	La Chapelle-aux-Saints	226	5	231
74	Limousin	19	2	16	045	La Chapelle-Saint-Géraud	232	5	237
74	Limousin	19	2	10	046	Chapelle-Spinasse	115	4	119
74	Limousin	19	1	14	047	Chartrier-Ferrière	340	3	343
74	Limousin	19	2	36	048	Le Chastang	353	8	361
74	Limousin	19	1	14	049	Chasteaux	580	17	597
74	Limousin	19	1	18	050	Chauffour-sur-Vell	402	15	417
74	Limousin	19	2	08	051	Chaumeil	161	5	166
74	Limousin	19	3	23	052	Chavanac	56	2	58
74	Limousin	19	3	37	053	Chaveroche	209	7	216
74	Limousin	19	1	03	054	Chenailler-Mascheix	179	2	181
74	Limousin	19	3	19	055	Chirac-Bellevue	269	4	273
74	Limousin	19	2	20	056	Clergoux	378	8	386
74	Limousin	19	1	18	057	Collonges-la-Rouge	470	20	490
74	Limousin	19	3	17	058	Combressol	346	12	358
74	Limousin	19	1	12	059	Concèze	413	13	426
74	Limousin	19	2	28	060	Condat-sur-Ganaveix	643	23	666
74	Limousin	19	3	05	167	Confolent-Port-Dieu	28	2	30
74	Limousin	19	2	36	061	Cornil	1415	22	1437
74	Limousin	19	2	08	062	Corrèze	1161	40	1201
74	Limousin	19	1	30	063	Cosnac	2902	114	3016
74	Limousin	19	3	11	064	Couffy-sur-Sarsonne	73	1	74
74	Limousin	19	3	11	065	Courteix	63	2	65
74	Limousin	19	1	14	066	Cublac	1751	41	1792
74	Limousin	19	1	18	067	Curemonte	214	9	223
74	Limousin	19	1	34	068	Dampniat	685	15	700
74	Limousin	19	2	21	069	Darazac	157	8	165
74	Limousin	19	3	17	070	Darnets	346	11	357
74	Limousin	19	3	17	071	Davignac	243	7	250
74	Limousin	19	1	09	072	Donzenac	2545	36	2581
74	Limousin	19	2	10	073	Égletons	4481	731	5212
74	Limousin	19	2	24	074	L; Église-aux-Bois	48	2	50
74	Limousin	19	2	20	075	Espagnac	334	4	338
74	Limousin	19	2	28	076	Espartignac	410	12	422
74	Limousin	19	1	33	077	Estivals	129	3	132
74	Limousin	19	1	29	078	Estivaux	373	3	376
74	Limousin	19	2	28	079	Eyburie	465	12	477
74	Limousin	19	3	11	080	Eygurande	699	20	719
74	Limousin	19	2	08	081	Eyrein	525	7	532
74	Limousin	19	2	35	082	Favars	973	31	1004
74	Limousin	19	3	11	083	Feyt	117	3	120
74	Limousin	19	2	01	084	Forgès	310	10	320
74	Limousin	19	2	36	085	Gimel-les-Cascades	720	9	729
74	Limousin	19	2	16	086	Goulles	345	10	355
74	Limousin	19	3	07	087	Gourdon-Murat	116	6	122
74	Limousin	19	3	07	088	Grandsaigne	47	4	51
74	Limousin	19	2	20	089	Gros-Chastang	171	2	173
74	Limousin	19	2	20	090	Gumond	103	1	104
74	Limousin	19	2	21	091	Hautefage	312	10	322
74	Limousin	19	2	10	092	Le Jardin	83	3	86
74	Limousin	19	1	33	093	Jugeals-Nazareth	853	18	871
74	Limousin	19	1	12	094	Juillac	1153	24	1177
74	Limousin	19	2	24	095	Lacelle	135	9	144
74	Limousin	19	2	36	096	Ladignac-sur-Rondelles	440	12	452
74	Limousin	19	2	13	097	Lafage-sur-Sombre	117	4	121
74	Limousin	19	2	36	098	Lagarde-Enval	760	20	780
74	Limousin	19	1	18	099	Lagleygeolle	224	5	229
74	Limousin	19	2	22	100	Lagraulière	1111	15	1126
74	Limousin	19	2	36	101	Laguenne	1465	56	1521
74	Limousin	19	3	19	102	Lamazière-Basse	297	5	302
74	Limousin	19	3	11	103	Lamazière-Haute	70	1	71
74	Limousin	19	2	28	104	Lamongerie	108	3	111
74	Limousin	19	1	04	105	Lanteuil	519	11	530
74	Limousin	19	2	13	106	Lapleau	381	7	388
74	Limousin	19	1	14	107	Larche	1609	46	1655
74	Limousin	19	3	11	108	Laroche-près-Feyt	75	0	75
74	Limousin	19	1	12	109	Lascaux	175	9	184
74	Limousin	19	2	13	110	Latronche	146	6	152
74	Limousin	19	2	13	111	Laval-sur-Luzège	98	2	100
74	Limousin	19	3	07	112	Lestards	109	4	113
74	Limousin	19	3	19	113	Liginiac	641	65	706
74	Limousin	19	3	37	114	Lignareix	157	9	166
74	Limousin	19	1	18	115	Ligneyrac	302	7	309
74	Limousin	19	1	03	116	Liourdres	224	7	231
74	Limousin	19	1	14	117	Lissac-sur-Couze	727	13	740
74	Limousin	19	2	24	118	Le Lonzac	778	15	793
74	Limousin	19	1	18	119	Lostanges	129	3	132
74	Limousin	19	1	02	120	Louignac	222	6	228
74	Limousin	19	1	15	121	Lubersac	2314	56	2370
74	Limousin	19	2	24	122	Madranges	194	2	196
74	Limousin	19	1	34	123	Malemort-sur-Corrèze	7709	193	7902
74	Limousin	19	1	14	124	Mansac	1362	23	1385
74	Limousin	19	2	36	127	Marc-la-Tour	168	7	175
74	Limousin	19	2	20	125	Marcillac-la-Croisille	852	17	869
74	Limousin	19	1	18	126	Marcillac-la-Croze	182	3	185
74	Limousin	19	3	05	128	Margerides	264	7	271
74	Limousin	19	2	28	129	Masseret	679	13	692
74	Limousin	19	3	17	130	Maussac	407	4	411
74	Limousin	19	2	28	131	Meilhards	515	10	525
74	Limousin	19	2	01	132	Ménoire	90	1	91
74	Limousin	19	2	16	133	Mercoeur	244	6	250
74	Limousin	19	3	11	134	Merlines	803	22	825
74	Limousin	19	3	27	135	Mestes	355	9	364
74	Limousin	19	3	17	136	Meymac	2526	165	2691
74	Limousin	19	2	08	137	Meyrignac-l;Église	50	3	53
74	Limousin	19	1	18	138	Meyssac	1252	78	1330
74	Limousin	19	3	23	139	Millevaches	87	0	87
74	Limousin	19	2	01	140	Monceaux-sur-Dordogne	673	26	699
74	Limousin	19	3	11	141	Monestier-Merlines	314	7	321
74	Limousin	19	3	05	142	Monestier-Port-Dieu	124	2	126
74	Limousin	19	2	10	143	Montaignac-Saint-Hippolyte	548	10	558
74	Limousin	19	1	15	144	Montgibaud	235	5	240
74	Limousin	19	2	10	145	Moustier-Ventadour	490	53	543
74	Limousin	19	2	35	146	Naves	2319	223	2542
74	Limousin	19	1	33	147	Nespouls	623	20	643
74	Limousin	19	3	19	148	Neuvic	1810	289	2099
74	Limousin	19	2	01	149	Neuville	196	5	201
74	Limousin	19	1	18	150	Noailhac	359	9	368
74	Limousin	19	1	33	151	Noailles	875	30	905
74	Limousin	19	1	03	152	Nonards	450	16	466
74	Limousin	19	1	02	153	Objat	3593	104	3697
74	Limousin	19	1	29	154	Orgnac-sur-Vézère	302	7	309
74	Limousin	19	2	08	155	Orliac-de-Bar	269	5	274
74	Limousin	19	1	04	156	Palazinges	111	0	111
74	Limousin	19	3	19	157	Palisse	235	3	238
74	Limousin	19	2	36	158	Pandrignes	172	7	179
74	Limousin	19	3	17	159	Péret-Bel-Air	107	4	111
74	Limousin	19	3	07	160	Pérols-sur-Vézère	188	7	195
74	Limousin	19	1	02	161	Perpezac-le-Blanc	467	13	480
74	Limousin	19	1	29	162	Perpezac-le-Noir	1092	16	1108
74	Limousin	19	1	04	163	Le Pescher	276	13	289
74	Limousin	19	3	23	164	Peyrelevade	815	22	837
74	Limousin	19	2	24	165	Peyrissac	137	3	140
74	Limousin	19	2	22	166	Pierrefitte	75	1	76
74	Limousin	19	3	07	168	Pradines	104	3	107
74	Limousin	19	1	03	169	Puy-d;Arnac	271	8	279
74	Limousin	19	1	03	170	Queyssac-les-Vignes	207	5	212
74	Limousin	19	2	16	171	Reygade	200	2	202
74	Limousin	19	2	24	172	Rilhac-Treignac	119	0	119
74	Limousin	19	2	21	173	Rilhac-Xaintrie	332	10	342
74	Limousin	19	2	20	174	La Roche-Canillac	157	3	160
74	Limousin	19	3	19	175	Roche-le-Peyroux	87	6	93
74	Limousin	19	2	10	176	Rosiers-d;Égletons	1078	28	1106
74	Limousin	19	1	12	177	Rosiers-de-Juillac	188	2	190
74	Limousin	19	1	09	178	Sadroc	801	17	818
74	Limousin	19	1	18	179	Saillac	184	3	187
74	Limousin	19	3	37	180	Saint-Angel	687	22	709
74	Limousin	19	2	08	181	Saint-Augustin	453	3	456
74	Limousin	19	1	02	182	Saint-Aulaire	856	26	882
74	Limousin	19	2	20	183	Saint-Bazile-de-la-Roche	147	2	149
74	Limousin	19	1	18	184	Saint-Bazile-de-Meyssac	151	4	155
74	Limousin	19	2	36	185	Saint-Bonnet-Avalouze	202	2	204
74	Limousin	19	2	01	186	Saint-Bonnet-Elvert	203	8	211
74	Limousin	19	1	29	188	Saint-Bonnet-l;Enfantier	344	4	348
74	Limousin	19	1	12	187	Saint-Bonnet-la-Rivière	371	9	380
74	Limousin	19	2	16	189	Saint-Bonnet-les-Tours-de-Merle	43	1	44
74	Limousin	19	3	05	190	Saint-Bonnet-près-Bort	188	6	194
74	Limousin	19	1	14	191	Saint-Cernin-de-Larche	597	21	618
74	Limousin	19	2	01	192	Saint-Chamant	504	14	518
74	Limousin	19	2	21	193	Saint-Cirgues-la-Loutre	190	7	197
74	Limousin	19	2	22	194	Saint-Clément	1275	29	1304
74	Limousin	19	1	02	195	Saint-Cyprien	381	6	387
74	Limousin	19	1	12	196	Saint-Cyr-la-Roche	470	12	482
74	Limousin	19	1	15	198	Saint-Éloy-les-Tuileries	120	3	123
74	Limousin	19	3	27	199	Saint-Étienne-aux-Clos	231	19	250
74	Limousin	19	3	19	200	Saint-Étienne-la-Geneste	93	2	95
74	Limousin	19	3	27	201	Saint-Exupéry-les-Roches	551	9	560
74	Limousin	19	3	27	204	Saint-Fréjoux	289	10	299
74	Limousin	19	2	21	205	Saint-Geniez-ô-Merle	105	8	113
74	Limousin	19	3	23	206	Saint-Germain-Lavolps	91	3	94
74	Limousin	19	2	35	207	Saint-Germain-les-Vergnes	1008	21	1029
74	Limousin	19	2	13	208	Saint-Hilaire-Foissac	210	5	215
74	Limousin	19	2	24	209	Saint-Hilaire-les-Courbes	160	7	167
74	Limousin	19	3	19	210	Saint-Hilaire-Luc	76	0	76
74	Limousin	19	2	35	211	Saint-Hilaire-Peyroux	903	11	914
74	Limousin	19	2	01	212	Saint-Hilaire-Taurieux	95	2	97
74	Limousin	19	2	22	213	Saint-Jal	651	7	658
74	Limousin	19	2	21	214	Saint-Julien-aux-Bois	492	12	504
74	Limousin	19	2	16	215	Saint-Julien-le-Pèlerin	135	2	137
74	Limousin	19	1	15	216	Saint-Julien-le-Vendômois	264	8	272
74	Limousin	19	1	18	217	Saint-Julien-Maumont	172	8	180
74	Limousin	19	3	05	218	Saint-Julien-près-Bort	431	11	442
74	Limousin	19	2	36	220	Saint-Martial-de-Gimel	472	10	482
74	Limousin	19	2	01	221	Saint-Martial-Entraygues	80	7	87
74	Limousin	19	2	20	222	Saint-Martin-la-Méanne	363	7	370
74	Limousin	19	1	15	223	Saint-Martin-Sepert	272	4	276
74	Limousin	19	2	13	225	Saint-Merd-de-Lapleau	152	3	155
74	Limousin	19	3	07	226	Saint-Merd-les-Oussines	127	4	131
74	Limousin	19	2	35	227	Saint-Mexant	1163	20	1183
74	Limousin	19	2	13	228	Saint-Pantaléon-de-Lapleau	70	3	73
74	Limousin	19	1	14	229	Saint-Pantaléon-de-Larche	4624	121	4745
74	Limousin	19	1	15	230	Saint-Pardoux-Corbier	366	4	370
74	Limousin	19	1	09	234	Saint-Pardoux-l;Ortigier	476	6	482
74	Limousin	19	2	20	231	Saint-Pardoux-la-Croisille	172	6	178
74	Limousin	19	3	11	232	Saint-Pardoux-le-Neuf	70	2	72
74	Limousin	19	3	37	233	Saint-Pardoux-le-Vieux	281	21	302
74	Limousin	19	2	20	235	Saint-Paul	217	3	220
74	Limousin	19	2	36	236	Saint-Priest-de-Gimel	473	10	483
74	Limousin	19	2	21	237	Saint-Privat	1118	15	1133
74	Limousin	19	3	23	238	Saint-Rémy	231	9	240
74	Limousin	19	1	02	239	Saint-Robert	342	10	352
74	Limousin	19	2	22	240	Saint-Salvadour	299	10	309
74	Limousin	19	3	23	241	Saint-Setiers	235	7	242
74	Limousin	19	1	12	242	Saint-Solve	409	8	417
74	Limousin	19	1	15	243	Saint-Sornin-Lavolps	928	20	948
74	Limousin	19	3	17	244	Saint-Sulpice-les-Bois	72	2	74
74	Limousin	19	2	01	245	Saint-Sylvain	146	3	149
74	Limousin	19	1	09	246	Saint-Viance	1676	39	1715
74	Limousin	19	3	05	247	Saint-Victour	186	2	188
74	Limousin	19	2	28	248	Saint-Ybard	664	11	675
74	Limousin	19	2	10	249	Saint-Yrieix-le-Déjalat	391	15	406
74	Limousin	19	1	09	202	Sainte-Féréole	1816	47	1863
74	Limousin	19	2	36	203	Sainte-Fortunade	1775	95	1870
74	Limousin	19	3	19	219	Sainte-Marie-Lapanouze	61	0	61
74	Limousin	19	2	28	250	Salon-la-Tour	708	10	718
74	Limousin	19	2	08	251	Sarran	255	7	262
74	Limousin	19	3	05	252	Sarroux	432	13	445
74	Limousin	19	1	02	253	Segonzac	233	7	240
74	Limousin	19	1	15	254	Ségur-le-Château	239	3	242
74	Limousin	19	2	22	255	Seilhac	1714	64	1778
74	Limousin	19	3	19	256	Sérandon	357	9	366
74	Limousin	19	1	04	257	Sérilhac	281	1	282
74	Limousin	19	2	21	258	Servières-le-Château	670	21	691
74	Limousin	19	2	16	259	Sexcles	227	7	234
74	Limousin	19	1	03	260	Sioniac	246	4	250
74	Limousin	19	3	23	261	Sornac	830	17	847
74	Limousin	19	2	24	262	Soudaine-Lavinadière	178	12	190
74	Limousin	19	3	17	263	Soudeilles	287	16	303
74	Limousin	19	2	13	264	Soursac	490	13	503
74	Limousin	19	3	07	265	Tarnac	322	6	328
74	Limousin	19	3	05	266	Thalamy	109	2	111
74	Limousin	19	3	07	268	Toy-Viam	32	2	34
74	Limousin	19	2	24	269	Treignac	1376	74	1450
74	Limousin	19	1	29	270	Troche	540	1	541
74	Limousin	19	1	03	271	Tudeils	249	20	269
74	Limousin	19	2	99	272	Tulle	14923	915	15838
74	Limousin	19	1	18	273	Turenne	793	25	818
74	Limousin	19	1	34	274	Ussac	3859	149	4008
74	Limousin	19	3	97	275	Ussel	10245	503	10748
74	Limousin	19	2	28	276	Uzerche	3126	69	3195
74	Limousin	19	3	27	277	Valiergues	143	4	147
74	Limousin	19	1	34	278	Varetz	2239	54	2293
74	Limousin	19	1	02	279	Vars-sur-Roseix	323	4	327
74	Limousin	19	1	03	280	Végennes	166	4	170
74	Limousin	19	2	24	281	Veix	71	0	71
74	Limousin	19	1	34	282	Venarsal	486	7	493
74	Limousin	19	3	05	283	Veyrières	65	1	66
74	Limousin	19	3	07	284	Viam	113	4	117
74	Limousin	19	1	29	285	Vigeois	1233	17	1250
74	Limousin	19	1	12	286	Vignols	589	18	607
74	Limousin	19	2	08	287	Vitrac-sur-Montane	258	5	263
74	Limousin	19	1	12	288	Voutezac	1270	139	1409
74	Limousin	19	1	02	289	Yssandon	684	15	699
94	Corse	2A	1	73	001	Afa	2843	106	2949
94	Corse	2A	1	98	004	Ajaccio	65542	661	66203
94	Corse	2A	1	73	006	Alata	2953	104	3057
94	Corse	2A	1	48	008	Albitreccia	1526	13	1539
94	Corse	2A	4	55	011	Altagène	53	3	56
94	Corse	2A	1	51	014	Ambiegna	61	1	62
94	Corse	2A	1	73	017	Appietto	1528	38	1566
94	Corse	2A	4	30	018	Arbellara	141	1	142
94	Corse	2A	1	61	019	Arbori	61	2	63
94	Corse	2A	4	34	021	Argiusta-Moriccio	82	2	84
94	Corse	2A	1	51	022	Arro	76	1	77
94	Corse	2A	4	55	024	Aullène	182	4	186
94	Corse	2A	1	48	026	Azilone-Ampaza	142	2	144
94	Corse	2A	1	51	027	Azzana	49	0	49
94	Corse	2A	1	61	028	Balogna	126	3	129
94	Corse	2A	1	02	031	Bastelica	543	9	552
94	Corse	2A	1	73	032	Bastelicaccia	3283	86	3369
94	Corse	2A	4	53	035	Belvédère-Campomoro	163	0	163
94	Corse	2A	4	53	038	Bilia	46	2	48
94	Corse	2A	1	06	040	Bocognano	485	10	495
94	Corse	2A	4	07	041	Bonifacio	2955	54	3009
94	Corse	2A	1	51	048	Calcatoggio	529	8	537
94	Corse	2A	1	48	056	Campo	84	1	85
94	Corse	2A	1	51	060	Cannelle	48	3	51
94	Corse	2A	4	22	061	Carbini	110	7	117
94	Corse	2A	1	06	062	Carbuccia	333	8	341
94	Corse	2A	1	48	064	Cardo-Torgia	37	0	37
94	Corse	2A	1	35	065	Cargèse	1161	19	1180
94	Corse	2A	4	55	066	Cargiaca	58	2	60
94	Corse	2A	1	51	070	Casaglione	366	4	370
94	Corse	2A	4	34	071	Casalabriva	180	3	183
94	Corse	2A	1	02	085	Cauro	1287	42	1329
94	Corse	2A	1	62	089	Ciamannacce	138	2	140
94	Corse	2A	1	61	090	Coggia	833	23	856
94	Corse	2A	1	48	091	Cognocoli-Monticchi	183	1	184
94	Corse	2A	4	40	092	Conca	1069	18	1087
94	Corse	2A	1	62	094	Corrano	86	1	87
94	Corse	2A	1	48	098	Coti-Chiavari	724	10	734
94	Corse	2A	1	62	099	Cozzano	271	9	280
94	Corse	2A	1	35	100	Cristinacce	60	2	62
94	Corse	2A	1	06	103	Cuttoli-Corticchiato	1911	42	1953
94	Corse	2A	1	02	104	Eccica-Suarella	1030	26	1056
94	Corse	2A	1	35	108	Évisa	190	3	193
94	Corse	2A	4	70	114	Figari	1276	22	1298
94	Corse	2A	4	53	115	Foce	142	4	146
94	Corse	2A	1	48	117	Forciolo	72	1	73
94	Corse	2A	4	30	118	Fozzano	197	7	204
94	Corse	2A	1	48	119	Frasseto	124	2	126
94	Corse	2A	4	53	127	Giuncheto	86	1	87
94	Corse	2A	4	53	128	Granace	57	2	59
94	Corse	2A	4	53	129	Grossa	47	1	48
94	Corse	2A	1	48	130	Grosseto-Prugna	2601	52	2653
94	Corse	2A	1	61	131	Guagno	153	8	161
94	Corse	2A	1	48	132	Guargualé	123	0	123
94	Corse	2A	1	62	133	Guitera-les-Bains	117	2	119
94	Corse	2A	4	40	139	Lecci	1357	19	1376
94	Corse	2A	1	61	141	Letia	105	2	107
94	Corse	2A	4	22	142	Levie	769	9	778
94	Corse	2A	1	51	144	Lopigna	105	0	105
94	Corse	2A	4	55	146	Loreto-di-Tallano	49	0	49
94	Corse	2A	1	35	154	Marignana	102	1	103
94	Corse	2A	4	55	158	Mela	30	0	30
94	Corse	2A	4	34	160	Moca-Croce	226	4	230
94	Corse	2A	4	70	163	Monacia-d;Aullène	464	5	469
94	Corse	2A	1	61	174	Murzo	83	0	83
94	Corse	2A	1	02	181	Ocana	536	11	547
94	Corse	2A	4	34	186	Olivese	259	3	262
94	Corse	2A	4	30	189	Olmeto	1222	40	1262
94	Corse	2A	4	55	191	Olmiccia	106	5	111
94	Corse	2A	1	61	196	Orto	57	1	58
94	Corse	2A	1	35	197	Osani	110	2	112
94	Corse	2A	1	35	198	Ota	565	11	576
94	Corse	2A	1	62	200	Palneca	163	4	167
94	Corse	2A	1	35	203	Partinello	103	4	107
94	Corse	2A	1	51	204	Pastricciola	84	1	85
94	Corse	2A	1	06	209	Peri	1737	31	1768
94	Corse	2A	4	34	211	Petreto-Bicchisano	570	12	582
94	Corse	2A	1	35	212	Piana	455	12	467
94	Corse	2A	4	70	215	Pianottoli-Caldarello	887	3	890
94	Corse	2A	1	48	228	Pietrosella	1251	28	1279
94	Corse	2A	1	48	232	Pila-Canale	281	2	283
94	Corse	2A	1	61	240	Poggiolo	97	2	99
94	Corse	2A	4	40	247	Porto-Vecchio	11035	273	11308
94	Corse	2A	4	30	249	Propriano	3399	56	3455
94	Corse	2A	1	48	253	Quasquara	55	1	56
94	Corse	2A	4	55	254	Quenza	212	10	222
94	Corse	2A	1	61	258	Renno	69	2	71
94	Corse	2A	1	51	259	Rezza	58	0	58
94	Corse	2A	1	51	262	Rosazia	56	1	57
94	Corse	2A	4	55	308	Sainte-Lucie-de-Tallano	454	11	465
94	Corse	2A	1	51	266	Salice	71	1	72
94	Corse	2A	1	62	268	Sampolo	57	1	58
94	Corse	2A	4	22	300	San-Gavino-di-Carbini	1060	34	1094
94	Corse	2A	1	51	295	Sant;Andréa-d;Orcino	74	2	76
94	Corse	2A	4	30	310	Santa-Maria-Figaniella	81	1	82
94	Corse	2A	1	48	312	Santa-Maria-Siché	442	3	445
94	Corse	2A	1	51	270	Sari-d;Orcino	312	4	316
94	Corse	2A	4	40	269	Sari-Solenzara	1334	24	1358
94	Corse	2A	1	06	271	Sarrola-Carcopino	2044	33	2077
94	Corse	2A	4	53	272	Sartène	3259	112	3371
94	Corse	2A	1	48	276	Serra-di-Ferro	473	3	476
94	Corse	2A	4	55	278	Serra-di-Scopamène	105	6	111
94	Corse	2A	1	35	279	Serriera	118	0	118
94	Corse	2A	1	61	282	Soccia	147	5	152
94	Corse	2A	4	34	284	Sollacaro	355	7	362
94	Corse	2A	4	55	285	Sorbollano	71	1	72
94	Corse	2A	4	70	288	Sotta	1025	18	1043
94	Corse	2A	1	62	322	Tasso	93	6	99
94	Corse	2A	1	06	323	Tavaco	281	4	285
94	Corse	2A	1	06	324	Tavera	389	7	396
94	Corse	2A	1	02	326	Tolla	117	1	118
94	Corse	2A	1	06	330	Ucciani	461	10	471
94	Corse	2A	1	48	331	Urbalacone	71	0	71
94	Corse	2A	1	06	336	Valle-di-Mezzana	314	5	319
94	Corse	2A	1	06	345	Vero	477	8	485
94	Corse	2A	1	61	348	Vico	885	18	903
94	Corse	2A	4	30	349	Viggianello	635	12	647
94	Corse	2A	1	73	351	Villanova	349	7	356
94	Corse	2A	4	55	357	Zérubia	29	4	33
94	Corse	2A	1	62	358	Zévaco	61	0	61
94	Corse	2A	1	62	359	Zicavo	241	8	249
94	Corse	2A	1	48	360	Zigliara	141	2	143
94	Corse	2A	4	22	362	Zonza	2341	47	2388
94	Corse	2A	4	55	363	Zoza	53	0	53
94	Corse	2B	3	60	002	Aghione	234	7	241
94	Corse	2B	3	54	003	Aiti	35	0	35
94	Corse	2B	3	54	005	Alando	28	1	29
94	Corse	2B	3	10	007	Albertacce	225	6	231
94	Corse	2B	3	24	009	Aléria	2067	41	2108
94	Corse	2B	5	05	010	Algajola	296	7	303
94	Corse	2B	3	54	012	Altiani	80	0	80
94	Corse	2B	3	54	013	Alzi	20	0	20
94	Corse	2B	3	24	015	Ampriani	15	1	16
94	Corse	2B	3	60	016	Antisanti	402	8	410
94	Corse	2B	5	05	020	Aregno	595	9	604
94	Corse	2B	3	25	023	Asco	125	0	125
94	Corse	2B	5	05	025	Avapessa	77	2	79
94	Corse	2B	5	29	029	Barbaggio	230	3	233
94	Corse	2B	2	42	030	Barrettali	148	5	153
94	Corse	2B	2	99	033	Bastia	43008	607	43615
94	Corse	2B	5	05	034	Belgodère	482	10	492
94	Corse	2B	3	14	036	Bigorno	77	0	77
94	Corse	2B	2	08	037	Biguglia	7058	141	7199
94	Corse	2B	3	25	039	Bisinchi	195	2	197
94	Corse	2B	2	08	042	Borgo	7646	109	7755
94	Corse	2B	2	09	043	Brando	1623	45	1668
94	Corse	2B	3	54	045	Bustanico	61	1	62
94	Corse	2B	2	42	046	Cagnano	195	5	200
94	Corse	2B	3	10	047	Calacuccia	307	12	319
94	Corse	2B	5	11	049	Calenzana	2168	19	2187
94	Corse	2B	5	12	050	Calvi	5394	108	5502
94	Corse	2B	3	54	051	Cambia	80	3	83
94	Corse	2B	3	37	052	Campana	24	1	25
94	Corse	2B	3	24	053	Campi	20	2	22
94	Corse	2B	3	14	054	Campile	183	1	184
94	Corse	2B	3	14	055	Campitello	110	2	112
94	Corse	2B	3	24	057	Canale-di-Verde	350	4	354
94	Corse	2B	2	09	058	Canari	321	5	326
94	Corse	2B	3	14	059	Canavaggia	106	1	107
94	Corse	2B	3	37	063	Carcheto-Brustico	27	0	27
94	Corse	2B	3	37	067	Carpineto	27	0	27
94	Corse	2B	3	54	068	Carticasi	33	0	33
94	Corse	2B	3	39	069	Casabianca	91	0	91
94	Corse	2B	3	39	072	Casalta	53	0	53
94	Corse	2B	3	10	073	Casamaccioli	102	3	105
94	Corse	2B	3	58	074	Casanova	348	4	352
94	Corse	2B	3	60	075	Casevecchie	67	0	67
94	Corse	2B	3	59	077	Castellare-di-Casinca	550	4	554
94	Corse	2B	3	54	078	Castellare-di-Mercurio	34	0	34
94	Corse	2B	3	25	079	Castello-di-Rostino	413	4	417
94	Corse	2B	3	25	080	Castifao	159	3	162
94	Corse	2B	3	10	081	Castiglione	34	0	34
94	Corse	2B	3	25	082	Castineta	54	0	54
94	Corse	2B	3	10	083	Castirla	192	2	194
94	Corse	2B	5	05	084	Cateri	214	2	216
94	Corse	2B	2	42	086	Centuri	218	4	222
94	Corse	2B	3	16	087	Cervione	1686	26	1712
94	Corse	2B	3	24	088	Chiatra	210	2	212
94	Corse	2B	3	41	366	Chisa	100	0	100
94	Corse	2B	5	20	093	Corbara	963	21	984
94	Corse	2B	3	10	095	Corscia	168	2	170
94	Corse	2B	3	17	096	Corte	6915	116	7031
94	Corse	2B	5	05	097	Costa	65	0	65
94	Corse	2B	3	39	101	Croce	84	1	85
94	Corse	2B	3	14	102	Crocicchia	47	2	49
94	Corse	2B	3	54	105	Erbajolo	105	2	107
94	Corse	2B	3	54	106	Érone	6	1	7
94	Corse	2B	2	42	107	Ersa	153	2	155
94	Corse	2B	5	29	109	Farinole	217	4	221
94	Corse	2B	3	54	110	Favalello	53	0	53
94	Corse	2B	3	37	111	Felce	50	0	50
94	Corse	2B	5	05	112	Feliceto	211	1	212
94	Corse	2B	3	39	113	Ficaja	50	0	50
94	Corse	2B	3	54	116	Focicchia	42	1	43
94	Corse	2B	2	71	120	Furiani	5273	120	5393
94	Corse	2B	5	11	121	Galéria	328	3	331
94	Corse	2B	3	25	122	Gavignano	46	1	47
94	Corse	2B	3	19	123	Ghisonaccia	3823	74	3897
94	Corse	2B	3	19	124	Ghisoni	226	1	227
94	Corse	2B	3	39	125	Giocatojo	44	0	44
94	Corse	2B	3	54	126	Giuncaggio	64	1	65
94	Corse	2B	5	20	134	L; Île-Rousse	3201	69	3270
94	Corse	2B	3	41	135	Isolaccio-di-Fiumorbo	382	1	383
94	Corse	2B	5	26	136	Lama	170	4	174
94	Corse	2B	3	54	137	Lano	24	1	25
94	Corse	2B	5	05	138	Lavatoggio	134	2	136
94	Corse	2B	3	14	140	Lento	116	0	116
94	Corse	2B	3	24	143	Linguizzetta	1042	7	1049
94	Corse	2B	3	59	145	Loreto-di-Casinca	254	3	257
94	Corse	2B	3	10	147	Lozzi	125	2	127
94	Corse	2B	2	08	148	Lucciana	4416	41	4457
94	Corse	2B	3	19	149	Lugo-di-Nazza	108	1	109
94	Corse	2B	5	12	150	Lumio	1255	29	1284
94	Corse	2B	2	42	152	Luri	680	13	693
94	Corse	2B	5	11	153	Manso	104	3	107
94	Corse	2B	3	24	155	Matra	49	1	50
94	Corse	2B	5	05	156	Mausoléo	16	1	17
94	Corse	2B	3	54	157	Mazzola	24	0	24
94	Corse	2B	2	42	159	Meria	96	3	99
94	Corse	2B	3	24	161	Moïta	82	0	82
94	Corse	2B	3	25	162	Moltifao	745	4	749
94	Corse	2B	3	37	164	Monacia-d;Orezza	32	0	32
94	Corse	2B	5	11	165	Moncale	256	5	261
94	Corse	2B	3	14	166	Monte	596	12	608
94	Corse	2B	5	11	167	Montegrosso	450	11	461
94	Corse	2B	5	20	168	Monticello	1686	61	1747
94	Corse	2B	3	25	169	Morosaglia	1083	7	1090
94	Corse	2B	2	42	170	Morsiglia	148	3	151
94	Corse	2B	3	58	171	Muracciole	49	0	49
94	Corse	2B	5	26	172	Murato	614	10	624
94	Corse	2B	5	05	173	Muro	254	14	268
94	Corse	2B	5	05	175	Nessa	109	2	111
94	Corse	2B	3	37	176	Nocario	59	0	59
94	Corse	2B	3	60	177	Noceta	58	0	58
94	Corse	2B	2	09	178	Nonza	70	2	72
94	Corse	2B	3	37	179	Novale	52	1	53
94	Corse	2B	5	05	180	Novella	91	0	91
94	Corse	2B	5	05	182	Occhiatana	175	2	177
94	Corse	2B	2	09	183	Ogliastro	103	1	104
94	Corse	2B	2	09	184	Olcani	80	0	80
94	Corse	2B	5	29	185	Oletta	1408	20	1428
94	Corse	2B	2	09	187	Olmeta-di-Capocorso	141	2	143
94	Corse	2B	5	29	188	Olmeta-di-Tuda	355	6	361
94	Corse	2B	5	05	190	Olmi-Cappella	188	5	193
94	Corse	2B	3	14	192	Olmo	190	2	192
94	Corse	2B	3	10	193	Omessa	565	7	572
94	Corse	2B	3	37	194	Ortale	25	0	25
94	Corse	2B	3	14	195	Ortiporio	128	1	129
94	Corse	2B	5	05	199	Palasca	138	3	141
94	Corse	2B	3	54	201	Pancheraccia	163	5	168
94	Corse	2B	3	37	202	Parata	32	0	32
94	Corse	2B	5	29	205	Patrimonio	669	16	685
94	Corse	2B	3	14	206	Penta-Acquatella	41	0	41
94	Corse	2B	3	59	207	Penta-di-Casinca	3101	31	3132
94	Corse	2B	3	37	208	Perelli	107	0	107
94	Corse	2B	3	39	210	Pero-Casevecchie	122	3	125
94	Corse	2B	3	24	213	Pianello	72	0	72
94	Corse	2B	3	39	214	Piano	24	0	24
94	Corse	2B	3	37	216	Piazzali	16	1	17
94	Corse	2B	3	37	217	Piazzole	47	1	48
94	Corse	2B	3	37	222	Pie-d;Orezza	37	0	37
94	Corse	2B	3	54	218	Piedicorte-di-Gaggio	116	1	117
94	Corse	2B	3	37	219	Piedicroce	134	2	136
94	Corse	2B	3	10	220	Piedigriggio	141	0	141
94	Corse	2B	3	37	221	Piedipartino	14	1	15
94	Corse	2B	3	24	225	Pietra-di-Verde	116	0	116
94	Corse	2B	2	09	224	Pietracorbara	591	12	603
94	Corse	2B	5	26	223	Pietralba	438	3	441
94	Corse	2B	3	54	226	Pietraserena	75	1	76
94	Corse	2B	3	37	227	Pietricaggio	38	1	39
94	Corse	2B	3	60	229	Pietroso	243	6	249
94	Corse	2B	5	26	230	Piève	119	5	124
94	Corse	2B	5	20	231	Pigna	99	7	106
94	Corse	2B	2	42	233	Pino	166	3	169
94	Corse	2B	3	37	234	Piobetta	23	0	23
94	Corse	2B	5	05	235	Pioggiola	89	0	89
94	Corse	2B	5	29	239	Poggio-d;Oletta	200	10	210
94	Corse	2B	3	19	236	Poggio-di-Nazza	186	3	189
94	Corse	2B	3	58	238	Poggio-di-Venaco	197	5	202
94	Corse	2B	3	39	241	Poggio-Marinaccio	30	0	30
94	Corse	2B	3	39	242	Poggio-Mezzana	650	9	659
94	Corse	2B	3	39	243	Polveroso	40	0	40
94	Corse	2B	3	10	244	Popolasca	50	2	52
94	Corse	2B	3	59	245	Porri	56	0	56
94	Corse	2B	3	39	246	La Porta	221	5	226
94	Corse	2B	3	10	248	Prato-di-Giovellina	48	1	49
94	Corse	2B	3	14	250	Prunelli-di-Casacconi	166	3	169
94	Corse	2B	3	41	251	Prunelli-di-Fiumorbo	3410	53	3463
94	Corse	2B	3	39	252	Pruno	188	5	193
94	Corse	2B	3	39	255	Quercitello	55	2	57
94	Corse	2B	3	37	256	Rapaggio	20	0	20
94	Corse	2B	5	26	257	Rapale	152	4	156
94	Corse	2B	3	58	260	Riventosa	169	7	176
94	Corse	2B	2	42	261	Rogliano	559	10	569
94	Corse	2B	3	60	263	Rospigliani	88	2	90
94	Corse	2B	3	54	264	Rusio	77	1	78
94	Corse	2B	5	26	265	Rutali	347	3	350
94	Corse	2B	5	29	298	Saint-Florent	1635	30	1665
94	Corse	2B	3	25	267	Saliceto	66	0	66
94	Corse	2B	3	39	297	San-Damiano	45	0	45
94	Corse	2B	3	39	299	San-Gavino-d;Ampugnani	85	3	88
94	Corse	2B	3	41	365	San-Gavino-di-Fiumorbo	174	6	180
94	Corse	2B	5	26	301	San-Gavino-di-Tenda	54	0	54
94	Corse	2B	3	16	302	San-Giovanni-di-Moriani	102	1	103
94	Corse	2B	3	16	303	San-Giuliano	616	5	621
94	Corse	2B	3	54	304	San-Lorenzo	145	2	147
94	Corse	2B	2	45	305	San-Martino-di-Lota	2764	49	2813
94	Corse	2B	3	16	313	San-Nicolao	1764	21	1785
94	Corse	2B	3	54	292	Sant;Andréa-di-Bozio	85	2	87
94	Corse	2B	3	16	293	Sant;Andréa-di-Cotone	231	2	233
94	Corse	2B	5	20	296	Sant;Antonino	94	3	97
94	Corse	2B	3	54	306	Santa-Lucia-di-Mercurio	92	1	93
94	Corse	2B	3	16	307	Santa-Lucia-di-Moriani	1138	13	1151
94	Corse	2B	2	45	309	Santa-Maria-di-Lota	1937	70	2007
94	Corse	2B	3	16	311	Santa-Maria-Poggio	623	11	634
94	Corse	2B	5	20	316	Santa-Reparata-di-Balagna	984	20	1004
94	Corse	2B	3	16	317	Santa-Reparata-di-Moriani	42	2	44
94	Corse	2B	5	26	314	Santo-Pietro-di-Tenda	355	6	361
94	Corse	2B	3	58	315	Santo-Pietro-di-Venaco	239	2	241
94	Corse	2B	3	39	273	Scata	44	0	44
94	Corse	2B	3	14	274	Scolca	100	2	102
94	Corse	2B	3	54	275	Sermano	73	2	75
94	Corse	2B	3	41	277	Serra-di-Fiumorbo	318	5	323
94	Corse	2B	3	39	280	Silvareccio	116	0	116
94	Corse	2B	2	09	281	Sisco	988	11	999
94	Corse	2B	3	41	283	Solaro	662	21	683
94	Corse	2B	3	59	286	Sorbo-Ocagnano	772	16	788
94	Corse	2B	5	26	287	Sorio	146	5	151
94	Corse	2B	3	10	289	Soveria	135	0	135
94	Corse	2B	5	05	290	Speloncato	285	10	295
94	Corse	2B	3	37	291	Stazzona	41	5	46
94	Corse	2B	3	39	318	Taglio-Isolaccio	552	4	556
94	Corse	2B	3	39	319	Talasani	657	15	672
94	Corse	2B	3	24	320	Tallone	314	4	318
94	Corse	2B	3	37	321	Tarrano	14	0	14
94	Corse	2B	2	42	327	Tomino	206	6	212
94	Corse	2B	3	24	328	Tox	93	0	93
94	Corse	2B	3	54	329	Tralonca	92	1	93
94	Corse	2B	5	26	332	Urtaca	186	7	193
94	Corse	2B	3	37	334	Valle-d;Alesani	137	1	138
94	Corse	2B	3	37	338	Valle-d;Orezza	44	1	45
94	Corse	2B	3	16	335	Valle-di-Campoloro	331	6	337
94	Corse	2B	3	25	337	Valle-di-Rostino	121	5	126
94	Corse	2B	5	29	333	Vallecalle	111	0	111
94	Corse	2B	5	05	339	Vallica	30	0	30
94	Corse	2B	3	39	340	Velone-Orneto	112	2	114
94	Corse	2B	3	58	341	Venaco	765	12	777
94	Corse	2B	3	41	342	Ventiseri	2273	51	2324
94	Corse	2B	3	59	343	Venzolasca	1666	17	1683
94	Corse	2B	3	37	344	Verdèse	38	0	38
94	Corse	2B	3	59	346	Vescovato	2458	32	2490
94	Corse	2B	3	60	347	Vezzani	321	8	329
94	Corse	2B	2	08	350	Vignale	174	2	176
94	Corse	2B	5	05	352	Ville-di-Paraso	179	1	180
94	Corse	2B	2	45	353	Ville-di-Pietrabugno	3446	102	3548
94	Corse	2B	3	58	354	Vivario	516	2	518
94	Corse	2B	3	14	355	Volpajola	454	3	457
94	Corse	2B	3	24	356	Zalana	154	2	156
94	Corse	2B	5	11	361	Zilia	266	5	271
94	Corse	2B	3	24	364	Zuani	35	0	35
26	Bourgogne	21	1	24	001	Agencourt	397	65	462
26	Bourgogne	21	2	35	002	Agey	270	14	284
26	Bourgogne	21	2	43	003	Ahuy	1265	26	1291
26	Bourgogne	21	3	01	004	Aignay-le-Duc	323	13	336
26	Bourgogne	21	2	14	005	Aiserey	1352	15	1367
26	Bourgogne	21	3	08	006	Aisey-sur-Seine	225	43	268
26	Bourgogne	21	3	27	007	Aisy-sous-Thil	221	49	270
26	Bourgogne	21	3	36	008	Alise-Sainte-Reine	617	20	637
26	Bourgogne	21	1	02	009	Allerey	167	1	168
26	Bourgogne	21	1	05	010	Aloxe-Corton	158	6	164
26	Bourgogne	21	3	08	012	Ampilly-le-Sec	363	7	370
26	Bourgogne	21	3	04	011	Ampilly-les-Bordes	74	4	78
26	Bourgogne	21	2	35	013	Ancey	379	6	385
26	Bourgogne	21	1	07	014	Antheuil	65	1	66
26	Bourgogne	21	1	02	015	Antigny-la-Ville	115	4	119
26	Bourgogne	21	2	10	021	Arc-sur-Tille	2479	59	2538
26	Bourgogne	21	2	20	016	Arceau	708	18	726
26	Bourgogne	21	1	24	017	Arcenant	502	15	517
26	Bourgogne	21	2	35	018	Arcey	48	0	48
26	Bourgogne	21	1	26	020	Arconcey	216	5	221
26	Bourgogne	21	1	24	022	Argilly	465	14	479
26	Bourgogne	21	1	02	023	Arnay-le-Duc	1630	97	1727
26	Bourgogne	21	3	37	024	Arnay-sous-Vitteaux	109	2	111
26	Bourgogne	21	3	21	025	Arrans	66	1	67
26	Bourgogne	21	3	21	026	Asnières-en-Montagne	186	3	189
26	Bourgogne	21	2	43	027	Asnières-lès-Dijon	1208	33	1241
26	Bourgogne	21	2	03	028	Athée	780	10	790
26	Bourgogne	21	3	21	029	Athie	90	1	91
26	Bourgogne	21	1	07	030	Aubaine	95	1	96
26	Bourgogne	21	1	29	031	Aubigny-en-Plaine	366	4	370
26	Bourgogne	21	1	23	032	Aubigny-la-Ronce	164	7	171
26	Bourgogne	21	2	35	033	Aubigny-lès-Sombernon	140	2	142
26	Bourgogne	21	3	22	034	Autricourt	122	3	125
26	Bourgogne	21	1	34	035	Auvillars-sur-Saône	308	7	315
26	Bourgogne	21	1	07	036	Auxant	71	1	72
26	Bourgogne	21	1	05	037	Auxey-Duresses	333	12	345
26	Bourgogne	21	2	03	038	Auxonne	7741	102	7843
26	Bourgogne	21	2	17	039	Avelanges	42	0	42
26	Bourgogne	21	3	37	040	Avosnes	75	2	77
26	Bourgogne	21	2	16	041	Avot	160	4	164
26	Bourgogne	21	1	34	042	Bagnot	129	3	132
26	Bourgogne	21	3	04	043	Baigneux-les-Juifs	258	26	284
26	Bourgogne	21	3	18	044	Balot	89	1	90
26	Bourgogne	21	2	35	045	Barbirey-sur-Ouche	266	9	275
26	Bourgogne	21	1	19	046	Bard-le-Régulier	70	3	73
26	Bourgogne	21	3	33	047	Bard-lès-Époisses	54	4	58
26	Bourgogne	21	2	15	048	Barges	461	7	468
26	Bourgogne	21	2	16	049	Barjon	41	0	41
26	Bourgogne	21	1	23	050	Baubigny	222	12	234
26	Bourgogne	21	2	35	051	Baulme-la-Roche	113	2	115
26	Bourgogne	21	3	01	052	Beaulieu	31	0	31
26	Bourgogne	21	2	20	053	Beaumont-sur-Vingeanne	185	3	188
26	Bourgogne	21	1	98	054	Beaune	22394	741	23135
26	Bourgogne	21	3	01	055	Beaunotte	20	0	20
26	Bourgogne	21	2	20	056	Beire-le-Châtel	792	22	814
26	Bourgogne	21	2	14	057	Beire-le-Fort	296	10	306
26	Bourgogne	21	3	22	058	Belan-sur-Ource	266	10	276
26	Bourgogne	21	2	43	059	Bellefond	774	19	793
26	Bourgogne	21	2	20	060	Belleneuve	1556	20	1576
26	Bourgogne	21	3	01	061	Bellenod-sur-Seine	78	3	81
26	Bourgogne	21	1	26	062	Bellenot-sous-Pouilly	228	6	234
26	Bourgogne	21	3	28	063	Beneuvre	95	3	98
26	Bourgogne	21	3	21	064	Benoisey	77	3	80
26	Bourgogne	21	1	07	065	Bessey-en-Chaume	110	2	112
26	Bourgogne	21	1	07	066	Bessey-la-Cour	72	0	72
26	Bourgogne	21	2	14	067	Bessey-lès-Cîteaux	666	14	680
26	Bourgogne	21	1	26	068	Beurey-Bauguay	140	3	143
26	Bourgogne	21	3	37	069	Beurizot	117	3	120
26	Bourgogne	21	2	15	070	Bévy	95	2	97
26	Bourgogne	21	2	20	071	Bèze	724	18	742
26	Bourgogne	21	2	20	072	Bézouotte	201	2	203
26	Bourgogne	21	3	27	073	Bierre-lès-Semur	88	6	94
26	Bourgogne	21	2	03	074	Billey	226	6	232
26	Bourgogne	21	3	04	075	Billy-lès-Chanceaux	80	1	81
26	Bourgogne	21	2	25	076	Binges	628	9	637
26	Bourgogne	21	3	22	077	Bissey-la-Côte	91	2	93
26	Bourgogne	21	3	18	078	Bissey-la-Pierre	76	5	81
26	Bourgogne	21	2	20	079	Blagny-sur-Vingeanne	138	0	138
26	Bourgogne	21	2	35	080	Blaisy-Bas	699	10	709
26	Bourgogne	21	2	35	081	Blaisy-Haut	120	1	121
26	Bourgogne	21	1	26	082	Blancey	70	3	73
26	Bourgogne	21	1	19	083	Blanot	131	7	138
26	Bourgogne	21	2	30	085	Bligny-le-Sec	161	3	164
26	Bourgogne	21	1	06	086	Bligny-lès-Beaune	1224	39	1263
26	Bourgogne	21	1	07	087	Bligny-sur-Ouche	850	15	865
26	Bourgogne	21	1	24	088	Boncourt-le-Bois	278	7	285
26	Bourgogne	21	1	34	089	Bonnencontre	431	5	436
26	Bourgogne	21	3	22	090	Boudreville	60	1	61
26	Bourgogne	21	1	26	091	Bouhey	40	0	40
26	Bourgogne	21	1	05	092	Bouilland	189	6	195
26	Bourgogne	21	3	18	093	Bouix	159	1	160
26	Bourgogne	21	2	13	094	Bourberain	343	5	348
26	Bourgogne	21	1	34	095	Bousselange	49	2	51
26	Bourgogne	21	2	32	096	Boussenois	105	0	105
26	Bourgogne	21	3	37	097	Boussey	30	1	31
26	Bourgogne	21	3	36	098	Boux-sous-Salmaise	142	4	146
26	Bourgogne	21	1	05	099	Bouze-lès-Beaune	333	5	338
26	Bourgogne	21	3	37	100	Brain	28	0	28
26	Bourgogne	21	3	27	101	Braux	175	3	178
26	Bourgogne	21	1	19	102	Brazey-en-Morvan	161	9	170
26	Bourgogne	21	1	29	103	Brazey-en-Plaine	2505	58	2563
26	Bourgogne	21	3	08	104	Brémur-et-Vaurois	63	5	68
26	Bourgogne	21	2	10	105	Bressey-sur-Tille	679	6	685
26	Bourgogne	21	2	14	106	Bretenière	736	16	752
26	Bourgogne	21	2	09	107	Bretigny	924	20	944
26	Bourgogne	21	3	27	108	Brianny	108	4	112
26	Bourgogne	21	3	22	109	Brion-sur-Ource	229	9	238
26	Bourgogne	21	2	15	110	Brochon	644	119	763
26	Bourgogne	21	2	09	111	Brognon	263	5	268
26	Bourgogne	21	1	34	112	Broin	433	6	439
26	Bourgogne	21	2	15	113	Broindon	122	2	124
26	Bourgogne	21	3	21	114	Buffon	160	6	166
26	Bourgogne	21	3	08	115	Buncey	386	6	392
26	Bourgogne	21	3	28	116	Bure-les-Templiers	133	2	135
26	Bourgogne	21	3	01	117	Busseaut	66	4	70
26	Bourgogne	21	2	16	118	Busserotte-et-Montenaille	33	2	35
26	Bourgogne	21	1	07	120	La Bussière-sur-Ouche	147	1	148
26	Bourgogne	21	2	16	119	Bussières	41	1	42
26	Bourgogne	21	2	35	121	Bussy-la-Pesle	65	1	66
26	Bourgogne	21	3	36	122	Bussy-le-Grand	317	7	324
26	Bourgogne	21	3	28	123	Buxerolles	23	2	25
26	Bourgogne	21	1	19	124	Censerey	178	2	180
26	Bourgogne	21	3	18	125	Cérilly	269	6	275
26	Bourgogne	21	2	14	126	Cessey-sur-Tille	594	10	604
26	Bourgogne	21	2	17	127	Chaignay	524	10	534
26	Bourgogne	21	1	26	128	Chailly-sur-Armançon	264	4	268
26	Bourgogne	21	3	28	129	Chambain	28	1	29
26	Bourgogne	21	2	14	130	Chambeire	313	5	318
26	Bourgogne	21	1	34	131	Chamblanc	516	63	579
26	Bourgogne	21	2	15	132	Chamboeuf	331	10	341
26	Bourgogne	21	2	15	133	Chambolle-Musigny	313	12	325
26	Bourgogne	21	3	08	134	Chamesson	280	8	288
26	Bourgogne	21	3	21	137	Champ-d;Oiseau	76	5	81
26	Bourgogne	21	2	20	135	Champagne-sur-Vingeanne	292	3	295
26	Bourgogne	21	2	30	136	Champagny	37	1	38
26	Bourgogne	21	2	03	138	Champdôtre	565	11	576
26	Bourgogne	21	3	31	139	Champeau-en-Morvan	247	9	256
26	Bourgogne	21	1	02	140	Champignolles	70	1	71
26	Bourgogne	21	3	37	141	Champrenault	29	1	30
26	Bourgogne	21	2	30	142	Chanceaux	202	3	205
26	Bourgogne	21	3	18	143	Channay	63	3	66
26	Bourgogne	21	3	36	144	Charencey	29	1	30
26	Bourgogne	21	3	33	145	Charigny	42	0	42
26	Bourgogne	21	2	20	146	Charmes	124	4	128
26	Bourgogne	21	3	37	147	Charny	33	0	33
26	Bourgogne	21	1	29	148	Charrey-sur-Saône	338	7	345
26	Bourgogne	21	3	08	149	Charrey-sur-Seine	166	5	171
26	Bourgogne	21	1	23	150	Chassagne-Montrachet	353	6	359
26	Bourgogne	21	3	33	151	Chassey	86	1	87
26	Bourgogne	21	1	26	152	Châteauneuf	84	3	87
26	Bourgogne	21	1	26	153	Châtellenot	144	5	149
26	Bourgogne	21	3	08	154	Châtillon-sur-Seine	5564	466	6030
26	Bourgogne	21	1	07	155	Chaudenay-la-Ville	38	0	38
26	Bourgogne	21	1	07	156	Chaudenay-le-Château	47	0	47
26	Bourgogne	21	3	28	157	Chaugey	22	1	23
26	Bourgogne	21	3	22	159	La Chaume	116	1	117
26	Bourgogne	21	2	13	158	Chaume-et-Courchamp	155	2	157
26	Bourgogne	21	3	04	160	Chaume-lès-Baigneux	97	2	99
26	Bourgogne	21	3	08	161	Chaumont-le-Bois	85	2	87
26	Bourgogne	21	1	24	162	Chaux	448	16	464
26	Bourgogne	21	2	32	163	Chazeuil	221	5	226
26	Bourgogne	21	1	26	164	Chazilly	133	6	139
26	Bourgogne	21	3	08	165	Chemin-d;Aisey	64	1	65
26	Bourgogne	21	2	97	166	Chenôve	14045	188	14233
26	Bourgogne	21	2	20	167	Cheuge	113	3	116
26	Bourgogne	21	3	37	168	Chevannay	52	1	53
26	Bourgogne	21	2	15	169	Chevannes	133	5	138
26	Bourgogne	21	1	06	170	Chevigny-en-Valière	293	6	299
26	Bourgogne	21	2	10	171	Chevigny-Saint-Sauveur	9969	163	10132
26	Bourgogne	21	1	34	172	Chivres	255	11	266
26	Bourgogne	21	1	06	173	Chorey-les-Beaune	565	13	578
26	Bourgogne	21	2	25	175	Cirey-lès-Pontailler	137	1	138
26	Bourgogne	21	1	26	176	Civry-en-Montagne	99	2	101
26	Bourgogne	21	3	27	177	Clamerey	179	4	183
26	Bourgogne	21	2	15	178	Clémencey	120	3	123
26	Bourgogne	21	2	09	179	Clénay	845	6	851
26	Bourgogne	21	2	25	180	Cléry	122	5	127
26	Bourgogne	21	1	02	181	Clomot	113	4	117
26	Bourgogne	21	2	15	182	Collonges-lès-Bévy	94	1	95
26	Bourgogne	21	2	14	183	Collonges-lès-Premières	769	7	776
26	Bourgogne	21	1	07	184	Colombier	51	1	52
26	Bourgogne	21	1	06	185	Combertault	528	12	540
26	Bourgogne	21	1	24	186	Comblanchien	699	7	706
26	Bourgogne	21	1	26	187	Commarin	124	4	128
26	Bourgogne	21	1	34	189	Corberon	421	11	432
26	Bourgogne	21	1	06	190	Corcelles-les-Arts	463	19	482
26	Bourgogne	21	2	15	191	Corcelles-lès-Cîteaux	823	13	836
26	Bourgogne	21	2	39	192	Corcelles-les-Monts	652	12	664
26	Bourgogne	21	1	34	193	Corgengoux	372	11	383
26	Bourgogne	21	1	24	194	Corgoloin	921	28	949
26	Bourgogne	21	1	23	195	Cormot-le-Grand	146	7	153
26	Bourgogne	21	1	23	196	Corpeau	1029	21	1050
26	Bourgogne	21	3	36	197	Corpoyer-la-Chapelle	20	0	20
26	Bourgogne	21	3	33	198	Corrombles	239	4	243
26	Bourgogne	21	3	33	199	Corsaint	141	3	144
26	Bourgogne	21	2	15	200	Couchey	1192	28	1220
26	Bourgogne	21	3	08	201	Coulmier-le-Sec	271	8	279
26	Bourgogne	21	3	22	202	Courban	167	3	170
26	Bourgogne	21	3	33	203	Courcelles-Frémoy	127	4	131
26	Bourgogne	21	3	21	204	Courcelles-lès-Montbard	87	4	91
26	Bourgogne	21	3	33	205	Courcelles-lès-Semur	238	8	246
26	Bourgogne	21	2	16	207	Courlon	72	4	76
26	Bourgogne	21	2	17	208	Courtivron	196	2	198
26	Bourgogne	21	2	10	209	Couternon	1662	21	1683
26	Bourgogne	21	1	26	210	Créancey	524	4	528
26	Bourgogne	21	2	17	211	Crécey-sur-Tille	144	3	147
26	Bourgogne	21	3	21	212	Crépand	339	15	354
26	Bourgogne	21	2	10	213	Crimolois	642	11	653
26	Bourgogne	21	1	07	214	Crugey	169	1	170
26	Bourgogne	21	2	20	215	Cuiserey	154	3	157
26	Bourgogne	21	1	02	216	Culètre	81	1	82
26	Bourgogne	21	2	15	217	Curley	144	4	148
26	Bourgogne	21	2	30	218	Curtil-Saint-Seine	101	6	107
26	Bourgogne	21	2	15	219	Curtil-Vergy	116	5	121
26	Bourgogne	21	2	16	220	Cussey-les-Forges	137	2	139
26	Bourgogne	21	1	07	221	Cussy-la-Colonne	54	3	57
26	Bourgogne	21	1	02	222	Cussy-le-Châtel	121	3	124
26	Bourgogne	21	2	43	223	Daix	1362	40	1402
26	Bourgogne	21	3	37	224	Dampierre-en-Montagne	77	0	77
26	Bourgogne	21	2	13	225	Dampierre-et-Flée	122	2	124
26	Bourgogne	21	3	36	226	Darcey	347	8	355
26	Bourgogne	21	2	43	227	Darois	443	6	449
26	Bourgogne	21	2	15	228	Détain-et-Bruant	150	1	151
26	Bourgogne	21	1	19	229	Diancey	83	2	85
26	Bourgogne	21	2	17	230	Diénay	296	10	306
26	Bourgogne	21	2	99	231	Dijon	151212	4021	155233
26	Bourgogne	21	3	27	232	Dompierre-en-Morvan	226	10	236
26	Bourgogne	21	2	25	233	Drambon	165	5	170
26	Bourgogne	21	2	35	234	Drée	54	0	54
26	Bourgogne	21	3	01	235	Duesme	54	2	56
26	Bourgogne	21	1	06	236	Ébaty	223	5	228
26	Bourgogne	21	3	01	237	Échalot	110	0	110
26	Bourgogne	21	2	35	238	Échannay	121	3	124
26	Bourgogne	21	1	29	239	Échenon	712	6	718
26	Bourgogne	21	2	17	240	Échevannes	225	8	233
26	Bourgogne	21	1	05	241	Échevronne	282	13	295
26	Bourgogne	21	2	14	242	Échigey	292	9	301
26	Bourgogne	21	1	07	243	Écutigny	103	5	108
26	Bourgogne	21	1	26	244	Éguilly	61	0	61
26	Bourgogne	21	2	17	245	Épagny	302	7	309
26	Bourgogne	21	2	15	246	Épernay-sous-Gevrey	183	2	185
26	Bourgogne	21	3	33	247	Époisses	783	20	803
26	Bourgogne	21	3	21	248	Éringes	64	4	68
26	Bourgogne	21	1	29	249	Esbarres	758	16	774
26	Bourgogne	21	3	28	250	Essarois	87	1	88
26	Bourgogne	21	1	26	251	Essey	247	44	291
26	Bourgogne	21	3	18	252	Étais	92	3	95
26	Bourgogne	21	3	01	253	Étalante	127	7	134
26	Bourgogne	21	2	15	254	L; Étang-Vergy	201	4	205
26	Bourgogne	21	2	43	255	Étaules	236	11	247
26	Bourgogne	21	2	25	256	Étevaux	294	4	298
26	Bourgogne	21	3	04	257	Étormay	79	2	81
26	Bourgogne	21	3	08	258	Étrochey	229	9	238
26	Bourgogne	21	3	21	259	Fain-lès-Montbard	301	7	308
26	Bourgogne	21	3	21	260	Fain-lès-Moutiers	155	5	160
26	Bourgogne	21	2	14	261	Fauverney	684	14	698
26	Bourgogne	21	3	28	262	Faverolles-lès-Lucey	35	1	36
26	Bourgogne	21	2	15	263	Fénay	1465	58	1523
26	Bourgogne	21	1	02	264	Le Fête	49	4	53
26	Bourgogne	21	2	15	265	Fixin	757	19	776
26	Bourgogne	21	2	17	266	Flacey	158	7	165
26	Bourgogne	21	1	24	267	Flagey-Echézeaux	499	5	504
26	Bourgogne	21	2	03	268	Flagey-lès-Auxonne	191	10	201
26	Bourgogne	21	2	03	269	Flammerans	422	11	433
26	Bourgogne	21	2	39	270	Flavignerot	165	9	174
26	Bourgogne	21	3	36	271	Flavigny-sur-Ozerain	305	13	318
26	Bourgogne	21	3	33	272	Flée	163	7	170
26	Bourgogne	21	2	39	273	Fleurey-sur-Ouche	1161	48	1209
26	Bourgogne	21	1	02	274	Foissy	153	3	156
26	Bourgogne	21	2	32	275	Foncegrive	150	1	151
26	Bourgogne	21	2	13	277	Fontaine-Française	933	28	961
26	Bourgogne	21	2	43	278	Fontaine-lès-Dijon	9114	270	9384
26	Bourgogne	21	3	04	276	Fontaines-en-Duesmois	128	2	130
26	Bourgogne	21	3	18	279	Fontaines-les-Sèches	37	1	38
26	Bourgogne	21	3	27	280	Fontangy	149	3	152
26	Bourgogne	21	2	13	281	Fontenelle	139	9	148
26	Bourgogne	21	3	33	282	Forléans	96	2	98
26	Bourgogne	21	2	16	283	Fraignot-et-Vesvrotte	68	7	75
26	Bourgogne	21	2	30	284	Francheville	245	10	255
26	Bourgogne	21	1	29	285	Franxault	409	11	420
26	Bourgogne	21	2	30	286	Frénois	90	1	91
26	Bourgogne	21	3	21	287	Fresnes	174	3	177
26	Bourgogne	21	3	36	288	Frôlois	181	8	189
26	Bourgogne	21	1	24	289	Fussey	112	7	119
26	Bourgogne	21	2	17	290	Gemeaux	864	15	879
26	Bourgogne	21	3	33	291	Genay	335	3	338
26	Bourgogne	21	2	14	292	Genlis	5613	92	5705
26	Bourgogne	21	2	35	293	Gergueil	139	1	140
26	Bourgogne	21	1	24	294	Gerland	411	10	421
26	Bourgogne	21	2	15	295	Gevrey-Chambertin	3061	56	3117
26	Bourgogne	21	3	22	296	Gevrolles	167	6	173
26	Bourgogne	21	1	24	297	Gilly-lès-Cîteaux	634	14	648
26	Bourgogne	21	3	37	298	Gissey-le-Vieil	105	3	108
26	Bourgogne	21	3	36	299	Gissey-sous-Flavigny	100	0	100
26	Bourgogne	21	2	35	300	Gissey-sur-Ouche	364	5	369
26	Bourgogne	21	1	34	301	Glanon	227	2	229
26	Bourgogne	21	3	08	302	Gomméville	151	7	158
26	Bourgogne	21	3	22	303	Les Goulles	16	1	17
26	Bourgogne	21	2	16	304	Grancey-le-Château-Neuvelle	272	7	279
26	Bourgogne	21	3	22	305	Grancey-sur-Ource	207	1	208
26	Bourgogne	21	2	35	306	Grenant-lès-Sombernon	199	3	202
26	Bourgogne	21	3	36	307	Grésigny-Sainte-Reine	136	10	146
26	Bourgogne	21	3	36	308	Grignon	225	4	229
26	Bourgogne	21	3	18	309	Griselles	90	0	90
26	Bourgogne	21	2	35	310	Grosbois-en-Montagne	115	5	120
26	Bourgogne	21	1	34	311	Grosbois-lès-Tichey	75	0	75
26	Bourgogne	21	3	28	312	Gurgy-la-Ville	39	0	39
26	Bourgogne	21	3	28	313	Gurgy-le-Château	50	1	51
26	Bourgogne	21	3	36	314	Hauteroche	73	2	75
26	Bourgogne	21	2	43	315	Hauteville-lès-Dijon	1098	29	1127
26	Bourgogne	21	2	25	316	Heuilley-sur-Saône	301	10	311
26	Bourgogne	21	2	17	317	Is-sur-Tille	4183	66	4249
26	Bourgogne	21	1	23	318	Ivry-en-Montagne	182	5	187
26	Bourgogne	21	2	14	319	Izeure	778	10	788
26	Bourgogne	21	2	14	320	Izier	771	14	785
26	Bourgogne	21	3	36	321	Jailly-les-Moulins	92	3	95
26	Bourgogne	21	1	34	322	Jallanges	335	3	338
26	Bourgogne	21	2	20	323	Jancigny	130	0	130
26	Bourgogne	21	3	33	324	Jeux-lès-Bard	51	2	53
26	Bourgogne	21	1	02	325	Jouey	202	4	206
26	Bourgogne	21	1	23	327	Jours-en-Vaux	100	3	103
26	Bourgogne	21	3	04	326	Jours-lès-Baigneux	87	5	92
26	Bourgogne	21	3	31	328	Juillenay	54	0	54
26	Bourgogne	21	3	33	329	Juilly	39	5	44
26	Bourgogne	21	2	14	330	Labergement-Foigney	407	9	416
26	Bourgogne	21	2	03	331	Labergement-lès-Auxonne	352	7	359
26	Bourgogne	21	1	34	332	Labergement-lès-Seurre	974	11	985
26	Bourgogne	21	1	34	333	Labruyère	214	0	214
26	Bourgogne	21	1	02	334	Lacanche	594	9	603
26	Bourgogne	21	3	27	335	Lacour-d;Arcenay	128	3	131
26	Bourgogne	21	1	06	606	Ladoix-Serrigny	1805	38	1843
26	Bourgogne	21	3	18	336	Laignes	777	18	795
26	Bourgogne	21	2	25	337	Lamarche-sur-Saône	1253	28	1281
26	Bourgogne	21	2	30	338	Lamargelle	158	5	163
26	Bourgogne	21	2	39	339	Lantenay	500	19	519
26	Bourgogne	21	1	34	340	Lanthes	253	5	258
26	Bourgogne	21	3	33	341	Lantilly	104	1	105
26	Bourgogne	21	1	29	342	Laperrière-sur-Saône	420	4	424
26	Bourgogne	21	3	18	343	Larrey	98	3	101
26	Bourgogne	21	1	34	344	Lechâtelet	206	1	207
26	Bourgogne	21	2	30	345	Léry	220	2	222
26	Bourgogne	21	3	28	346	Leuglay	337	10	347
26	Bourgogne	21	1	06	347	Levernois	284	9	293
26	Bourgogne	21	2	13	348	Licey-sur-Vingeanne	110	2	112
26	Bourgogne	21	1	19	349	Liernais	591	23	614
26	Bourgogne	21	3	22	350	Lignerolles	49	1	50
26	Bourgogne	21	2	14	351	Longchamp	1186	87	1273
26	Bourgogne	21	2	14	352	Longeault	587	12	599
26	Bourgogne	21	2	14	353	Longecourt-en-Plaine	1241	30	1271
26	Bourgogne	21	1	02	354	Longecourt-lès-Culêtre	47	2	49
26	Bourgogne	21	2	38	355	Longvic	9290	177	9467
26	Bourgogne	21	1	29	356	Losne	1597	33	1630
26	Bourgogne	21	3	22	357	Louesme	113	1	114
26	Bourgogne	21	3	21	358	Lucenay-le-Duc	206	6	212
26	Bourgogne	21	3	28	359	Lucey	59	1	60
26	Bourgogne	21	1	07	360	Lusigny-sur-Ouche	107	3	110
26	Bourgogne	21	2	17	361	Lux	519	8	527
26	Bourgogne	21	1	26	362	Maconge	149	1	150
26	Bourgogne	21	1	02	363	Magnien	334	5	339
26	Bourgogne	21	3	33	365	Magny-la-Ville	82	1	83
26	Bourgogne	21	3	04	364	Magny-Lambert	97	3	100
26	Bourgogne	21	1	29	366	Magny-lès-Aubigny	196	1	197
26	Bourgogne	21	1	24	368	Magny-lès-Villers	258	9	267
26	Bourgogne	21	2	03	367	Magny-Montarlot	234	5	239
26	Bourgogne	21	2	20	369	Magny-Saint-Médard	256	2	258
26	Bourgogne	21	2	14	370	Magny-sur-Tille	833	21	854
26	Bourgogne	21	2	03	371	Les Maillys	830	29	859
26	Bourgogne	21	3	08	372	Maisey-le-Duc	104	5	109
26	Bourgogne	21	2	35	373	Mâlain	721	13	734
26	Bourgogne	21	1	02	374	Maligny	215	4	219
26	Bourgogne	21	1	19	375	Manlay	211	8	219
26	Bourgogne	21	2	25	376	Marandeuil	117	0	117
26	Bourgogne	21	3	37	377	Marcellois	37	1	38
26	Bourgogne	21	3	18	378	Marcenay	113	2	115
26	Bourgogne	21	1	19	379	Marcheseuil	173	2	175
26	Bourgogne	21	3	27	380	Marcigny-sous-Thil	61	0	61
26	Bourgogne	21	3	37	381	Marcilly-et-Dracy	95	3	98
26	Bourgogne	21	1	26	382	Marcilly-Ogny	198	8	206
26	Bourgogne	21	2	17	383	Marcilly-sur-Tille	1596	17	1613
26	Bourgogne	21	1	24	384	Marey-lès-Fussey	64	3	67
26	Bourgogne	21	2	17	385	Marey-sur-Tille	327	8	335
26	Bourgogne	21	3	36	386	Marigny-le-Cahouët	277	10	287
26	Bourgogne	21	1	06	387	Marigny-lès-Reullée	191	6	197
26	Bourgogne	21	2	14	388	Marliens	449	10	459
26	Bourgogne	21	3	21	389	Marmagne	237	12	249
26	Bourgogne	21	2	38	390	Marsannay-la-Côte	5108	113	5221
26	Bourgogne	21	2	17	391	Marsannay-le-Bois	774	15	789
26	Bourgogne	21	1	26	392	Martrois	62	1	63
26	Bourgogne	21	3	08	393	Massingy	160	7	167
26	Bourgogne	21	3	33	394	Massingy-lès-Semur	193	3	196
26	Bourgogne	21	3	37	395	Massingy-lès-Vitteaux	88	6	94
26	Bourgogne	21	3	01	396	Mauvilly	73	3	76
26	Bourgogne	21	1	05	397	Mavilly-Mandelot	163	7	170
26	Bourgogne	21	2	25	398	Maxilly-sur-Saône	340	5	345
26	Bourgogne	21	1	26	399	Meilly-sur-Rouvres	184	4	188
26	Bourgogne	21	2	16	400	Le Meix	45	0	45
26	Bourgogne	21	1	05	401	Meloisey	328	8	336
26	Bourgogne	21	3	28	402	Menesble	11	0	11
26	Bourgogne	21	1	19	403	Ménessaire	71	0	71
26	Bourgogne	21	3	36	404	Ménétreux-le-Pitois	445	19	464
26	Bourgogne	21	1	06	405	Merceuil	839	17	856
26	Bourgogne	21	2	35	406	Mesmont	211	4	215
26	Bourgogne	21	2	15	407	Messanges	240	7	247
26	Bourgogne	21	2	43	408	Messigny-et-Vantoux	1574	45	1619
26	Bourgogne	21	1	24	409	Meuilley	458	14	472
26	Bourgogne	21	3	01	410	Meulson	38	2	40
26	Bourgogne	21	1	06	411	Meursanges	485	6	491
26	Bourgogne	21	1	05	412	Meursault	1529	52	1581
26	Bourgogne	21	3	33	413	Millery	377	13	390
26	Bourgogne	21	1	02	414	Mimeure	292	6	298
26	Bourgogne	21	3	01	415	Minot	221	16	237
26	Bourgogne	21	2	20	416	Mirebeau-sur-Bèze	1977	29	2006
26	Bourgogne	21	3	27	417	Missery	107	2	109
26	Bourgogne	21	3	01	418	Moitron	62	4	66
26	Bourgogne	21	3	18	419	Molesme	242	1	243
26	Bourgogne	21	1	23	420	Molinot	152	3	155
26	Bourgogne	21	2	17	421	Moloy	220	8	228
26	Bourgogne	21	3	31	422	Molphey	148	7	155
26	Bourgogne	21	1	26	441	Mont-Saint-Jean	248	5	253
26	Bourgogne	21	1	06	423	Montagny-lès-Beaune	662	20	682
26	Bourgogne	21	1	29	424	Montagny-lès-Seurre	109	4	113
26	Bourgogne	21	3	21	425	Montbard	5513	192	5705
26	Bourgogne	21	3	33	426	Montberthault	261	6	267
26	Bourgogne	21	1	07	427	Montceau-et-Écharnant	157	6	163
26	Bourgogne	21	1	05	428	Monthelie	164	5	169
26	Bourgogne	21	3	21	429	Montigny-Montfort	290	7	297
26	Bourgogne	21	2	13	433	Montigny-Mornay-Villeneuve-sur-Vingeanne	373	9	382
26	Bourgogne	21	3	27	430	Montigny-Saint-Barthélemy	87	2	89
26	Bourgogne	21	3	33	431	Montigny-sur-Armançon	141	7	148
26	Bourgogne	21	3	22	432	Montigny-sur-Aube	311	8	319
26	Bourgogne	21	3	31	434	Montlay-en-Auxois	156	3	159
26	Bourgogne	21	3	08	435	Montliot-et-Courcelles	285	7	292
26	Bourgogne	21	1	34	436	Montmain	117	0	117
26	Bourgogne	21	2	25	437	Montmançon	227	8	235
26	Bourgogne	21	3	28	438	Montmoyen	89	1	90
26	Bourgogne	21	2	35	439	Montoillot	72	2	74
26	Bourgogne	21	1	29	440	Montot	196	8	204
26	Bourgogne	21	2	15	442	Morey-Saint-Denis	697	18	715
26	Bourgogne	21	3	08	444	Mosson	93	3	96
26	Bourgogne	21	3	31	445	La Motte-Ternant	168	2	170
26	Bourgogne	21	3	21	446	Moutiers-Saint-Jean	256	4	260
26	Bourgogne	21	1	02	447	Musigny	89	1	90
26	Bourgogne	21	3	36	448	Mussy-la-Fosse	76	2	78
26	Bourgogne	21	3	27	449	Nan-sous-Thil	191	2	193
26	Bourgogne	21	1	05	450	Nantoux	180	7	187
26	Bourgogne	21	3	18	451	Nesle-et-Massoult	82	4	86
26	Bourgogne	21	2	38	452	Neuilly-lès-Dijon	1869	29	1898
26	Bourgogne	21	3	18	454	Nicey	130	4	134
26	Bourgogne	21	3	08	455	Nod-sur-Seine	248	6	254
26	Bourgogne	21	3	21	456	Nogent-lès-Montbard	144	6	150
26	Bourgogne	21	3	27	457	Noidan	87	2	89
26	Bourgogne	21	2	15	458	Noiron-sous-Gevrey	1056	23	1079
26	Bourgogne	21	2	20	459	Noiron-sur-Bèze	210	4	214
26	Bourgogne	21	3	08	460	Noiron-sur-Seine	81	0	81
26	Bourgogne	21	1	23	461	Nolay	1496	25	1521
26	Bourgogne	21	2	43	462	Norges-la-Ville	869	24	893
26	Bourgogne	21	3	27	463	Normier	49	8	57
26	Bourgogne	21	1	24	464	Nuits-Saint-Georges	5600	113	5713
26	Bourgogne	21	3	08	465	Obtrée	74	0	74
26	Bourgogne	21	3	04	466	Oigny	35	2	37
26	Bourgogne	21	2	20	467	Oisilly	141	0	141
26	Bourgogne	21	2	13	468	Orain	96	2	98
26	Bourgogne	21	2	09	469	Orgeux	472	10	482
26	Bourgogne	21	3	01	470	Origny	36	0	36
26	Bourgogne	21	3	04	471	Orret	24	0	24
26	Bourgogne	21	2	32	472	Orville	188	5	193
26	Bourgogne	21	2	38	473	Ouges	1166	22	1188
26	Bourgogne	21	1	34	474	Pagny-la-Ville	421	6	427
26	Bourgogne	21	1	34	475	Pagny-le-Château	498	6	504
26	Bourgogne	21	1	07	476	Painblanc	159	6	165
26	Bourgogne	21	2	30	477	Panges	80	3	83
26	Bourgogne	21	2	39	478	Pasques	295	8	303
26	Bourgogne	21	2	30	479	Pellerey	86	2	88
26	Bourgogne	21	1	05	480	Pernand-Vergelesses	279	16	295
26	Bourgogne	21	2	38	481	Perrigny-lès-Dijon	1478	27	1505
26	Bourgogne	21	2	25	482	Perrigny-sur-l;Ognon	663	4	667
26	Bourgogne	21	2	17	483	Pichanges	256	5	261
26	Bourgogne	21	3	18	484	Planay	81	0	81
26	Bourgogne	21	2	43	485	Plombières-lès-Dijon	2812	143	2955
26	Bourgogne	21	2	14	486	Pluvault	517	13	530
26	Bourgogne	21	2	14	487	Pluvet	419	4	423
26	Bourgogne	21	3	18	488	Poinçon-lès-Larrey	206	3	209
26	Bourgogne	21	2	30	489	Poiseul-la-Grange	69	0	69
26	Bourgogne	21	3	04	490	Poiseul-la-Ville-et-Laperrière	165	6	171
26	Bourgogne	21	2	17	491	Poiseul-lès-Saulx	63	0	63
26	Bourgogne	21	1	05	492	Pommard	525	14	539
26	Bourgogne	21	2	03	493	Poncey-lès-Athée	570	11	581
26	Bourgogne	21	2	30	494	Poncey-sur-l;Ignon	86	0	86
26	Bourgogne	21	2	03	495	Pont	93	1	94
26	Bourgogne	21	3	33	497	Pont-et-Massène	201	8	209
26	Bourgogne	21	2	25	496	Pontailler-sur-Saône	1251	30	1281
26	Bourgogne	21	3	37	498	Posanges	68	2	70
26	Bourgogne	21	3	08	499	Pothières	194	2	196
26	Bourgogne	21	3	36	500	Pouillenay	568	12	580
26	Bourgogne	21	1	26	501	Pouilly-en-Auxois	1555	145	1700
26	Bourgogne	21	1	34	502	Pouilly-sur-Saône	667	8	675
26	Bourgogne	21	2	13	503	Pouilly-sur-Vingeanne	117	2	119
26	Bourgogne	21	2	35	504	Prâlon	76	2	78
26	Bourgogne	21	3	27	505	Précy-sous-Thil	766	25	791
26	Bourgogne	21	1	24	506	Premeaux-Prissey	468	7	475
26	Bourgogne	21	2	14	507	Premières	120	1	121
26	Bourgogne	21	2	39	508	Prenois	416	10	426
26	Bourgogne	21	3	08	510	Prusly-sur-Ource	177	2	179
26	Bourgogne	21	3	18	511	Puits	139	7	146
26	Bourgogne	21	1	23	512	Puligny-Montrachet	411	10	421
26	Bourgogne	21	2	15	513	Quemigny-Poisot	197	10	207
26	Bourgogne	21	3	01	514	Quemigny-sur-Seine	115	3	118
26	Bourgogne	21	2	10	515	Quetigny	9752	427	10179
26	Bourgogne	21	3	21	516	Quincerot	104	2	106
26	Bourgogne	21	1	24	517	Quincey	426	10	436
26	Bourgogne	21	3	21	518	Quincy-le-Vicomte	194	11	205
26	Bourgogne	21	3	28	519	Recey-sur-Ource	383	13	396
26	Bourgogne	21	2	35	520	Remilly-en-Montagne	129	4	133
26	Bourgogne	21	2	10	521	Remilly-sur-Tille	744	15	759
26	Bourgogne	21	2	20	522	Renève	430	8	438
26	Bourgogne	21	2	15	523	Reulle-Vergy	120	5	125
26	Bourgogne	21	3	22	524	Riel-les-Eaux	84	1	85
26	Bourgogne	21	3	31	525	La Roche-en-Brenil	898	18	916
26	Bourgogne	21	3	36	528	La Roche-Vanneau	150	7	157
26	Bourgogne	21	3	01	526	Rochefort-sur-Brévon	45	2	47
26	Bourgogne	21	1	23	527	La Rochepot	280	6	286
26	Bourgogne	21	3	27	529	Roilly	38	0	38
26	Bourgogne	21	3	21	530	Rougemont	178	5	183
26	Bourgogne	21	3	31	531	Rouvray	605	12	617
26	Bourgogne	21	2	14	532	Rouvres-en-Plaine	1013	11	1024
26	Bourgogne	21	1	26	533	Rouvres-sous-Meilly	97	6	103
26	Bourgogne	21	1	06	534	Ruffey-lès-Beaune	678	83	761
26	Bourgogne	21	2	09	535	Ruffey-lès-Echirey	1193	33	1226
26	Bourgogne	21	2	32	536	Sacquenay	262	4	266
26	Bourgogne	21	3	37	537	Saffres	122	6	128
26	Bourgogne	21	3	31	538	Saint-Andeux	128	5	133
26	Bourgogne	21	2	35	539	Saint-Anthot	57	0	57
26	Bourgogne	21	2	09	540	Saint-Apollinaire	6276	114	6390
26	Bourgogne	21	1	23	541	Saint-Aubin	257	12	269
26	Bourgogne	21	1	24	542	Saint-Bernard	455	6	461
26	Bourgogne	21	3	28	543	Saint-Broing-les-Moines	188	8	196
26	Bourgogne	21	3	31	546	Saint-Didier	214	2	216
26	Bourgogne	21	3	33	547	Saint-Euphrône	198	6	204
26	Bourgogne	21	3	31	548	Saint-Germain-de-Modéon	172	4	176
26	Bourgogne	21	3	01	549	Saint-Germain-le-Rocheux	89	5	94
26	Bourgogne	21	3	21	550	Saint-Germain-lès-Senailly	93	2	95
26	Bourgogne	21	3	37	552	Saint-Hélier	40	1	41
26	Bourgogne	21	2	35	553	Saint-Jean-de-Boeuf	113	1	114
26	Bourgogne	21	1	29	554	Saint-Jean-de-Losne	1168	11	1179
26	Bourgogne	21	2	09	555	Saint-Julien	1453	47	1500
26	Bourgogne	21	2	25	556	Saint-Léger-Triey	210	2	212
26	Bourgogne	21	3	04	557	Saint-Marc-sur-Seine	123	7	130
26	Bourgogne	21	1	19	560	Saint-Martin-de-la-Mer	293	3	296
26	Bourgogne	21	2	30	561	Saint-Martin-du-Mont	451	10	461
26	Bourgogne	21	2	13	562	Saint-Maurice-sur-Vingeanne	214	8	222
26	Bourgogne	21	3	37	563	Saint-Mesmin	138	1	139
26	Bourgogne	21	1	24	564	Saint-Nicolas-lès-Cîteaux	434	9	443
26	Bourgogne	21	2	15	565	Saint-Philibert	446	3	449
26	Bourgogne	21	1	02	566	Saint-Pierre-en-Vaux	133	0	133
26	Bourgogne	21	1	02	567	Saint-Prix-lès-Arnay	247	5	252
26	Bourgogne	21	3	21	568	Saint-Rémy	826	24	850
26	Bourgogne	21	1	23	569	Saint-Romain	234	12	246
26	Bourgogne	21	2	25	571	Saint-Sauveur	238	2	240
26	Bourgogne	21	1	29	572	Saint-Seine-en-Bâche	287	4	291
26	Bourgogne	21	2	30	573	Saint-Seine-l;Abbaye	360	45	405
26	Bourgogne	21	2	13	574	Saint-Seine-sur-Vingeanne	402	9	411
26	Bourgogne	21	1	29	575	Saint-Symphorien-sur-Saône	352	5	357
26	Bourgogne	21	3	37	576	Saint-Thibault	159	5	164
26	Bourgogne	21	1	29	577	Saint-Usage	1199	15	1214
26	Bourgogne	21	2	35	578	Saint-Victor-sur-Ouche	247	4	251
26	Bourgogne	21	3	37	544	Sainte-Colombe	60	4	64
26	Bourgogne	21	3	08	545	Sainte-Colombe-sur-Seine	947	22	969
26	Bourgogne	21	1	06	558	Sainte-Marie-la-Blanche	817	24	841
26	Bourgogne	21	2	35	559	Sainte-Marie-sur-Ouche	665	51	716
26	Bourgogne	21	1	26	570	Sainte-Sabine	190	4	194
26	Bourgogne	21	2	16	579	Salives	285	12	297
26	Bourgogne	21	3	36	580	Salmaise	140	3	143
26	Bourgogne	21	1	29	581	Samerey	130	4	134
26	Bourgogne	21	1	23	582	Santenay	838	21	859
26	Bourgogne	21	1	23	583	Santosse	49	1	50
26	Bourgogne	21	3	31	584	Saulieu	2564	122	2686
26	Bourgogne	21	2	15	585	Saulon-la-Chapelle	1049	14	1063
26	Bourgogne	21	2	15	586	Saulon-la-Rue	650	8	658
26	Bourgogne	21	2	17	587	Saulx-le-Duc	271	2	273
26	Bourgogne	21	1	07	588	Saussey	84	2	86
26	Bourgogne	21	2	30	589	Saussy	97	0	97
26	Bourgogne	21	2	43	591	Savigny-le-Sec	807	19	826
26	Bourgogne	21	1	05	590	Savigny-lès-Beaune	1367	40	1407
26	Bourgogne	21	2	35	592	Savigny-sous-Mâlain	195	6	201
26	Bourgogne	21	1	19	593	Savilly	76	1	77
26	Bourgogne	21	3	18	594	Savoisy	214	3	217
26	Bourgogne	21	2	20	595	Savolles	156	2	158
26	Bourgogne	21	2	15	596	Savouges	386	1	387
26	Bourgogne	21	2	15	597	Segrois	48	1	49
26	Bourgogne	21	3	21	598	Seigny	164	2	166
26	Bourgogne	21	2	32	599	Selongey	2410	40	2450
26	Bourgogne	21	1	26	600	Semarey	116	2	118
26	Bourgogne	21	2	15	601	Semezanges	104	6	110
26	Bourgogne	21	3	04	602	Semond	34	0	34
26	Bourgogne	21	3	33	603	Semur-en-Auxois	4195	415	4610
26	Bourgogne	21	3	21	604	Senailly	141	5	146
26	Bourgogne	21	2	10	605	Sennecey-lès-Dijon	2189	40	2229
26	Bourgogne	21	1	34	607	Seurre	2432	28	2460
26	Bourgogne	21	3	31	608	Sincey-lès-Rouvray	117	2	119
26	Bourgogne	21	2	03	609	Soirans	469	2	471
26	Bourgogne	21	2	25	610	Soissons-sur-Nacey	330	5	335
26	Bourgogne	21	2	35	611	Sombernon	978	15	993
26	Bourgogne	21	3	33	612	Souhey	95	5	100
26	Bourgogne	21	3	36	084	Source-Seine	53	0	53
26	Bourgogne	21	3	37	613	Soussey-sur-Brionne	136	3	139
26	Bourgogne	21	2	17	614	Spoy	298	3	301
26	Bourgogne	21	1	19	615	Sussey	251	6	257
26	Bourgogne	21	1	06	616	Tailly	191	8	199
26	Bourgogne	21	2	43	617	Talant	11475	268	11743
26	Bourgogne	21	2	25	618	Talmay	535	13	548
26	Bourgogne	21	2	20	619	Tanay	237	4	241
26	Bourgogne	21	2	17	620	Tarsul	172	0	172
26	Bourgogne	21	2	14	621	Tart-l;Abbaye	231	11	242
26	Bourgogne	21	2	14	622	Tart-le-Bas	227	2	229
26	Bourgogne	21	2	14	623	Tart-le-Haut	1389	13	1402
26	Bourgogne	21	2	25	624	Tellecey	132	2	134
26	Bourgogne	21	2	15	625	Ternant	105	4	109
26	Bourgogne	21	3	28	626	Terrefondrée	66	5	71
26	Bourgogne	21	3	36	627	Thenissey	119	5	124
26	Bourgogne	21	3	22	628	Thoires	74	6	80
26	Bourgogne	21	3	31	629	Thoisy-la-Berchère	311	4	315
26	Bourgogne	21	1	26	630	Thoisy-le-Désert	208	4	212
26	Bourgogne	21	1	07	631	Thomirey	59	1	60
26	Bourgogne	21	2	14	632	Thorey-en-Plaine	1022	13	1035
26	Bourgogne	21	3	37	633	Thorey-sous-Charny	188	4	192
26	Bourgogne	21	1	07	634	Thorey-sur-Ouche	153	0	153
26	Bourgogne	21	3	27	635	Thoste	117	6	123
26	Bourgogne	21	1	23	636	Thury	293	4	297
26	Bourgogne	21	1	34	637	Tichey	211	3	214
26	Bourgogne	21	2	17	638	Til-Châtel	1001	13	1014
26	Bourgogne	21	2	03	639	Tillenay	732	10	742
26	Bourgogne	21	3	33	640	Torcy-et-Pouligny	162	3	165
26	Bourgogne	21	3	21	641	Touillon	442	6	448
26	Bourgogne	21	3	33	642	Toutry	465	18	483
26	Bourgogne	21	2	03	643	Tréclun	388	2	390
26	Bourgogne	21	2	20	644	Trochères	180	2	182
26	Bourgogne	21	1	29	645	Trouhans	646	9	655
26	Bourgogne	21	2	30	646	Trouhaut	99	0	99
26	Bourgogne	21	1	34	647	Trugny	112	0	112
26	Bourgogne	21	2	30	648	Turcey	175	6	181
26	Bourgogne	21	3	37	649	Uncey-le-Franc	46	1	47
26	Bourgogne	21	2	15	650	Urcy	159	4	163
26	Bourgogne	21	2	30	651	Val-Suzon	220	11	231
26	Bourgogne	21	1	26	652	Vandenesse-en-Auxois	284	11	295
26	Bourgogne	21	3	08	653	Vannaire	62	0	62
26	Bourgogne	21	3	08	655	Vanvey	235	19	254
26	Bourgogne	21	2	14	656	Varanges	778	14	792
26	Bourgogne	21	2	09	657	Varois-et-Chaignot	2004	61	2065
26	Bourgogne	21	1	23	658	Vauchignon	39	0	39
26	Bourgogne	21	2	30	659	Vaux-Saules	191	0	191
26	Bourgogne	21	1	07	660	Veilly	61	3	64
26	Bourgogne	21	2	39	661	Velars-sur-Ouche	1704	42	1746
26	Bourgogne	21	3	37	662	Velogny	39	1	40
26	Bourgogne	21	3	36	663	Venarey-les-Laumes	2947	71	3018
26	Bourgogne	21	3	18	664	Verdonnet	88	2	90
26	Bourgogne	21	2	32	665	Vernois-lès-Vesvres	194	0	194
26	Bourgogne	21	2	17	666	Vernot	71	2	73
26	Bourgogne	21	2	32	667	Véronnes	397	7	404
26	Bourgogne	21	2	35	669	Verrey-sous-Drée	62	0	62
26	Bourgogne	21	3	36	670	Verrey-sous-Salmaise	318	6	324
26	Bourgogne	21	3	18	671	Vertault	54	1	55
26	Bourgogne	21	3	37	672	Vesvres	23	1	24
26	Bourgogne	21	1	07	673	Veuvey-sur-Ouche	206	1	207
26	Bourgogne	21	3	22	674	Veuxhaulles-sur-Aube	231	4	235
26	Bourgogne	21	1	19	675	Vianges	61	2	63
26	Bourgogne	21	3	33	676	Vic-de-Chassenay	230	12	242
26	Bourgogne	21	1	07	677	Vic-des-Prés	105	1	106
26	Bourgogne	21	3	27	678	Vic-sous-Thil	202	7	209
26	Bourgogne	21	2	35	679	Vieilmoulin	103	2	105
26	Bourgogne	21	2	25	680	Vielverge	496	3	499
26	Bourgogne	21	3	33	681	Vieux-Château	97	2	99
26	Bourgogne	21	2	20	682	Viévigne	213	7	220
26	Bourgogne	21	1	02	683	Viévy	339	8	347
26	Bourgogne	21	1	06	684	Vignoles	851	17	868
26	Bourgogne	21	3	04	685	Villaines-en-Duesmois	289	10	299
26	Bourgogne	21	3	21	686	Villaines-les-Prévôtes	141	9	150
26	Bourgogne	21	3	31	687	Villargoix	169	2	171
26	Bourgogne	21	3	33	689	Villars-et-Villenotte	156	7	163
26	Bourgogne	21	1	24	688	Villars-Fontaine	125	5	130
26	Bourgogne	21	3	37	690	Villeberny	87	2	89
26	Bourgogne	21	1	24	691	Villebichot	377	8	385
26	Bourgogne	21	2	17	692	Villecomte	267	3	270
26	Bourgogne	21	3	18	693	Villedieu	76	2	78
26	Bourgogne	21	3	37	694	Villeferry	31	1	32
26	Bourgogne	21	3	04	695	La Villeneuve-les-Convers	40	1	41
26	Bourgogne	21	3	33	696	Villeneuve-sous-Charigny	94	6	100
26	Bourgogne	21	1	24	698	Villers-la-Faye	407	9	416
26	Bourgogne	21	2	03	699	Villers-les-Pots	1034	19	1053
26	Bourgogne	21	3	08	700	Villers-Patras	97	4	101
26	Bourgogne	21	2	03	701	Villers-Rotin	136	1	137
26	Bourgogne	21	2	17	702	Villey-sur-Tille	296	4	300
26	Bourgogne	21	1	19	703	Villiers-en-Morvan	42	1	43
26	Bourgogne	21	3	08	704	Villiers-le-Duc	103	3	106
26	Bourgogne	21	2	30	705	Villotte-Saint-Seine	60	2	62
26	Bourgogne	21	3	08	706	Villotte-sur-Ource	112	3	115
26	Bourgogne	21	3	37	707	Villy-en-Auxois	239	6	245
26	Bourgogne	21	1	24	708	Villy-le-Moutier	356	1	357
26	Bourgogne	21	3	21	709	Viserny	191	7	198
26	Bourgogne	21	3	37	710	Vitteaux	1102	38	1140
26	Bourgogne	21	3	08	711	Vix	111	6	117
26	Bourgogne	21	1	05	712	Volnay	274	6	280
26	Bourgogne	21	2	25	713	Vonges	347	2	349
26	Bourgogne	21	1	24	714	Vosne-Romanée	415	10	425
26	Bourgogne	21	1	02	715	Voudenay	190	1	191
26	Bourgogne	21	1	24	716	Vougeot	191	3	194
26	Bourgogne	21	3	28	717	Voulaines-les-Templiers	306	17	323
53	Bretagne	22	4	48	001	Allineuc	561	6	567
53	Bretagne	22	4	18	002	Andel	1098	23	1121
53	Bretagne	22	1	12	003	Aucaleuc	893	28	921
53	Bretagne	22	2	01	004	Bégard	4707	75	4782
53	Bretagne	22	2	02	005	Belle-Isle-en-Terre	1072	18	1090
53	Bretagne	22	3	42	006	Berhet	225	9	234
53	Bretagne	22	4	13	007	Binic	3693	91	3784
53	Bretagne	22	1	12	008	Bobital	1036	27	1063
53	Bretagne	22	4	34	009	Le Bodéo	179	3	182
53	Bretagne	22	4	07	011	Boqueho	1067	22	1089
53	Bretagne	22	1	24	012	La Bouillie	847	13	860
53	Bretagne	22	2	03	013	Bourbriac	2351	57	2408
53	Bretagne	22	1	30	014	Bourseul	1072	27	1099
53	Bretagne	22	4	26	015	Bréhand	1438	24	1462
53	Bretagne	22	2	40	018	Brélidy	302	12	314
53	Bretagne	22	2	35	019	Bringolo	399	7	406
53	Bretagne	22	1	04	020	Broons	2924	61	2985
53	Bretagne	22	1	12	021	Brusvily	1065	27	1092
53	Bretagne	22	2	05	023	Bulat-Pestivien	465	10	475
53	Bretagne	22	2	05	024	Calanhel	254	9	263
53	Bretagne	22	2	05	025	Callac	2365	38	2403
53	Bretagne	22	1	12	026	Calorguen	671	28	699
53	Bretagne	22	4	08	027	Le Cambout	475	18	493
53	Bretagne	22	3	47	028	Camlez	853	27	880
53	Bretagne	22	2	46	029	Canihuel	376	12	388
53	Bretagne	22	3	19	030	Caouënnec-Lanvézéac	879	16	895
53	Bretagne	22	2	05	031	Carnoët	770	5	775
53	Bretagne	22	1	06	032	Caulnes	2385	141	2526
53	Bretagne	22	2	27	033	Caurel	378	13	391
53	Bretagne	22	3	42	034	Cavan	1419	26	1445
53	Bretagne	22	1	14	035	Les Champs-Géraux	1036	24	1060
53	Bretagne	22	1	06	036	La Chapelle-Blanche	200	9	209
53	Bretagne	22	2	02	037	La Chapelle-Neuve	425	3	428
53	Bretagne	22	4	07	038	Châtelaudren	1020	42	1062
53	Bretagne	22	4	08	039	La Chèze	592	22	614
53	Bretagne	22	2	16	040	Coadout	543	6	549
53	Bretagne	22	3	42	041	Coatascorn	251	4	255
53	Bretagne	22	3	47	042	Coatréven	437	19	456
53	Bretagne	22	4	08	043	Coëtlogon	236	2	238
53	Bretagne	22	4	18	044	Coëtmieux	1599	29	1628
53	Bretagne	22	4	07	045	Cohiniac	383	12	395
53	Bretagne	22	1	09	046	Collinée	921	21	942
53	Bretagne	22	4	10	047	Corlay	1011	22	1033
53	Bretagne	22	1	30	048	Corseul	2029	88	2117
53	Bretagne	22	1	30	049	Créhen	1697	59	1756
53	Bretagne	22	1	98	050	Dinan	10819	461	11280
53	Bretagne	22	1	17	051	Dolo	606	13	619
53	Bretagne	22	2	05	052	Duault	356	4	360
53	Bretagne	22	1	04	053	Éréac	644	7	651
53	Bretagne	22	4	32	054	Erquy	3852	90	3942
53	Bretagne	22	4	13	055	Étables-sur-Mer	3062	102	3164
53	Bretagne	22	1	14	056	Évran	1664	24	1688
53	Bretagne	22	4	20	057	Le Faouët	317	4	321
53	Bretagne	22	4	08	058	La Ferrière	455	7	462
53	Bretagne	22	4	41	059	Le Foeil	1473	41	1514
53	Bretagne	22	1	24	179	Fréhel	1637	39	1676
53	Bretagne	22	4	38	060	Gausson	620	19	639
53	Bretagne	22	2	43	061	Glomel	1389	47	1436
53	Bretagne	22	1	25	062	Gomené	588	16	604
53	Bretagne	22	4	20	063	Gommenec;h	531	14	545
53	Bretagne	22	2	15	064	Gouarec	937	30	967
53	Bretagne	22	2	35	065	Goudelin	1657	38	1695
53	Bretagne	22	1	09	066	Le Gouray	1219	12	1231
53	Bretagne	22	4	48	068	Grâce-Uzel	414	9	423
53	Bretagne	22	2	16	067	Grâces	2435	47	2482
53	Bretagne	22	1	06	069	Guenroc	216	7	223
53	Bretagne	22	2	16	070	Guingamp	7280	858	8138
53	Bretagne	22	1	06	071	Guitté	623	17	640
53	Bretagne	22	2	02	072	Gurunhuel	398	10	408
53	Bretagne	22	4	34	073	La Harmoye	431	11	442
53	Bretagne	22	4	10	074	Le Haut-Corlay	688	24	712
53	Bretagne	22	4	22	075	Hémonstoir	671	10	681
53	Bretagne	22	1	24	076	Hénanbihen	1365	37	1402
53	Bretagne	22	1	24	077	Hénansal	1123	28	1151
53	Bretagne	22	3	42	078	Hengoat	203	4	207
53	Bretagne	22	4	26	079	Hénon	2204	34	2238
53	Bretagne	22	4	34	080	L; Hermitage-Lorge	743	8	751
53	Bretagne	22	4	49	081	Hillion	4076	91	4167
53	Bretagne	22	1	12	082	Le Hinglé	832	32	864
53	Bretagne	22	4	28	016	Île-de-Bréhat	414	11	425
53	Bretagne	22	1	25	083	Illifaut	685	21	706
53	Bretagne	22	1	17	084	Jugon-les-Lacs	1731	37	1768
53	Bretagne	22	3	21	085	Kerbors	312	9	321
53	Bretagne	22	4	28	086	Kerfot	651	21	672
53	Bretagne	22	2	43	087	Kergrist-Moëlou	659	16	675
53	Bretagne	22	2	03	088	Kerien	277	7	284
53	Bretagne	22	3	29	090	Kermaria-Sulard	979	31	1010
53	Bretagne	22	2	01	091	Kermoroc;h	417	6	423
53	Bretagne	22	2	46	092	Kerpert	297	7	304
53	Bretagne	22	4	18	093	Lamballe	12098	441	12539
53	Bretagne	22	1	37	094	Lancieux	1494	53	1547
53	Bretagne	22	2	01	095	Landebaëron	193	3	196
53	Bretagne	22	1	30	096	Landébia	492	13	505
53	Bretagne	22	1	31	097	La Landec	715	19	734
53	Bretagne	22	4	18	098	Landéhen	1346	25	1371
53	Bretagne	22	4	34	099	Lanfains	1016	38	1054
53	Bretagne	22	4	38	100	Langast	631	22	653
53	Bretagne	22	3	47	101	Langoat	1124	47	1171
53	Bretagne	22	1	09	102	Langourla	555	5	560
53	Bretagne	22	1	37	103	Langrolay-sur-Rance	832	24	856
53	Bretagne	22	1	31	104	Languédias	461	35	496
53	Bretagne	22	1	30	105	Languenan	1100	24	1124
53	Bretagne	22	4	49	106	Langueux	7178	326	7504
53	Bretagne	22	2	15	107	Laniscat	813	19	832
53	Bretagne	22	4	39	108	Lanleff	109	6	115
53	Bretagne	22	4	39	109	Lanloup	269	7	276
53	Bretagne	22	3	47	110	Lanmérin	495	5	500
53	Bretagne	22	3	21	111	Lanmodez	461	8	469
53	Bretagne	22	4	20	112	Lannebert	418	8	426
53	Bretagne	22	3	19	113	Lannion	20079	904	20983
53	Bretagne	22	1	04	114	Lanrelas	862	18	880
53	Bretagne	22	2	46	115	Lanrivain	549	16	565
53	Bretagne	22	2	35	116	Lanrodec	1180	80	1260
53	Bretagne	22	4	13	117	Lantic	1541	20	1561
53	Bretagne	22	1	11	118	Lanvallay	3735	96	3831
53	Bretagne	22	3	33	119	Lanvellec	551	6	557
53	Bretagne	22	4	20	121	Lanvollon	1767	27	1794
53	Bretagne	22	1	25	122	Laurenan	716	15	731
53	Bretagne	22	1	11	123	Léhon	3064	143	3207
53	Bretagne	22	2	15	124	Lescouët-Gouarec	206	8	214
53	Bretagne	22	4	41	126	Le Leslay	138	5	143
53	Bretagne	22	3	21	127	Lézardrieux	1601	46	1647
53	Bretagne	22	2	02	129	Loc-Envel	73	10	83
53	Bretagne	22	2	23	128	Locarn	535	23	558
53	Bretagne	22	3	36	131	Loguivy-Plougras	950	26	976
53	Bretagne	22	2	05	132	Lohuec	272	7	279
53	Bretagne	22	1	25	133	Loscouët-sur-Meu	648	20	668
53	Bretagne	22	3	29	134	Louannec	3017	128	3145
53	Bretagne	22	2	02	135	Louargat	2301	65	2366
53	Bretagne	22	4	22	136	Loudéac	9857	467	10324
53	Bretagne	22	2	23	137	Maël-Carhaix	1619	29	1648
53	Bretagne	22	2	05	138	Maël-Pestivien	406	9	415
53	Bretagne	22	2	03	139	Magoar	89	2	91
53	Bretagne	22	4	18	140	La Malhoure	479	12	491
53	Bretagne	22	3	42	141	Mantallot	213	3	216
53	Bretagne	22	1	24	143	Matignon	1683	45	1728
53	Bretagne	22	4	51	144	La Méaugon	1301	40	1341
53	Bretagne	22	1	04	145	Mégrit	747	7	754
53	Bretagne	22	2	15	146	Mellionnec	403	17	420
53	Bretagne	22	1	25	147	Merdrignac	2918	176	3094
53	Bretagne	22	1	25	148	Mérillac	240	6	246
53	Bretagne	22	4	48	149	Merléac	498	24	522
53	Bretagne	22	4	20	150	Le Merzer	906	13	919
53	Bretagne	22	4	18	151	Meslin	987	22	1009
53	Bretagne	22	3	47	152	Minihy-Tréguier	1103	57	1160
53	Bretagne	22	4	26	153	Moncontour	940	17	957
53	Bretagne	22	4	18	154	Morieux	936	17	953
53	Bretagne	22	4	22	155	La Motte	2056	56	2112
53	Bretagne	22	2	16	156	Moustéru	689	11	700
53	Bretagne	22	2	23	157	Le Moustoir	672	23	695
53	Bretagne	22	2	27	158	Mûr-de-Bretagne	2108	59	2167
53	Bretagne	22	4	18	160	Noyal	836	24	860
53	Bretagne	22	2	16	161	Pabu	2799	145	2944
53	Bretagne	22	4	28	162	Paimpol	7634	408	8042
53	Bretagne	22	2	23	163	Paule	699	24	723
53	Bretagne	22	2	01	164	Pédernec	1905	51	1956
53	Bretagne	22	4	26	165	Penguily	613	7	620
53	Bretagne	22	3	47	166	Penvénan	2620	88	2708
53	Bretagne	22	2	15	167	Perret	175	4	179
53	Bretagne	22	3	29	168	Perros-Guirec	7511	303	7814
53	Bretagne	22	2	46	169	Peumerit-Quintin	167	3	170
53	Bretagne	22	4	41	170	Plaine-Haute	1416	23	1439
53	Bretagne	22	4	34	171	Plaintel	3985	99	4084
53	Bretagne	22	1	30	172	Plancoët	3082	76	3158
53	Bretagne	22	4	32	173	Planguenoual	2001	44	2045
53	Bretagne	22	1	24	174	Pléboulle	726	18	744
53	Bretagne	22	1	17	175	Plédéliac	1284	31	1315
53	Bretagne	22	4	51	176	Plédran	6039	112	6151
53	Bretagne	22	4	20	177	Pléguien	1201	32	1233
53	Bretagne	22	4	39	178	Pléhédel	1311	31	1342
53	Bretagne	22	1	31	180	Plélan-le-Petit	1765	73	1838
53	Bretagne	22	2	15	181	Plélauff	693	28	721
53	Bretagne	22	4	07	182	Plélo	3275	90	3365
53	Bretagne	22	4	08	183	Plémet	3047	128	3175
53	Bretagne	22	4	38	184	Plémy	1682	43	1725
53	Bretagne	22	1	17	185	Plénée-Jugon	2434	75	2509
53	Bretagne	22	4	32	186	Pléneuf-Val-André	4054	110	4164
53	Bretagne	22	4	50	187	Plérin	13788	605	14393
53	Bretagne	22	4	07	188	Plerneuf	1009	12	1021
53	Bretagne	22	2	03	189	Plésidy	640	14	654
53	Bretagne	22	1	37	190	Pleslin-Trigavou	3425	76	3501
53	Bretagne	22	4	38	191	Plessala	1881	55	1936
53	Bretagne	22	1	37	192	Plessix-Balisson	92	1	93
53	Bretagne	22	1	17	193	Plestan	1546	42	1588
53	Bretagne	22	3	33	194	Plestin-les-Grèves	3616	123	3739
53	Bretagne	22	3	21	195	Pleubian	2533	90	2623
53	Bretagne	22	3	21	196	Pleudaniel	980	26	1006
53	Bretagne	22	1	11	197	Pleudihen-sur-Rance	2825	81	2906
53	Bretagne	22	3	29	198	Pleumeur-Bodou	4050	180	4230
53	Bretagne	22	3	21	199	Pleumeur-Gautier	1180	22	1202
53	Bretagne	22	1	30	200	Pléven	565	16	581
53	Bretagne	22	1	24	201	Plévenon	731	14	745
53	Bretagne	22	2	23	202	Plévin	795	25	820
53	Bretagne	22	4	34	203	Ploeuc-sur-Lié	3247	66	3313
53	Bretagne	22	2	40	204	Ploëzal	1225	29	1254
53	Bretagne	22	1	31	205	Plorec-sur-Arguenon	399	6	405
53	Bretagne	22	2	35	206	Plouagat	2522	61	2583
53	Bretagne	22	3	36	207	Plouaret	2189	47	2236
53	Bretagne	22	1	14	208	Plouasne	1554	28	1582
53	Bretagne	22	1	37	209	Ploubalay	2769	60	2829
53	Bretagne	22	4	28	210	Ploubazlanec	3263	186	3449
53	Bretagne	22	3	19	211	Ploubezre	3376	91	3467
53	Bretagne	22	2	40	212	Plouëc-du-Trieux	1102	25	1127
53	Bretagne	22	1	12	213	Plouër-sur-Rance	3361	113	3474
53	Bretagne	22	4	28	214	Plouézec	3382	108	3490
53	Bretagne	22	4	51	215	Ploufragan	11111	426	11537
53	Bretagne	22	2	02	216	Plougonver	715	17	732
53	Bretagne	22	3	36	217	Plougras	441	16	457
53	Bretagne	22	3	47	218	Plougrescant	1349	48	1397
53	Bretagne	22	4	38	219	Plouguenast	1846	69	1915
53	Bretagne	22	2	43	220	Plouguernével	1759	64	1823
53	Bretagne	22	3	47	221	Plouguiel	1840	58	1898
53	Bretagne	22	4	39	222	Plouha	4597	99	4696
53	Bretagne	22	2	16	223	Plouisy	1926	259	2185
53	Bretagne	22	3	19	224	Ploulec;h	1678	58	1736
53	Bretagne	22	2	16	225	Ploumagoar	5142	84	5226
53	Bretagne	22	3	33	226	Ploumilliau	2550	69	2619
53	Bretagne	22	3	36	227	Plounérin	749	11	760
53	Bretagne	22	3	36	228	Plounévez-Moëdec	1442	35	1477
53	Bretagne	22	2	43	229	Plounévez-Quintin	1074	55	1129
53	Bretagne	22	2	05	231	Plourac;h	348	15	363
53	Bretagne	22	4	13	232	Plourhan	1954	44	1998
53	Bretagne	22	4	28	233	Plourivo	2213	86	2299
53	Bretagne	22	4	07	234	Plouvara	1105	18	1123
53	Bretagne	22	3	33	235	Plouzélambre	220	10	230
53	Bretagne	22	4	39	236	Pludual	718	15	733
53	Bretagne	22	1	30	237	Pluduno	2091	58	2149
53	Bretagne	22	3	33	238	Plufur	558	12	570
53	Bretagne	22	1	06	239	Plumaudan	1151	18	1169
53	Bretagne	22	1	06	240	Plumaugat	1095	30	1125
53	Bretagne	22	4	08	241	Plumieux	1075	27	1102
53	Bretagne	22	4	32	242	Plurien	1417	33	1450
53	Bretagne	22	2	05	243	Plusquellec	570	24	594
53	Bretagne	22	4	10	244	Plussulien	492	13	505
53	Bretagne	22	3	36	245	Pluzunet	1019	38	1057
53	Bretagne	22	4	18	246	Pommeret	1916	36	1952
53	Bretagne	22	3	42	247	Pommerit-Jaudy	1266	473	1739
53	Bretagne	22	4	20	248	Pommerit-le-Vicomte	1812	44	1856
53	Bretagne	22	2	03	249	Pont-Melvez	673	16	689
53	Bretagne	22	2	40	250	Pontrieux	1024	19	1043
53	Bretagne	22	4	50	251	Pordic	5956	167	6123
53	Bretagne	22	3	42	253	Pouldouran	165	9	174
53	Bretagne	22	3	42	254	Prat	1144	41	1185
53	Bretagne	22	4	08	255	La Prénessaye	848	16	864
53	Bretagne	22	2	40	256	Quemper-Guézennec	1091	23	1114
53	Bretagne	22	3	42	257	Quemperven	390	10	400
53	Bretagne	22	4	26	258	Quessoy	3492	249	3741
53	Bretagne	22	1	12	259	Quévert	3626	165	3791
53	Bretagne	22	4	48	260	Le Quillio	545	10	555
53	Bretagne	22	4	18	261	Quintenic	315	3	318
53	Bretagne	22	4	41	262	Quintin	2834	210	3044
53	Bretagne	22	1	14	263	Le Quiou	339	7	346
53	Bretagne	22	3	42	264	La Roche-Derrien	1010	42	1052
53	Bretagne	22	3	19	265	Rospez	1727	48	1775
53	Bretagne	22	2	43	266	Rostrenen	3307	329	3636
53	Bretagne	22	1	04	267	Rouillac	364	4	368
53	Bretagne	22	1	24	268	Ruca	562	10	572
53	Bretagne	22	2	40	269	Runan	255	7	262
53	Bretagne	22	2	03	271	Saint-Adrien	337	2	339
53	Bretagne	22	2	16	272	Saint-Agathon	2110	50	2160
53	Bretagne	22	4	32	273	Saint-Alban	1963	29	1992
53	Bretagne	22	1	14	274	Saint-André-des-Eaux	248	7	255
53	Bretagne	22	4	08	275	Saint-Barnabé	1262	37	1299
53	Bretagne	22	4	41	276	Saint-Bihy	200	9	209
53	Bretagne	22	4	41	277	Saint-Brandan	2369	50	2419
53	Bretagne	22	4	99	278	Saint-Brieuc	46209	2037	48246
53	Bretagne	22	4	22	279	Saint-Caradec	1196	26	1222
53	Bretagne	22	1	12	280	Saint-Carné	891	51	942
53	Bretagne	22	4	26	281	Saint-Carreuc	1501	9	1510
53	Bretagne	22	1	24	282	Saint-Cast-le-Guildo	3491	80	3571
53	Bretagne	22	2	40	283	Saint-Clet	871	28	899
53	Bretagne	22	2	46	284	Saint-Connan	305	7	312
53	Bretagne	22	2	27	285	Saint-Connec	266	17	283
53	Bretagne	22	1	24	286	Saint-Denoual	416	7	423
53	Bretagne	22	4	51	287	Saint-Donan	1463	35	1498
53	Bretagne	22	4	08	288	Saint-Étienne-du-Gué-de-l;Isle	388	11	399
53	Bretagne	22	2	35	289	Saint-Fiacre	226	2	228
53	Bretagne	22	2	15	290	Saint-Gelven	316	8	324
53	Bretagne	22	4	41	291	Saint-Gildas	303	7	310
53	Bretagne	22	1	09	292	Saint-Gilles-du-Mené	481	10	491
53	Bretagne	22	2	40	293	Saint-Gilles-les-Bois	409	9	418
53	Bretagne	22	2	46	294	Saint-Gilles-Pligeaux	272	7	279
53	Bretagne	22	2	27	295	Saint-Gilles-Vieux-Marché	326	12	338
53	Bretagne	22	4	26	296	Saint-Glen	596	17	613
53	Bretagne	22	1	09	297	Saint-Gouéno	660	23	683
53	Bretagne	22	2	27	298	Saint-Guen	460	12	472
53	Bretagne	22	1	11	299	Saint-Hélen	1234	27	1261
53	Bretagne	22	4	48	300	Saint-Hervé	403	10	413
53	Bretagne	22	2	15	334	Saint-Igeaux	140	4	144
53	Bretagne	22	1	37	302	Saint-Jacut-de-la-Mer	853	15	868
53	Bretagne	22	1	09	303	Saint-Jacut-du-Mené	725	14	739
53	Bretagne	22	2	35	304	Saint-Jean-Kerdaniel	578	12	590
53	Bretagne	22	1	06	305	Saint-Jouan-de-l;Isle	454	8	462
53	Bretagne	22	1	14	306	Saint-Judoce	549	14	563
53	Bretagne	22	4	51	307	Saint-Julien	2053	44	2097
53	Bretagne	22	1	14	308	Saint-Juvat	642	12	654
53	Bretagne	22	1	25	309	Saint-Launeuc	197	0	197
53	Bretagne	22	2	01	310	Saint-Laurent	476	8	484
53	Bretagne	22	1	30	311	Saint-Lormel	876	16	892
53	Bretagne	22	1	06	312	Saint-Maden	201	8	209
53	Bretagne	22	4	10	313	Saint-Martin-des-Prés	338	13	351
53	Bretagne	22	4	22	314	Saint-Maudan	372	15	387
53	Bretagne	22	1	31	315	Saint-Maudez	295	13	308
53	Bretagne	22	4	10	316	Saint-Mayeux	515	11	526
53	Bretagne	22	1	31	317	Saint-Méloir-des-Bois	257	12	269
53	Bretagne	22	1	31	318	Saint-Michel-de-Plélan	308	3	311
53	Bretagne	22	3	33	319	Saint-Michel-en-Grève	474	17	491
53	Bretagne	22	2	05	320	Saint-Nicodème	169	6	175
53	Bretagne	22	2	46	321	Saint-Nicolas-du-Pélem	1723	63	1786
53	Bretagne	22	2	35	322	Saint-Péver	358	4	362
53	Bretagne	22	1	24	323	Saint-Pôtan	808	4	812
53	Bretagne	22	3	29	324	Saint-Quay-Perros	1461	58	1519
53	Bretagne	22	4	13	325	Saint-Quay-Portrieux	3093	240	3333
53	Bretagne	22	4	18	326	Saint-Rieul	458	4	462
53	Bretagne	22	1	12	327	Saint-Samson-sur-Rance	1520	45	1565
53	Bretagne	22	2	05	328	Saint-Servais	408	5	413
53	Bretagne	22	4	48	330	Saint-Thélo	420	6	426
53	Bretagne	22	4	26	332	Saint-Trimoël	444	8	452
53	Bretagne	22	1	25	333	Saint-Vran	745	12	757
53	Bretagne	22	2	46	331	Sainte-Tréphine	219	4	223
53	Bretagne	22	2	03	335	Senven-Léhart	233	5	238
53	Bretagne	22	1	04	337	Sévignac	1114	27	1141
53	Bretagne	22	2	01	338	Squiffiec	769	17	786
53	Bretagne	22	1	12	339	Taden	2297	116	2413
53	Bretagne	22	3	36	340	Tonquédec	1073	29	1102
53	Bretagne	22	1	17	341	Tramain	649	15	664
53	Bretagne	22	1	31	342	Trébédan	393	5	398
53	Bretagne	22	3	29	343	Trébeurden	3710	149	3859
53	Bretagne	22	2	23	344	Trébrivan	698	20	718
53	Bretagne	22	4	26	345	Trébry	762	7	769
53	Bretagne	22	4	26	346	Trédaniel	994	15	1009
53	Bretagne	22	3	21	347	Trédarzec	1135	44	1179
53	Bretagne	22	1	04	348	Trédias	515	4	519
53	Bretagne	22	3	33	349	Trédrez-Locquémeau	1460	31	1491
53	Bretagne	22	3	33	350	Tréduder	200	10	210
53	Bretagne	22	2	23	351	Treffrin	558	11	569
53	Bretagne	22	1	14	352	Tréfumel	265	15	280
53	Bretagne	22	3	29	353	Trégastel	2440	85	2525
53	Bretagne	22	2	02	354	Tréglamus	1007	31	1038
53	Bretagne	22	4	07	356	Trégomeur	919	19	938
53	Bretagne	22	1	37	357	Trégon	234	7	241
53	Bretagne	22	2	01	358	Trégonneau	511	6	517
53	Bretagne	22	3	36	359	Trégrom	401	5	406
53	Bretagne	22	4	49	360	Trégueux	7926	230	8156
53	Bretagne	22	4	20	361	Tréguidel	600	17	617
53	Bretagne	22	3	47	362	Tréguier	2723	252	2975
53	Bretagne	22	3	29	363	Trélévern	1381	56	1437
53	Bretagne	22	1	12	364	Trélivan	2501	79	2580
53	Bretagne	22	2	43	365	Trémargat	164	11	175
53	Bretagne	22	3	33	366	Trémel	415	12	427
53	Bretagne	22	4	07	367	Tréméloir	743	7	750
53	Bretagne	22	1	37	368	Tréméreuc	627	19	646
53	Bretagne	22	1	04	369	Trémeur	684	21	705
53	Bretagne	22	4	20	370	Tréméven	362	6	368
53	Bretagne	22	1	25	371	Trémorel	1106	19	1125
53	Bretagne	22	4	50	372	Trémuson	1916	41	1957
53	Bretagne	22	2	23	373	Tréogan	99	5	104
53	Bretagne	22	4	20	375	Tressignaux	612	10	622
53	Bretagne	22	4	22	376	Trévé	1547	47	1594
53	Bretagne	22	4	13	377	Tréveneuc	779	23	802
53	Bretagne	22	4	20	378	Trévérec	202	3	205
53	Bretagne	22	3	29	379	Trévou-Tréguignec	1434	36	1470
53	Bretagne	22	1	12	380	Trévron	704	18	722
53	Bretagne	22	3	47	381	Trézény	320	7	327
53	Bretagne	22	3	42	383	Troguéry	297	7	304
53	Bretagne	22	4	48	384	Uzel	1075	34	1109
53	Bretagne	22	1	11	385	La Vicomté-sur-Rance	950	41	991
53	Bretagne	22	4	41	386	Le Vieux-Bourg	765	7	772
53	Bretagne	22	3	36	387	Le Vieux-Marché	1274	37	1311
53	Bretagne	22	1	31	388	Vildé-Guingalan	1199	29	1228
53	Bretagne	22	4	49	389	Yffiniac	4778	109	4887
53	Bretagne	22	4	28	390	Yvias	732	11	743
53	Bretagne	22	1	04	391	Yvignac-la-Tour	1199	23	1222
74	Limousin	23	2	01	001	Ahun	1590	248	1838
74	Limousin	23	2	19	002	Ajain	1098	28	1126
74	Limousin	23	1	02	003	Alleyrat	142	6	148
74	Limousin	23	2	24	004	Anzême	559	18	577
74	Limousin	23	1	15	005	Arfeuille-Châtain	208	9	217
74	Limousin	23	2	05	006	Arrènes	228	7	235
74	Limousin	23	1	23	007	Ars	260	8	268
74	Limousin	23	1	02	008	Aubusson	3844	227	4071
74	Limousin	23	1	09	009	Auge	104	2	106
74	Limousin	23	2	05	010	Augères	129	1	130
74	Limousin	23	2	05	011	Aulon	165	1	166
74	Limousin	23	2	07	012	Auriat	125	1	126
74	Limousin	23	1	03	013	Auzances	1336	64	1400
74	Limousin	23	2	05	014	Azat-Châtenet	134	1	135
74	Limousin	23	2	25	015	Azerables	924	14	938
74	Limousin	23	1	23	016	Banize	159	1	160
74	Limousin	23	1	13	017	Basville	174	7	181
74	Limousin	23	2	25	018	Bazelat	297	8	305
74	Limousin	23	1	12	019	Beissat	34	1	35
74	Limousin	23	1	04	020	Bellegarde-en-Marche	409	19	428
74	Limousin	23	2	05	021	Bénévent-l;Abbaye	843	20	863
74	Limousin	23	2	10	022	Bétête	346	9	355
74	Limousin	23	2	20	023	Blaudeix	116	2	118
74	Limousin	23	1	02	024	Blessac	523	24	547
74	Limousin	23	2	06	025	Bonnat	1305	27	1332
74	Limousin	23	2	08	026	Bord-Saint-Georges	360	21	381
74	Limousin	23	2	07	027	Bosmoreau-les-Mines	249	1	250
74	Limousin	23	1	04	028	Bosroger	108	0	108
74	Limousin	23	2	06	029	Le Bourg-d;Hem	227	4	231
74	Limousin	23	2	07	030	Bourganeuf	2910	231	3141
74	Limousin	23	2	08	031	Boussac	1353	56	1409
74	Limousin	23	2	08	032	Boussac-Bourg	783	21	804
74	Limousin	23	2	24	033	La Brionne	427	13	440
74	Limousin	23	1	03	034	Brousse	25	1	26
74	Limousin	23	1	09	035	Budelière	788	17	805
74	Limousin	23	2	24	036	Bussière-Dunoise	1073	13	1086
74	Limousin	23	1	03	037	Bussière-Nouvelle	114	1	115
74	Limousin	23	2	08	038	Bussière-Saint-Georges	223	3	226
74	Limousin	23	2	14	039	La Celle-Dunoise	608	29	637
74	Limousin	23	2	20	040	La Celle-sous-Gouzon	139	4	143
74	Limousin	23	2	10	041	La Cellette	273	2	275
74	Limousin	23	2	05	042	Ceyroux	127	0	127
74	Limousin	23	1	23	043	Chamberaud	101	2	103
74	Limousin	23	2	06	044	Chambon-Sainte-Croix	88	1	89
74	Limousin	23	1	09	045	Chambon-sur-Voueize	1010	12	1022
74	Limousin	23	1	15	046	Chambonchard	87	0	87
74	Limousin	23	2	18	047	Chamborand	232	9	241
74	Limousin	23	1	04	048	Champagnat	440	10	450
74	Limousin	23	2	06	049	Champsanglard	228	5	233
74	Limousin	23	2	14	050	La Chapelle-Baloue	130	4	134
74	Limousin	23	2	21	051	La Chapelle-Saint-Martial	86	1	87
74	Limousin	23	2	27	052	La Chapelle-Taillefert	379	5	384
74	Limousin	23	1	03	053	Chard	202	3	205
74	Limousin	23	1	03	054	Charron	229	6	235
74	Limousin	23	1	03	055	Châtelard	33	1	34
74	Limousin	23	2	05	056	Châtelus-le-Marcheix	368	8	376
74	Limousin	23	2	10	057	Châtelus-Malvaleix	569	16	585
74	Limousin	23	1	11	058	Le Chauchet	108	1	109
74	Limousin	23	1	04	059	La Chaussade	117	3	120
74	Limousin	23	1	23	060	Chavanat	129	3	132
74	Limousin	23	1	11	061	Chénérailles	750	26	776
74	Limousin	23	2	06	062	Chéniers	557	11	568
74	Limousin	23	1	12	063	Clairavaux	153	3	156
74	Limousin	23	2	10	064	Clugnat	709	17	726
74	Limousin	23	2	14	065	Colondannes	271	4	275
74	Limousin	23	1	03	066	Le Compas	207	1	208
74	Limousin	23	1	12	067	La Courtine	818	24	842
74	Limousin	23	2	01	068	Cressat	570	7	577
74	Limousin	23	1	13	069	Crocq	442	9	451
74	Limousin	23	2	14	070	Crozant	533	18	551
74	Limousin	23	1	16	071	Croze	190	5	195
74	Limousin	23	2	20	072	Domeyrot	223	9	232
74	Limousin	23	1	03	073	Dontreix	396	22	418
74	Limousin	23	1	23	074	Le Donzeil	176	5	181
74	Limousin	23	2	14	075	Dun-le-Palestel	1192	24	1216
74	Limousin	23	1	15	076	Évaux-les-Bains	1457	59	1516
74	Limousin	23	1	17	077	Faux-la-Montagne	362	9	371
74	Limousin	23	2	07	078	Faux-Mazuras	170	7	177
74	Limousin	23	1	16	079	Felletin	1867	286	2153
74	Limousin	23	1	17	080	Féniers	91	3	94
74	Limousin	23	1	13	081	Flayat	332	15	347
74	Limousin	23	2	18	082	Fleurat	281	2	283
74	Limousin	23	1	15	083	Fontanières	263	3	266
74	Limousin	23	2	06	084	La Forêt-du-Temple	145	8	153
74	Limousin	23	1	23	086	Fransèches	246	14	260
74	Limousin	23	2	14	087	Fresselines	603	18	621
74	Limousin	23	2	24	088	Gartempe	125	0	125
74	Limousin	23	2	10	089	Genouillac	801	13	814
74	Limousin	23	1	17	090	Gentioux-Pigerolles	388	14	402
74	Limousin	23	1	17	091	Gioux	174	7	181
74	Limousin	23	2	19	092	Glénic	610	19	629
74	Limousin	23	2	20	093	Gouzon	1511	60	1571
74	Limousin	23	2	18	095	Le Grand-Bourg	1211	49	1260
74	Limousin	23	2	98	096	Guéret	13573	1004	14577
74	Limousin	23	1	11	097	Issoudun-Létrieix	299	13	312
74	Limousin	23	2	10	098	Jalesches	81	1	82
74	Limousin	23	2	21	099	Janaillat	360	7	367
74	Limousin	23	2	20	100	Jarnages	519	10	529
74	Limousin	23	2	19	101	Jouillat	470	8	478
74	Limousin	23	2	19	102	Ladapeyre	346	6	352
74	Limousin	23	2	14	103	Lafat	383	8	391
74	Limousin	23	2	08	104	Lavaufranche	245	4	249
74	Limousin	23	1	11	105	Lavaveix-les-Mines	761	58	819
74	Limousin	23	1	09	106	Lépaud	389	8	397
74	Limousin	23	2	01	107	Lépinas	171	2	173
74	Limousin	23	2	08	108	Leyrat	155	5	160
74	Limousin	23	2	06	109	Linard	166	4	170
74	Limousin	23	1	03	110	Lioux-les-Monges	50	3	53
74	Limousin	23	2	18	111	Lizières	283	9	292
74	Limousin	23	2	06	112	Lourdoueix-Saint-Pierre	804	19	823
74	Limousin	23	1	04	113	Lupersat	331	13	344
74	Limousin	23	1	09	114	Lussat	455	10	465
74	Limousin	23	1	12	115	Magnat-l;Étrange	227	8	235
74	Limousin	23	1	04	116	Mainsat	610	24	634
74	Limousin	23	2	14	117	Maison-Feyne	300	9	309
74	Limousin	23	2	01	118	Maisonnisses	205	5	210
74	Limousin	23	1	12	119	Malleret	38	2	40
74	Limousin	23	2	08	120	Malleret-Boussac	244	6	250
74	Limousin	23	2	06	121	Malval	46	0	46
74	Limousin	23	2	07	122	Mansat-la-Courrière	87	3	90
74	Limousin	23	1	03	123	Les Mars	202	5	207
74	Limousin	23	2	05	124	Marsac	679	16	695
74	Limousin	23	1	12	125	Le Mas-d;Artige	103	2	105
74	Limousin	23	2	07	126	Masbaraud-Mérignat	374	8	382
74	Limousin	23	1	04	127	Mautes	229	3	232
74	Limousin	23	2	01	128	Mazeirat	137	5	142
74	Limousin	23	1	13	129	La Mazière-aux-Bons-Hommes	67	1	68
74	Limousin	23	2	06	130	Méasnes	584	7	591
74	Limousin	23	1	13	131	Mérinchal	745	28	773
74	Limousin	23	2	24	132	Montaigut-le-Blanc	387	5	392
74	Limousin	23	2	07	133	Montboucher	360	31	391
74	Limousin	23	1	22	134	Le Monteil-au-Vicomte	215	44	259
74	Limousin	23	2	06	136	Mortroux	304	8	312
74	Limousin	23	2	05	137	Mourioux-Vieilleville	535	8	543
74	Limousin	23	2	01	138	Moutier-d;Ahun	157	6	163
74	Limousin	23	2	06	139	Moutier-Malcard	545	4	549
74	Limousin	23	1	16	140	Moutier-Rozeille	433	9	442
74	Limousin	23	2	14	141	Naillat	670	14	684
74	Limousin	23	1	02	142	Néoux	299	13	312
74	Limousin	23	2	25	143	Noth	519	7	526
74	Limousin	23	1	17	144	La Nouaille	251	3	254
74	Limousin	23	1	09	145	Nouhant	315	4	319
74	Limousin	23	2	08	146	Nouzerines	251	3	254
74	Limousin	23	2	06	147	Nouzerolles	104	2	106
74	Limousin	23	2	10	148	Nouziers	241	5	246
74	Limousin	23	2	20	149	Parsac	591	15	606
74	Limousin	23	2	01	150	Peyrabout	139	5	144
74	Limousin	23	1	11	151	Peyrat-la-Nonière	474	8	482
74	Limousin	23	2	20	152	Pierrefitte	75	5	80
74	Limousin	23	2	01	154	Pionnat	763	7	770
74	Limousin	23	2	21	155	Pontarion	358	12	370
74	Limousin	23	1	13	156	Pontcharraud	79	0	79
74	Limousin	23	2	21	157	La Pouge	82	1	83
74	Limousin	23	1	16	158	Poussanges	143	2	145
74	Limousin	23	1	11	159	Puy-Malsignat	161	1	162
74	Limousin	23	1	15	160	Reterre	308	4	312
74	Limousin	23	2	20	161	Rimondeix	83	3	86
74	Limousin	23	2	10	162	Roches	380	5	385
74	Limousin	23	1	03	164	Rougnat	531	15	546
74	Limousin	23	1	22	165	Royère-de-Vassivière	561	19	580
74	Limousin	23	2	14	166	Sagnat	198	8	206
74	Limousin	23	2	25	177	Saint-Agnant-de-Versillat	1139	40	1179
74	Limousin	23	1	13	178	Saint-Agnant-près-Crocq	208	4	212
74	Limousin	23	1	02	179	Saint-Alpinien	300	2	302
74	Limousin	23	1	02	180	Saint-Amand	513	14	527
74	Limousin	23	2	07	181	Saint-Amand-Jartoudeix	171	4	175
74	Limousin	23	1	02	182	Saint-Avit-de-Tardes	188	3	191
74	Limousin	23	1	23	183	Saint-Avit-le-Pauvre	73	3	76
74	Limousin	23	1	13	184	Saint-Bard	106	1	107
74	Limousin	23	1	11	185	Saint-Chabrais	320	26	346
74	Limousin	23	2	27	186	Saint-Christophe	130	7	137
74	Limousin	23	1	11	187	Saint-Dizier-la-Tour	219	8	227
74	Limousin	23	2	10	188	Saint-Dizier-les-Domaines	187	7	194
74	Limousin	23	2	07	189	Saint-Dizier-Leyrenne	887	25	912
74	Limousin	23	1	04	190	Saint-Domet	166	9	175
74	Limousin	23	2	21	191	Saint-Éloi	206	3	209
74	Limousin	23	2	18	192	Saint-Étienne-de-Fursac	847	15	862
74	Limousin	23	2	19	195	Saint-Fiel	948	37	985
74	Limousin	23	1	16	196	Saint-Frion	211	2	213
74	Limousin	23	2	21	197	Saint-Georges-la-Pouge	349	5	354
74	Limousin	23	1	13	198	Saint-Georges-Nigremont	168	5	173
74	Limousin	23	2	25	199	Saint-Germain-Beaupré	436	6	442
74	Limousin	23	2	05	200	Saint-Goussaud	199	1	200
74	Limousin	23	2	01	201	Saint-Hilaire-la-Plaine	209	4	213
74	Limousin	23	2	21	202	Saint-Hilaire-le-Château	259	8	267
74	Limousin	23	1	15	203	Saint-Julien-la-Genête	241	4	245
74	Limousin	23	1	09	204	Saint-Julien-le-Châtel	168	0	168
74	Limousin	23	1	22	205	Saint-Junien-la-Bregère	147	4	151
74	Limousin	23	2	26	206	Saint-Laurent	646	15	661
74	Limousin	23	2	25	207	Saint-Léger-Bridereix	198	8	206
74	Limousin	23	2	24	208	Saint-Léger-le-Guérétois	430	7	437
74	Limousin	23	1	09	209	Saint-Loup	174	2	176
74	Limousin	23	1	02	210	Saint-Maixant	225	11	236
74	Limousin	23	1	02	211	Saint-Marc-à-Frongier	367	8	375
74	Limousin	23	1	17	212	Saint-Marc-à-Loubaud	137	4	141
74	Limousin	23	2	08	213	Saint-Marien	184	7	191
74	Limousin	23	1	23	214	Saint-Martial-le-Mont	239	10	249
74	Limousin	23	1	12	215	Saint-Martial-le-Vieux	129	1	130
74	Limousin	23	1	22	216	Saint-Martin-Château	159	6	165
74	Limousin	23	2	07	217	Saint-Martin-Sainte-Catherine	331	5	336
74	Limousin	23	2	25	219	Saint-Maurice-la-Souterraine	1206	23	1229
74	Limousin	23	1	13	218	Saint-Maurice-près-Crocq	117	1	118
74	Limousin	23	1	11	220	Saint-Médard-la-Rochette	570	15	585
74	Limousin	23	1	12	221	Saint-Merd-la-Breuille	204	5	209
74	Limousin	23	1	23	222	Saint-Michel-de-Veisse	168	5	173
74	Limousin	23	1	22	223	Saint-Moreil	238	3	241
74	Limousin	23	1	12	224	Saint-Oradoux-de-Chirouze	89	1	90
74	Limousin	23	1	13	225	Saint-Oradoux-près-Crocq	116	5	121
74	Limousin	23	1	13	226	Saint-Pardoux-d;Arnet	163	7	170
74	Limousin	23	1	02	228	Saint-Pardoux-le-Neuf	178	8	186
74	Limousin	23	1	11	229	Saint-Pardoux-les-Cards	296	10	306
74	Limousin	23	1	22	227	Saint-Pardoux-Morterolles	218	6	224
74	Limousin	23	1	22	232	Saint-Pierre-Bellevue	229	9	238
74	Limousin	23	2	07	230	Saint-Pierre-Chérignat	184	2	186
74	Limousin	23	2	18	231	Saint-Pierre-de-Fursac	794	28	822
74	Limousin	23	2	08	233	Saint-Pierre-le-Bost	148	4	152
74	Limousin	23	1	15	234	Saint-Priest	164	9	173
74	Limousin	23	2	25	235	Saint-Priest-la-Feuille	758	21	779
74	Limousin	23	2	18	236	Saint-Priest-la-Plaine	246	6	252
74	Limousin	23	2	07	237	Saint-Priest-Palus	44	2	46
74	Limousin	23	1	16	238	Saint-Quentin-la-Chabanne	359	13	372
74	Limousin	23	2	14	239	Saint-Sébastien	694	20	714
74	Limousin	23	2	08	240	Saint-Silvain-Bas-le-Roc	498	9	507
74	Limousin	23	1	04	241	Saint-Silvain-Bellegarde	210	6	216
74	Limousin	23	2	24	242	Saint-Silvain-Montaigut	184	1	185
74	Limousin	23	2	20	243	Saint-Silvain-sous-Toulx	153	5	158
74	Limousin	23	2	14	244	Saint-Sulpice-le-Dunois	648	7	655
74	Limousin	23	2	24	245	Saint-Sulpice-le-Guérétois	2008	71	2079
74	Limousin	23	1	23	246	Saint-Sulpice-les-Champs	386	12	398
74	Limousin	23	2	24	247	Saint-Vaury	1806	119	1925
74	Limousin	23	2	27	248	Saint-Victor-en-Marche	361	13	374
74	Limousin	23	1	16	249	Saint-Yrieix-la-Montagne	218	4	222
74	Limousin	23	2	01	250	Saint-Yrieix-les-Bois	300	8	308
74	Limousin	23	2	26	193	Sainte-Feyre	2302	69	2371
74	Limousin	23	1	16	194	Sainte-Feyre-la-Montagne	129	3	132
74	Limousin	23	1	15	167	Sannat	389	4	393
74	Limousin	23	2	21	168	Sardent	785	32	817
74	Limousin	23	2	26	169	La Saunière	645	21	666
74	Limousin	23	2	27	170	Savennes	216	11	227
74	Limousin	23	1	03	171	Sermur	119	4	123
74	Limousin	23	1	11	172	La Serre-Bussière-Vieille	123	3	126
74	Limousin	23	2	07	173	Soubrebost	129	1	130
74	Limousin	23	2	08	174	Soumans	582	17	599
74	Limousin	23	1	23	175	Sous-Parsat	141	5	146
74	Limousin	23	2	25	176	La Souterraine	5522	233	5755
74	Limousin	23	1	09	251	Tardes	145	1	146
74	Limousin	23	2	10	252	Tercillat	166	9	175
74	Limousin	23	2	21	253	Thauron	184	4	188
74	Limousin	23	2	08	254	Toulx-Sainte-Croix	297	5	302
74	Limousin	23	2	20	255	Trois-Fonds	116	0	116
74	Limousin	23	1	16	257	Vallière	766	18	784
74	Limousin	23	2	25	258	Vareilles	308	10	318
74	Limousin	23	1	09	259	Verneiges	101	0	101
74	Limousin	23	2	21	260	Vidaillat	169	1	170
74	Limousin	23	1	09	261	Viersat	311	5	316
74	Limousin	23	2	01	262	Vigeville	150	0	150
74	Limousin	23	2	14	263	Villard	346	3	349
74	Limousin	23	1	17	264	La Villedieu	43	4	47
74	Limousin	23	1	13	265	La Villeneuve	83	3	86
74	Limousin	23	1	13	266	La Villetelle	164	4	168
72	Aquitaine	24	2	26	001	Abjat-sur-Bandiat	650	18	668
72	Aquitaine	24	3	04	002	Agonac	1643	35	1678
72	Aquitaine	24	3	40	004	Ajat	328	3	331
72	Aquitaine	24	4	32	006	Allas-les-Mines	204	3	207
72	Aquitaine	24	3	28	007	Allemans	578	18	596
72	Aquitaine	24	1	07	005	Alles-sur-Dordogne	350	8	358
72	Aquitaine	24	2	18	008	Angoisse	616	9	625
72	Aquitaine	24	3	11	009	Anlhiac	290	5	295
72	Aquitaine	24	3	30	010	Annesse-et-Beaulieu	1486	42	1528
72	Aquitaine	24	3	37	011	Antonne-et-Trigonant	1211	36	1247
72	Aquitaine	24	4	35	012	Archignac	340	6	346
72	Aquitaine	24	3	34	013	Atur	1787	43	1830
72	Aquitaine	24	4	22	014	Aubas	616	14	630
72	Aquitaine	24	4	32	015	Audrix	290	11	301
72	Aquitaine	24	2	26	016	Augignac	836	23	859
72	Aquitaine	24	4	22	018	Auriac-du-Périgord	419	14	433
72	Aquitaine	24	3	40	019	Azerat	422	5	427
72	Aquitaine	24	4	39	020	La Bachellerie	903	20	923
72	Aquitaine	24	3	13	021	Badefols-d;Ans	471	17	488
72	Aquitaine	24	1	07	022	Badefols-sur-Dordogne	216	5	221
72	Aquitaine	24	1	17	023	Baneuil	345	5	350
72	Aquitaine	24	1	14	024	Bardou	42	0	42
72	Aquitaine	24	3	40	025	Bars	232	13	245
72	Aquitaine	24	3	34	026	Bassillac	1795	32	1827
72	Aquitaine	24	1	01	027	Bayac	357	6	363
72	Aquitaine	24	1	01	028	Beaumont-du-Périgord	1115	26	1141
72	Aquitaine	24	3	24	029	Beaupouyet	471	4	475
72	Aquitaine	24	4	39	030	Beauregard-de-Terrasson	708	15	723
72	Aquitaine	24	1	45	031	Beauregard-et-Bassac	282	1	283
72	Aquitaine	24	3	25	032	Beauronne	331	7	338
72	Aquitaine	24	2	19	033	Beaussac	185	3	188
72	Aquitaine	24	1	45	034	Beleymas	249	8	257
72	Aquitaine	24	4	02	035	Belvès	1450	50	1500
72	Aquitaine	24	4	32	036	Berbiguières	173	12	185
72	Aquitaine	24	1	96	037	Bergerac	27648	1043	28691
72	Aquitaine	24	3	44	038	Bertric-Burée	421	13	434
72	Aquitaine	24	4	47	039	Besse	154	5	159
72	Aquitaine	24	4	36	040	Beynac-et-Cazenac	532	15	547
72	Aquitaine	24	4	32	041	Bézenac	132	0	132
72	Aquitaine	24	3	04	042	Biras	586	5	591
72	Aquitaine	24	1	20	043	Biron	185	4	189
72	Aquitaine	24	3	34	044	Blis-et-Born	417	8	425
72	Aquitaine	24	1	14	045	Boisse	244	3	247
72	Aquitaine	24	3	13	046	Boisseuilh	119	1	120
72	Aquitaine	24	3	40	047	La Boissière-d;Ans	230	0	230
72	Aquitaine	24	1	42	048	Bonneville-et-Saint-Avit-de-Fumadières	308	9	317
72	Aquitaine	24	4	35	050	Borrèze	341	14	355
72	Aquitaine	24	1	16	051	Bosset	199	5	204
72	Aquitaine	24	1	07	052	Bouillac	125	3	128
72	Aquitaine	24	3	34	053	Boulazac	6606	256	6862
72	Aquitaine	24	1	14	054	Bouniagues	517	17	534
72	Aquitaine	24	3	04	055	Bourdeilles	769	19	788
72	Aquitaine	24	2	26	056	Le Bourdeix	252	1	253
72	Aquitaine	24	3	44	057	Bourg-des-Maisons	64	0	64
72	Aquitaine	24	3	28	058	Bourg-du-Bost	240	3	243
72	Aquitaine	24	3	24	059	Bourgnac	307	9	316
72	Aquitaine	24	1	01	060	Bourniquel	68	2	70
72	Aquitaine	24	3	43	061	Bourrou	142	2	144
72	Aquitaine	24	3	44	062	Bouteilles-Saint-Sébastien	192	5	197
72	Aquitaine	24	4	10	063	Bouzic	140	2	142
72	Aquitaine	24	3	04	064	Brantôme	2152	28	2180
72	Aquitaine	24	3	43	065	Breuilh	238	7	245
72	Aquitaine	24	3	40	066	Brouchaud	209	2	211
72	Aquitaine	24	4	05	067	Le Bugue	2762	56	2818
72	Aquitaine	24	1	07	068	Le Buisson-de-Cadouin	2119	54	2173
72	Aquitaine	24	3	04	069	Bussac	370	4	374
72	Aquitaine	24	2	06	070	Busserolles	561	4	565
72	Aquitaine	24	2	06	071	Bussière-Badil	466	2	468
72	Aquitaine	24	1	07	073	Calès	374	7	381
72	Aquitaine	24	4	08	074	Calviac-en-Périgord	501	6	507
72	Aquitaine	24	4	47	075	Campagnac-lès-Quercy	310	7	317
72	Aquitaine	24	4	05	076	Campagne	388	6	394
72	Aquitaine	24	1	45	077	Campsegret	398	10	408
72	Aquitaine	24	2	09	079	Cantillac	194	5	199
72	Aquitaine	24	1	20	080	Capdrot	508	9	517
72	Aquitaine	24	4	08	081	Carlux	652	24	676
72	Aquitaine	24	4	08	082	Carsac-Aillac	1502	41	1543
72	Aquitaine	24	1	46	083	Carsac-de-Gurson	196	10	206
72	Aquitaine	24	4	02	084	Carves	110	4	114
72	Aquitaine	24	4	39	085	La Cassagne	157	2	159
72	Aquitaine	24	4	10	086	Castelnaud-la-Chapelle	475	8	483
72	Aquitaine	24	4	32	087	Castels	644	9	653
72	Aquitaine	24	1	17	088	Cause-de-Clérans	326	5	331
72	Aquitaine	24	4	08	089	Cazoulès	446	10	456
72	Aquitaine	24	3	21	090	Celles	555	9	564
72	Aquitaine	24	4	10	091	Cénac-et-Saint-Julien	1206	31	1237
72	Aquitaine	24	3	43	092	Cendrieux	566	14	580
72	Aquitaine	24	3	44	093	Cercles	194	4	198
72	Aquitaine	24	3	43	094	Chalagnac	392	7	399
72	Aquitaine	24	2	15	095	Chalais	435	17	452
72	Aquitaine	24	2	09	096	Champagnac-de-Belair	696	21	717
72	Aquitaine	24	3	44	097	Champagne-et-Fontaine	395	12	407
72	Aquitaine	24	3	49	098	Champcevinel	2630	80	2710
72	Aquitaine	24	2	19	099	Champeaux-et-la-Chapelle-Pommier	157	3	160
72	Aquitaine	24	2	06	100	Champniers-et-Reilhac	501	6	507
72	Aquitaine	24	2	33	101	Champs-Romain	312	8	320
72	Aquitaine	24	3	50	102	Chancelade	4227	138	4365
72	Aquitaine	24	3	37	103	Le Change	599	10	609
72	Aquitaine	24	3	25	104	Chantérac	544	14	558
72	Aquitaine	24	3	21	105	Chapdeuil	142	1	143
72	Aquitaine	24	4	22	106	La Chapelle-Aubareil	483	4	487
72	Aquitaine	24	2	09	107	La Chapelle-Faucher	394	6	400
72	Aquitaine	24	3	30	108	La Chapelle-Gonaguet	1076	27	1103
72	Aquitaine	24	3	44	109	La Chapelle-Grésignac	118	4	122
72	Aquitaine	24	3	44	110	La Chapelle-Montabourlet	67	3	70
72	Aquitaine	24	2	09	111	La Chapelle-Montmoreau	74	1	75
72	Aquitaine	24	3	13	113	La Chapelle-Saint-Jean	87	1	88
72	Aquitaine	24	3	28	114	Chassaignes	81	0	81
72	Aquitaine	24	3	49	115	Château-l;Évêque	2086	41	2127
72	Aquitaine	24	4	39	116	Châtres	184	1	185
72	Aquitaine	24	4	39	117	Chavagnac	348	9	357
72	Aquitaine	24	3	31	118	Chenaud	319	25	344
72	Aquitaine	24	3	44	119	Cherval	284	6	290
72	Aquitaine	24	3	13	120	Cherveix-Cubas	625	21	646
72	Aquitaine	24	3	13	121	Chourgnac	72	1	73
72	Aquitaine	24	4	02	122	Cladech	93	3	96
72	Aquitaine	24	3	11	124	Clermont-d;Excideuil	258	7	265
72	Aquitaine	24	1	45	123	Clermont-de-Beauregard	122	6	128
72	Aquitaine	24	1	14	126	Colombier	242	7	249
72	Aquitaine	24	4	39	127	Coly	224	4	228
72	Aquitaine	24	3	28	128	Comberanche-et-Épeluche	178	4	182
72	Aquitaine	24	2	09	129	Condat-sur-Trincou	491	7	498
72	Aquitaine	24	4	39	130	Condat-sur-Vézère	879	15	894
72	Aquitaine	24	1	14	132	Conne-de-Labarde	227	11	238
72	Aquitaine	24	2	26	131	Connezac	79	4	83
72	Aquitaine	24	2	15	133	La Coquille	1355	18	1373
72	Aquitaine	24	2	41	134	Corgnac-sur-l;Isle	799	21	820
72	Aquitaine	24	3	37	135	Cornille	668	18	686
72	Aquitaine	24	3	13	136	Coubjours	154	3	157
72	Aquitaine	24	3	37	137	Coulaures	733	127	860
72	Aquitaine	24	3	50	138	Coulounieix-Chamiers	8356	434	8790
72	Aquitaine	24	1	48	140	Cours-de-Pile	1470	37	1507
72	Aquitaine	24	3	30	139	Coursac	1914	34	1948
72	Aquitaine	24	3	44	141	Coutures	190	2	192
72	Aquitaine	24	4	32	142	Coux-et-Bigaroque	987	28	1015
72	Aquitaine	24	1	17	143	Couze-et-Saint-Front	765	27	792
72	Aquitaine	24	3	21	144	Creyssac	93	5	98
72	Aquitaine	24	1	48	145	Creysse	1854	49	1903
72	Aquitaine	24	3	43	146	Creyssensac-et-Pissot	232	7	239
72	Aquitaine	24	3	37	147	Cubjac	709	29	738
72	Aquitaine	24	1	38	148	Cunèges	304	9	313
72	Aquitaine	24	4	10	150	Daglan	555	15	570
72	Aquitaine	24	4	02	151	Doissat	126	2	128
72	Aquitaine	24	4	10	152	Domme	998	17	1015
72	Aquitaine	24	4	39	153	La Dornac	410	17	427
72	Aquitaine	24	3	21	154	Douchapt	302	5	307
72	Aquitaine	24	1	45	155	Douville	447	6	453
72	Aquitaine	24	3	34	156	La Douze	1069	10	1079
72	Aquitaine	24	3	25	157	Douzillac	802	20	822
72	Aquitaine	24	2	18	158	Dussac	399	7	406
72	Aquitaine	24	3	23	159	Échourgnac	416	5	421
72	Aquitaine	24	1	45	161	Église-Neuve-d;Issac	128	1	129
72	Aquitaine	24	3	43	160	Église-Neuve-de-Vergt	435	10	445
72	Aquitaine	24	3	37	162	Escoire	459	13	472
72	Aquitaine	24	2	06	163	Étouars	144	2	146
72	Aquitaine	24	3	11	164	Excideuil	1226	46	1272
72	Aquitaine	24	3	23	165	Eygurande-et-Gardedeuil	377	9	386
72	Aquitaine	24	3	34	166	Eyliac	739	13	752
72	Aquitaine	24	1	12	167	Eymet	2570	83	2653
72	Aquitaine	24	3	04	170	Eyvirat	277	9	286
72	Aquitaine	24	2	41	171	Eyzerac	577	5	582
72	Aquitaine	24	4	32	172	Les Eyzies-de-Tayac-Sireuil	832	14	846
72	Aquitaine	24	4	22	174	Fanlac	138	2	140
72	Aquitaine	24	4	22	175	Les Farges	323	14	337
72	Aquitaine	24	1	14	176	Faurilles	46	2	48
72	Aquitaine	24	1	14	177	Faux	583	14	597
72	Aquitaine	24	3	31	178	Festalemps	254	12	266
72	Aquitaine	24	4	39	179	La Feuillade	739	15	754
72	Aquitaine	24	2	33	180	Firbeix	303	7	310
72	Aquitaine	24	1	38	181	Flaugeac	320	7	327
72	Aquitaine	24	1	16	182	Le Fleix	1433	72	1505
72	Aquitaine	24	4	05	183	Fleurac	240	10	250
72	Aquitaine	24	4	10	184	Florimont-Gaumier	143	0	143
72	Aquitaine	24	1	12	186	Fonroque	267	6	273
72	Aquitaine	24	1	16	222	La Force	2520	109	2629
72	Aquitaine	24	3	40	188	Fossemagne	605	4	609
72	Aquitaine	24	1	42	189	Fougueyrolles	472	11	483
72	Aquitaine	24	3	43	190	Fouleix	221	1	222
72	Aquitaine	24	1	16	191	Fraisse	141	3	144
72	Aquitaine	24	3	40	192	Gabillou	92	1	93
72	Aquitaine	24	1	38	193	Gageac-et-Rouillac	442	17	459
72	Aquitaine	24	1	38	194	Gardonne	1469	32	1501
72	Aquitaine	24	1	20	195	Gaugeac	112	0	112
72	Aquitaine	24	3	11	196	Génis	482	11	493
72	Aquitaine	24	1	16	197	Ginestet	794	31	825
72	Aquitaine	24	2	09	198	La Gonterie-Boulouneix	241	3	244
72	Aquitaine	24	3	44	199	Gout-Rossignol	401	6	407
72	Aquitaine	24	3	21	200	Grand-Brassac	527	8	535
72	Aquitaine	24	3	13	202	Granges-d;Ans	164	9	173
72	Aquitaine	24	2	19	203	Les Graulges	68	3	71
72	Aquitaine	24	4	39	204	Grèzes	191	3	194
72	Aquitaine	24	3	30	205	Grignols	584	4	588
72	Aquitaine	24	4	02	206	Grives	113	3	116
72	Aquitaine	24	4	10	207	Groléjac	645	20	665
72	Aquitaine	24	3	43	208	Grun-Bordas	213	3	216
72	Aquitaine	24	2	26	209	Hautefaye	114	2	116
72	Aquitaine	24	3	13	210	Hautefort	1073	23	1096
72	Aquitaine	24	1	45	211	Issac	383	10	393
72	Aquitaine	24	1	14	212	Issigeac	708	24	732
72	Aquitaine	24	3	30	213	Jaure	145	1	146
72	Aquitaine	24	2	26	214	Javerlhac-et-la-Chapelle-Saint-Robert	907	15	922
72	Aquitaine	24	4	35	215	Jayac	186	3	189
72	Aquitaine	24	3	31	216	La Jemaye	108	2	110
72	Aquitaine	24	4	05	217	Journiac	414	10	424
72	Aquitaine	24	2	15	218	Jumilhac-le-Grand	1214	50	1264
72	Aquitaine	24	1	01	219	Labouquerie	223	0	223
72	Aquitaine	24	3	43	220	Lacropte	639	11	650
72	Aquitaine	24	1	17	223	Lalinde	2959	61	3020
72	Aquitaine	24	1	48	224	Lamonzie-Montastruc	665	3	668
72	Aquitaine	24	1	38	225	Lamonzie-Saint-Martin	2333	43	2376
72	Aquitaine	24	1	42	226	Lamothe-Montravel	1238	40	1278
72	Aquitaine	24	2	18	227	Lanouaille	990	12	1002
72	Aquitaine	24	1	17	228	Lanquais	542	17	559
72	Aquitaine	24	4	39	229	Le Lardin-Saint-Lazare	1907	32	1939
72	Aquitaine	24	4	02	230	Larzac	137	2	139
72	Aquitaine	24	1	20	231	Lavalade	106	1	107
72	Aquitaine	24	4	47	232	Lavaur	79	1	80
72	Aquitaine	24	1	45	233	Laveyssière	121	12	133
72	Aquitaine	24	1	16	234	Les Lèches	321	12	333
72	Aquitaine	24	2	19	235	Léguillac-de-Cercles	301	5	306
72	Aquitaine	24	3	30	236	Léguillac-de-l;Auche	916	8	924
72	Aquitaine	24	1	48	237	Lembras	1229	30	1259
72	Aquitaine	24	2	41	238	Lempzours	160	6	166
72	Aquitaine	24	3	37	239	Ligueux	268	6	274
72	Aquitaine	24	1	29	240	Limeuil	325	12	337
72	Aquitaine	24	3	40	241	Limeyrat	453	7	460
72	Aquitaine	24	1	17	242	Liorac-sur-Louyre	224	7	231
72	Aquitaine	24	3	04	243	Lisle	928	20	948
72	Aquitaine	24	1	20	244	Lolme	132	2	134
72	Aquitaine	24	4	47	245	Loubejac	262	6	268
72	Aquitaine	24	1	16	246	Lunas	363	9	372
72	Aquitaine	24	3	44	247	Lusignac	189	1	190
72	Aquitaine	24	2	26	248	Lussas-et-Nontronneau	314	11	325
72	Aquitaine	24	4	05	249	Manaurie	155	5	160
72	Aquitaine	24	3	30	251	Manzac-sur-Vern	566	15	581
72	Aquitaine	24	4	36	252	Marcillac-Saint-Quentin	801	18	819
72	Aquitaine	24	2	19	253	Mareuil	1125	21	1146
72	Aquitaine	24	4	32	254	Marnac	186	5	191
72	Aquitaine	24	4	36	255	Marquay	572	13	585
72	Aquitaine	24	3	50	256	Marsac-sur-l;Isle	2956	89	3045
72	Aquitaine	24	1	20	257	Marsalès	233	3	236
72	Aquitaine	24	3	34	258	Marsaneix	1028	36	1064
72	Aquitaine	24	1	45	259	Maurens	1048	34	1082
72	Aquitaine	24	1	17	260	Mauzac-et-Grand-Castang	862	8	870
72	Aquitaine	24	4	05	261	Mauzens-et-Miremont	322	9	331
72	Aquitaine	24	3	37	262	Mayac	301	9	310
72	Aquitaine	24	4	47	263	Mazeyrolles	350	6	356
72	Aquitaine	24	3	23	264	Ménesplet	1679	28	1707
72	Aquitaine	24	3	30	266	Mensignac	1465	47	1512
72	Aquitaine	24	1	38	267	Mescoules	164	1	165
72	Aquitaine	24	4	32	268	Meyrals	575	20	595
72	Aquitaine	24	2	33	269	Mialet	662	9	671
72	Aquitaine	24	3	34	270	Milhac-d;Auberoche	554	12	566
72	Aquitaine	24	2	33	271	Milhac-de-Nontron	592	7	599
72	Aquitaine	24	1	46	272	Minzac	446	4	450
72	Aquitaine	24	1	07	273	Molières	317	3	320
72	Aquitaine	24	1	38	274	Monbazillac	922	121	1043
72	Aquitaine	24	1	38	276	Monestier	386	11	397
72	Aquitaine	24	1	16	277	Monfaucon	279	13	292
72	Aquitaine	24	1	14	278	Monmadalès	74	0	74
72	Aquitaine	24	1	14	279	Monmarvès	58	1	59
72	Aquitaine	24	1	20	280	Monpazier	516	17	533
72	Aquitaine	24	4	02	293	Monplaisant	276	10	286
72	Aquitaine	24	1	01	281	Monsac	189	5	194
72	Aquitaine	24	1	14	282	Monsaguel	164	7	171
72	Aquitaine	24	2	19	283	Monsec	197	1	198
72	Aquitaine	24	3	40	284	Montagnac-d;Auberoche	144	5	149
72	Aquitaine	24	1	45	285	Montagnac-la-Crempse	378	6	384
72	Aquitaine	24	3	21	286	Montagrier	503	10	513
72	Aquitaine	24	1	14	287	Montaut	113	3	116
72	Aquitaine	24	1	42	288	Montazeau	312	6	318
72	Aquitaine	24	1	42	289	Montcaret	1423	30	1453
72	Aquitaine	24	1	01	290	Montferrand-du-Périgord	177	3	180
72	Aquitaine	24	4	22	291	Montignac	2783	77	2860
72	Aquitaine	24	1	46	292	Montpeyroux	440	7	447
72	Aquitaine	24	3	23	294	Montpon-Ménestérol	5465	89	5554
72	Aquitaine	24	3	30	295	Montrem	1244	18	1262
72	Aquitaine	24	1	48	296	Mouleydier	1095	20	1115
72	Aquitaine	24	1	46	297	Moulin-Neuf	882	11	893
72	Aquitaine	24	4	32	298	Mouzens	241	7	248
72	Aquitaine	24	3	24	299	Mussidan	2864	66	2930
72	Aquitaine	24	4	10	300	Nabirat	377	4	381
72	Aquitaine	24	4	35	301	Nadaillac	340	7	347
72	Aquitaine	24	3	13	302	Nailhac	297	3	300
72	Aquitaine	24	3	44	303	Nanteuil-Auriac-de-Bourzac	255	5	260
72	Aquitaine	24	2	41	304	Nantheuil	1057	15	1072
72	Aquitaine	24	2	18	305	Nanthiat	282	6	288
72	Aquitaine	24	1	42	306	Nastringues	114	5	119
72	Aquitaine	24	1	01	307	Naussannes	218	3	221
72	Aquitaine	24	3	37	308	Négrondes	838	10	848
72	Aquitaine	24	3	25	309	Neuvic	3635	116	3751
72	Aquitaine	24	1	01	310	Nojals-et-Clotte	206	6	212
72	Aquitaine	24	2	26	311	Nontron	3351	165	3516
72	Aquitaine	24	3	34	312	Notre-Dame-de-Sanilhac	3059	80	3139
72	Aquitaine	24	4	47	313	Orliac	58	1	59
72	Aquitaine	24	4	08	314	Orliaguet	91	5	96
72	Aquitaine	24	3	31	316	Parcoul	375	1	376
72	Aquitaine	24	4	35	317	Paulin	271	9	280
72	Aquitaine	24	1	29	318	Paunat	314	9	323
72	Aquitaine	24	3	21	319	Paussac-et-Saint-Vivien	445	16	461
72	Aquitaine	24	2	18	320	Payzac	1069	16	1085
72	Aquitaine	24	4	39	321	Pazayac	879	16	895
72	Aquitaine	24	3	97	322	Périgueux	29573	1427	31000
72	Aquitaine	24	3	28	323	Petit-Bersac	171	2	173
72	Aquitaine	24	4	39	324	Peyrignac	530	5	535
72	Aquitaine	24	4	08	325	Peyrillac-et-Millac	217	5	222
72	Aquitaine	24	4	22	326	Peyzac-le-Moustier	171	2	173
72	Aquitaine	24	1	29	327	Pezuls	122	2	124
72	Aquitaine	24	2	06	328	Piégut-Pluviers	1227	34	1261
72	Aquitaine	24	3	23	329	Le Pizou	1261	13	1274
72	Aquitaine	24	1	14	168	Plaisance	453	12	465
72	Aquitaine	24	4	22	330	Plazac	714	32	746
72	Aquitaine	24	1	38	331	Pomport	804	18	822
72	Aquitaine	24	3	31	333	Ponteyraud	53	1	54
72	Aquitaine	24	1	07	334	Pontours	210	4	214
72	Aquitaine	24	1	42	335	Port-Sainte-Foy-et-Ponchapt	2497	77	2574
72	Aquitaine	24	4	08	336	Prats-de-Carlux	507	12	519
72	Aquitaine	24	4	47	337	Prats-du-Périgord	155	2	157
72	Aquitaine	24	1	17	338	Pressignac-Vicq	468	8	476
72	Aquitaine	24	3	11	339	Preyssac-d;Excideuil	155	2	157
72	Aquitaine	24	1	16	340	Prigonrieux	4057	108	4165
72	Aquitaine	24	4	36	341	Proissans	918	24	942
72	Aquitaine	24	3	31	343	Puymangou	94	3	97
72	Aquitaine	24	2	19	344	Puyrenier	58	0	58
72	Aquitaine	24	1	48	345	Queyssac	467	20	487
72	Aquitaine	24	2	09	346	Quinsac	385	6	391
72	Aquitaine	24	1	01	347	Rampieux	136	2	138
72	Aquitaine	24	1	12	348	Razac-d;Eymet	303	7	310
72	Aquitaine	24	1	38	349	Razac-de-Saussignac	352	11	363
72	Aquitaine	24	3	30	350	Razac-sur-l;Isle	2447	54	2501
72	Aquitaine	24	1	38	351	Ribagnac	320	4	324
72	Aquitaine	24	3	28	352	Ribérac	4090	251	4341
72	Aquitaine	24	3	31	354	La Roche-Chalais	2873	56	2929
72	Aquitaine	24	2	19	353	La Rochebeaucourt-et-Argentine	395	7	402
72	Aquitaine	24	4	36	355	La Roque-Gageac	418	14	432
72	Aquitaine	24	1	38	357	Rouffignac-de-Sigoulès	345	9	354
72	Aquitaine	24	4	22	356	Rouffignac-Saint-Cernin-de-Reilhac	1557	40	1597
72	Aquitaine	24	2	19	221	Rudeau-Ladosse	178	3	181
72	Aquitaine	24	1	12	359	Sadillac	107	0	107
72	Aquitaine	24	4	02	360	Sagelat	361	3	364
72	Aquitaine	24	1	17	361	Saint-Agne	416	11	427
72	Aquitaine	24	4	02	363	Saint-Amand-de-Belvès	101	6	107
72	Aquitaine	24	4	22	364	Saint-Amand-de-Coly	394	13	407
72	Aquitaine	24	3	43	365	Saint-Amand-de-Vergt	216	3	219
72	Aquitaine	24	4	36	366	Saint-André-d;Allas	798	20	818
72	Aquitaine	24	3	25	367	Saint-André-de-Double	161	5	166
72	Aquitaine	24	3	31	368	Saint-Antoine-Cumond	390	6	396
72	Aquitaine	24	3	34	369	Saint-Antoine-d;Auberoche	147	0	147
72	Aquitaine	24	1	42	370	Saint-Antoine-de-Breuilh	2081	64	2145
72	Aquitaine	24	3	25	371	Saint-Aquilin	513	5	518
72	Aquitaine	24	3	30	372	Saint-Astier	5469	151	5620
72	Aquitaine	24	1	12	373	Saint-Aubin-de-Cadelech	325	12	337
72	Aquitaine	24	1	14	374	Saint-Aubin-de-Lanquais	295	4	299
72	Aquitaine	24	4	10	375	Saint-Aubin-de-Nabirat	126	3	129
72	Aquitaine	24	3	31	376	Saint-Aulaye	1360	23	1383
72	Aquitaine	24	4	05	377	Saint-Avit-de-Vialard	150	3	153
72	Aquitaine	24	1	20	378	Saint-Avit-Rivière	78	6	84
72	Aquitaine	24	1	01	379	Saint-Avit-Sénieur	451	16	467
72	Aquitaine	24	3	23	380	Saint-Barthélemy-de-Bellegarde	522	6	528
72	Aquitaine	24	2	06	381	Saint-Barthélemy-de-Bussière	233	7	240
72	Aquitaine	24	1	12	383	Saint-Capraise-d;Eymet	139	0	139
72	Aquitaine	24	1	17	382	Saint-Capraise-de-Lalinde	525	33	558
72	Aquitaine	24	1	20	384	Saint-Cassien	28	0	28
72	Aquitaine	24	4	47	386	Saint-Cernin-de-l;Herm	235	10	245
72	Aquitaine	24	1	14	385	Saint-Cernin-de-Labarde	194	13	207
72	Aquitaine	24	4	32	388	Saint-Chamassy	526	14	540
72	Aquitaine	24	4	05	389	Saint-Cirq	113	3	116
72	Aquitaine	24	3	34	390	Saint-Crépin-d;Auberoche	294	5	299
72	Aquitaine	24	2	19	391	Saint-Crépin-de-Richemont	213	6	219
72	Aquitaine	24	4	35	392	Saint-Crépin-et-Carlucet	497	15	512
72	Aquitaine	24	4	10	395	Saint-Cybranet	385	6	391
72	Aquitaine	24	4	32	396	Saint-Cyprien	1571	51	1622
72	Aquitaine	24	2	18	397	Saint-Cyr-les-Champagnes	279	8	287
72	Aquitaine	24	2	26	398	Saint-Estèphe	590	14	604
72	Aquitaine	24	3	24	399	Saint-Étienne-de-Puycorbier	106	1	107
72	Aquitaine	24	2	19	403	Saint-Félix-de-Bourdeilles	70	1	71
72	Aquitaine	24	4	05	404	Saint-Félix-de-Reillac-et-Mortemart	198	3	201
72	Aquitaine	24	1	17	405	Saint-Félix-de-Villadeix	305	3	308
72	Aquitaine	24	3	04	408	Saint-Front-d;Alemps	258	6	264
72	Aquitaine	24	3	24	409	Saint-Front-de-Pradoux	1117	24	1141
72	Aquitaine	24	2	33	410	Saint-Front-la-Rivière	526	7	533
72	Aquitaine	24	2	26	411	Saint-Front-sur-Nizonne	144	5	149
72	Aquitaine	24	4	35	412	Saint-Geniès	960	28	988
72	Aquitaine	24	1	16	413	Saint-Georges-Blancaneix	242	7	249
72	Aquitaine	24	1	45	414	Saint-Georges-de-Montclard	275	8	283
72	Aquitaine	24	1	46	415	Saint-Géraud-de-Corps	188	2	190
72	Aquitaine	24	4	02	416	Saint-Germain-de-Belvès	154	2	156
72	Aquitaine	24	3	11	417	Saint-Germain-des-Prés	519	10	529
72	Aquitaine	24	3	25	418	Saint-Germain-du-Salembre	887	6	893
72	Aquitaine	24	1	48	419	Saint-Germain-et-Mons	757	16	773
72	Aquitaine	24	1	16	420	Saint-Géry	212	6	218
72	Aquitaine	24	3	34	421	Saint-Geyrac	241	6	247
72	Aquitaine	24	1	45	422	Saint-Hilaire-d;Estissac	111	3	114
72	Aquitaine	24	3	25	424	Saint-Jean-d;Ataux	115	2	117
72	Aquitaine	24	1	45	426	Saint-Jean-d;Estissac	154	0	154
72	Aquitaine	24	1	45	427	Saint-Jean-d;Eyraud	190	13	203
72	Aquitaine	24	2	41	425	Saint-Jean-de-Côle	356	5	361
72	Aquitaine	24	2	15	428	Saint-Jory-de-Chalais	595	39	634
72	Aquitaine	24	3	11	429	Saint-Jory-las-Bloux	257	3	260
72	Aquitaine	24	1	12	433	Saint-Julien-d;Eymet	113	4	117
72	Aquitaine	24	3	04	430	Saint-Julien-de-Bourdeilles	79	1	80
72	Aquitaine	24	1	45	431	Saint-Julien-de-Crempse	214	5	219
72	Aquitaine	24	4	08	432	Saint-Julien-de-Lampon	619	9	628
72	Aquitaine	24	3	21	434	Saint-Just	127	4	131
72	Aquitaine	24	1	29	435	Saint-Laurent-des-Bâtons	220	9	229
72	Aquitaine	24	3	24	436	Saint-Laurent-des-Hommes	1050	14	1064
72	Aquitaine	24	1	48	437	Saint-Laurent-des-Vignes	816	26	842
72	Aquitaine	24	4	10	438	Saint-Laurent-la-Vallée	253	11	264
72	Aquitaine	24	3	34	439	Saint-Laurent-sur-Manoire	913	21	934
72	Aquitaine	24	1	14	441	Saint-Léon-d;Issigeac	115	3	118
72	Aquitaine	24	3	30	442	Saint-Léon-sur-l;Isle	2020	30	2050
72	Aquitaine	24	4	22	443	Saint-Léon-sur-Vézère	421	8	429
72	Aquitaine	24	3	24	444	Saint-Louis-en-l;Isle	261	4	265
72	Aquitaine	24	3	43	459	Saint-Maime-de-Péreyrol	274	9	283
72	Aquitaine	24	1	17	445	Saint-Marcel-du-Périgord	152	2	154
72	Aquitaine	24	1	20	446	Saint-Marcory	53	0	53
72	Aquitaine	24	3	11	448	Saint-Martial-d;Albarède	485	10	495
72	Aquitaine	24	3	23	449	Saint-Martial-d;Artenset	973	18	991
72	Aquitaine	24	4	10	450	Saint-Martial-de-Nabirat	670	7	677
72	Aquitaine	24	2	26	451	Saint-Martial-de-Valette	831	17	848
72	Aquitaine	24	3	44	452	Saint-Martial-Viveyrol	206	0	206
72	Aquitaine	24	2	41	453	Saint-Martin-de-Fressengeas	385	8	393
72	Aquitaine	24	1	46	454	Saint-Martin-de-Gurson	606	12	618
72	Aquitaine	24	3	28	455	Saint-Martin-de-Ribérac	697	12	709
72	Aquitaine	24	1	45	456	Saint-Martin-des-Combes	192	2	194
72	Aquitaine	24	3	24	457	Saint-Martin-l;Astier	135	3	138
72	Aquitaine	24	2	26	458	Saint-Martin-le-Pin	296	6	302
72	Aquitaine	24	3	28	460	Saint-Méard-de-Drône	474	8	482
72	Aquitaine	24	1	46	461	Saint-Méard-de-Gurçon	783	29	812
72	Aquitaine	24	3	11	463	Saint-Médard-d;Excideuil	567	19	586
72	Aquitaine	24	3	24	462	Saint-Médard-de-Mussidan	1697	14	1711
72	Aquitaine	24	3	11	464	Saint-Mesmin	266	1	267
72	Aquitaine	24	3	24	465	Saint-Michel-de-Double	266	4	270
72	Aquitaine	24	1	42	466	Saint-Michel-de-Montaigne	363	10	373
72	Aquitaine	24	3	43	468	Saint-Michel-de-Villadeix	303	4	307
72	Aquitaine	24	1	48	472	Saint-Nexans	875	18	893
72	Aquitaine	24	2	09	474	Saint-Pancrace	153	3	156
72	Aquitaine	24	3	37	475	Saint-Pantaly-d;Ans	154	7	161
72	Aquitaine	24	3	11	476	Saint-Pantaly-d;Excideuil	156	5	161
72	Aquitaine	24	3	28	477	Saint-Pardoux-de-Drône	211	4	215
72	Aquitaine	24	4	02	478	Saint-Pardoux-et-Vielvic	191	1	192
72	Aquitaine	24	2	33	479	Saint-Pardoux-la-Rivière	1185	18	1203
72	Aquitaine	24	3	43	480	Saint-Paul-de-Serre	260	7	267
72	Aquitaine	24	2	15	481	Saint-Paul-la-Roche	517	9	526
72	Aquitaine	24	3	44	482	Saint-Paul-Lizonne	316	9	325
72	Aquitaine	24	1	14	483	Saint-Perdoux	137	1	138
72	Aquitaine	24	1	16	487	Saint-Pierre-d;Eyraud	1683	27	1710
72	Aquitaine	24	3	34	484	Saint-Pierre-de-Chignac	814	13	827
72	Aquitaine	24	2	41	485	Saint-Pierre-de-Côle	460	7	467
72	Aquitaine	24	2	15	486	Saint-Pierre-de-Frugie	403	7	410
72	Aquitaine	24	4	10	488	Saint-Pompont	440	9	449
72	Aquitaine	24	2	15	489	Saint-Priest-les-Fougères	395	5	400
72	Aquitaine	24	3	31	490	Saint-Privat-des-Prés	579	12	591
72	Aquitaine	24	4	39	491	Saint-Rabier	555	12	567
72	Aquitaine	24	3	11	493	Saint-Raphaël	110	1	111
72	Aquitaine	24	1	46	494	Saint-Rémy	423	6	429
72	Aquitaine	24	1	20	495	Saint-Romain-de-Monpazier	83	4	87
72	Aquitaine	24	2	41	496	Saint-Romain-et-Saint-Clément	316	9	325
72	Aquitaine	24	2	33	498	Saint-Saud-Lacoussière	868	16	884
72	Aquitaine	24	1	48	499	Saint-Sauveur	775	25	800
72	Aquitaine	24	3	23	500	Saint-Sauveur-Lalande	139	1	140
72	Aquitaine	24	1	42	501	Saint-Seurin-de-Prats	487	11	498
72	Aquitaine	24	3	25	502	Saint-Séverin-d;Estissac	81	3	84
72	Aquitaine	24	2	18	505	Saint-Sulpice-d;Excideuil	317	6	323
72	Aquitaine	24	2	19	503	Saint-Sulpice-de-Mareuil	126	2	128
72	Aquitaine	24	3	28	504	Saint-Sulpice-de-Roumagnac	215	2	217
72	Aquitaine	24	3	21	508	Saint-Victor	197	3	200
72	Aquitaine	24	3	25	509	Saint-Vincent-de-Connezac	561	7	568
72	Aquitaine	24	4	32	510	Saint-Vincent-de-Cosse	365	15	380
72	Aquitaine	24	3	31	511	Saint-Vincent-Jalmoutiers	251	4	255
72	Aquitaine	24	4	36	512	Saint-Vincent-le-Paluel	269	10	279
72	Aquitaine	24	3	37	513	Saint-Vincent-sur-l;Isle	264	6	270
72	Aquitaine	24	1	42	514	Saint-Vivien	287	11	298
72	Aquitaine	24	1	29	362	Sainte-Alvère	886	16	902
72	Aquitaine	24	1	01	393	Sainte-Croix	90	3	93
72	Aquitaine	24	2	19	394	Sainte-Croix-de-Mareuil	136	6	142
72	Aquitaine	24	3	13	401	Sainte-Eulalie-d;Ans	291	25	316
72	Aquitaine	24	1	12	402	Sainte-Eulalie-d;Eymet	75	2	77
72	Aquitaine	24	4	02	406	Sainte-Foy-de-Belvès	131	2	133
72	Aquitaine	24	1	29	407	Sainte-Foy-de-Longas	237	9	246
72	Aquitaine	24	1	12	423	Sainte-Innocence	99	1	100
72	Aquitaine	24	3	34	447	Sainte-Marie-de-Chignac	591	6	597
72	Aquitaine	24	4	08	470	Sainte-Mondane	253	6	259
72	Aquitaine	24	4	36	471	Sainte-Nathalène	574	14	588
72	Aquitaine	24	3	40	473	Sainte-Orse	386	7	393
72	Aquitaine	24	1	14	492	Sainte-Radegonde	56	1	57
72	Aquitaine	24	1	01	497	Sainte-Sabine-Born	381	9	390
72	Aquitaine	24	3	11	507	Sainte-Trie	122	4	126
72	Aquitaine	24	3	11	515	Salagnac	876	18	894
72	Aquitaine	24	4	35	516	Salignac-Eyvigues	1139	67	1206
72	Aquitaine	24	4	02	517	Salles-de-Belvès	80	3	83
72	Aquitaine	24	3	43	518	Salon	238	6	244
72	Aquitaine	24	2	18	519	Sarlande	418	9	427
72	Aquitaine	24	4	36	520	Sarlat-la-Canéda	9739	540	10279
72	Aquitaine	24	3	37	521	Sarliac-sur-l;Isle	1029	25	1054
72	Aquitaine	24	2	18	522	Sarrazac	377	5	382
72	Aquitaine	24	1	38	523	Saussignac	418	12	430
72	Aquitaine	24	4	05	524	Savignac-de-Miremont	160	0	160
72	Aquitaine	24	2	26	525	Savignac-de-Nontron	195	0	195
72	Aquitaine	24	2	18	526	Savignac-Lédrier	734	14	748
72	Aquitaine	24	3	37	527	Savignac-les-Églises	951	42	993
72	Aquitaine	24	2	26	528	Sceau-Saint-Angel	128	4	132
72	Aquitaine	24	3	21	529	Segonzac	208	3	211
72	Aquitaine	24	3	04	530	Sencenac-Puy-de-Fourches	230	2	232
72	Aquitaine	24	4	22	531	Sergeac	212	7	219
72	Aquitaine	24	1	12	532	Serres-et-Montguyard	204	3	207
72	Aquitaine	24	3	31	533	Servanches	80	3	83
72	Aquitaine	24	1	38	534	Sigoulès	838	190	1028
72	Aquitaine	24	4	08	535	Simeyrols	242	5	247
72	Aquitaine	24	1	12	536	Singleyrac	310	3	313
72	Aquitaine	24	3	28	537	Siorac-de-Ribérac	254	2	256
72	Aquitaine	24	4	02	538	Siorac-en-Périgord	1026	23	1049
72	Aquitaine	24	3	37	540	Sorges	1332	21	1353
72	Aquitaine	24	2	06	541	Soudat	84	0	84
72	Aquitaine	24	1	20	542	Soulaures	76	2	78
72	Aquitaine	24	3	24	543	Sourzac	1105	23	1128
72	Aquitaine	24	4	36	544	Tamniès	351	10	361
72	Aquitaine	24	3	13	545	Teillots	117	6	123
72	Aquitaine	24	3	13	546	Temple-Laguyon	46	2	48
72	Aquitaine	24	4	39	547	Terrasson-Lavilledieu	6225	117	6342
72	Aquitaine	24	2	26	548	Teyjat	275	3	278
72	Aquitaine	24	1	38	549	Thénac	374	9	383
72	Aquitaine	24	3	40	550	Thenon	1277	28	1305
72	Aquitaine	24	2	41	551	Thiviers	3095	193	3288
72	Aquitaine	24	4	22	552	Thonac	258	9	267
72	Aquitaine	24	3	21	553	Tocane-Saint-Apre	1680	33	1713
72	Aquitaine	24	3	44	554	La Tour-Blanche	445	7	452
72	Aquitaine	24	3	13	555	Tourtoirac	651	16	667
72	Aquitaine	24	3	49	557	Trélissac	7097	279	7376
72	Aquitaine	24	1	29	558	Trémolat	576	11	587
72	Aquitaine	24	4	32	559	Tursac	321	3	324
72	Aquitaine	24	1	07	560	Urval	151	4	155
72	Aquitaine	24	3	04	561	Valeuil	396	4	400
72	Aquitaine	24	3	25	562	Vallereuil	278	4	282
72	Aquitaine	24	4	22	563	Valojoulx	267	6	273
72	Aquitaine	24	3	28	564	Vanxains	727	127	854
72	Aquitaine	24	2	06	565	Varaignes	425	3	428
72	Aquitaine	24	1	17	566	Varennes	448	8	456
72	Aquitaine	24	2	41	567	Vaunac	260	7	267
72	Aquitaine	24	1	42	568	Vélines	1117	34	1151
72	Aquitaine	24	3	44	569	Vendoire	152	0	152
72	Aquitaine	24	1	17	570	Verdon	47	8	55
72	Aquitaine	24	3	43	571	Vergt	1674	45	1719
72	Aquitaine	24	1	20	572	Vergt-de-Biron	183	5	188
72	Aquitaine	24	3	44	573	Verteillac	642	14	656
72	Aquitaine	24	4	08	574	Veyrignac	319	5	324
72	Aquitaine	24	4	10	575	Veyrines-de-Domme	222	27	249
72	Aquitaine	24	3	43	576	Veyrines-de-Vergt	248	13	261
72	Aquitaine	24	4	36	577	Vézac	621	19	640
72	Aquitaine	24	2	19	579	Vieux-Mareuil	334	12	346
72	Aquitaine	24	4	39	580	Villac	243	7	250
72	Aquitaine	24	1	45	581	Villamblard	885	31	916
72	Aquitaine	24	2	09	582	Villars	458	14	472
72	Aquitaine	24	1	46	584	Villefranche-de-Lonchat	963	12	975
72	Aquitaine	24	4	47	585	Villefranche-du-Périgord	759	15	774
72	Aquitaine	24	3	28	586	Villetoureix	874	22	896
72	Aquitaine	24	4	36	587	Vitrac	886	20	906
43	Franche-Comté	25	1	07	001	Abbans-Dessous	235	5	240
43	Franche-Comté	25	1	07	002	Abbans-Dessus	307	7	314
43	Franche-Comté	25	1	23	003	Abbenans	355	4	359
43	Franche-Comté	25	2	09	004	Abbévillers	1076	17	1093
43	Franche-Comté	25	2	10	005	Accolans	98	0	98
43	Franche-Comté	25	1	04	006	Adam-lès-Passavant	99	2	101
43	Franche-Comté	25	3	27	007	Adam-lès-Vercel	108	2	110
43	Franche-Comté	25	2	30	008	Aibre	454	14	468
43	Franche-Comté	25	1	04	009	Aïssey	162	4	166
43	Franche-Comté	25	2	34	011	Allenjoie	754	8	762
43	Franche-Comté	25	3	15	012	Les Alliés	115	3	118
43	Franche-Comté	25	2	30	013	Allondans	227	5	232
43	Franche-Comté	25	1	13	014	Amagney	731	12	743
43	Franche-Comté	25	1	01	015	Amancey	655	19	674
43	Franche-Comté	25	1	18	016	Amathay-Vésigneux	146	4	150
43	Franche-Comté	25	1	01	017	Amondans	93	4	97
43	Franche-Comté	25	2	08	018	Anteuil	610	12	622
43	Franche-Comté	25	2	10	019	Appenans	428	11	439
43	Franche-Comté	25	2	03	020	Arbouans	992	19	1011
43	Franche-Comté	25	1	22	021	Arc-et-Senans	1481	41	1522
43	Franche-Comté	25	3	15	025	Arc-sous-Cicon	650	16	666
43	Franche-Comté	25	3	11	026	Arc-sous-Montenot	229	14	243
43	Franche-Comté	25	2	10	022	Arcey	1414	35	1449
43	Franche-Comté	25	1	06	027	Arguel	238	11	249
43	Franche-Comté	25	3	15	024	Arçon	771	19	790
43	Franche-Comté	25	3	27	028	Athose	168	6	174
43	Franche-Comté	25	3	15	029	Aubonne	229	9	238
43	Franche-Comté	25	1	02	030	Audeux	437	6	443
43	Franche-Comté	25	2	03	031	Audincourt	14825	269	15094
43	Franche-Comté	25	1	04	032	Autechaux	392	13	405
43	Franche-Comté	25	2	09	033	Autechaux-Roide	563	16	579
43	Franche-Comté	25	1	02	034	Auxon-Dessous	1246	19	1265
43	Franche-Comté	25	1	02	035	Auxon-Dessus	1158	24	1182
43	Franche-Comté	25	1	07	036	Avanne-Aveney	2340	57	2397
43	Franche-Comté	25	1	23	038	Avilley	181	1	182
43	Franche-Comté	25	3	27	039	Avoudrey	835	15	850
43	Franche-Comté	25	2	34	040	Badevel	850	16	866
43	Franche-Comté	25	3	20	041	Bannans	320	11	331
43	Franche-Comté	25	3	25	042	Le Barboux	241	6	247
43	Franche-Comté	25	2	30	043	Bart	1898	50	1948
43	Franche-Comté	25	1	22	044	Bartherans	46	1	47
43	Franche-Comté	25	1	13	045	Battenans-les-Mines	58	1	59
43	Franche-Comté	25	2	12	046	Battenans-Varin	67	0	67
43	Franche-Comté	25	1	04	047	Baume-les-Dames	5315	108	5423
43	Franche-Comté	25	2	30	048	Bavans	3573	62	3635
43	Franche-Comté	25	2	12	049	Belfays	102	3	105
43	Franche-Comté	25	3	25	050	Le Bélieu	320	10	330
43	Franche-Comté	25	2	12	051	Belleherbe	587	18	605
43	Franche-Comté	25	3	27	052	Belmont	60	1	61
43	Franche-Comté	25	2	08	053	Belvoir	98	4	102
43	Franche-Comté	25	2	21	054	Berche	460	4	464
43	Franche-Comté	25	1	02	055	Berthelange	267	3	270
43	Franche-Comté	25	1	99	056	Besançon	116914	4124	121038
43	Franche-Comté	25	2	14	057	Bethoncourt	5971	62	6033
43	Franche-Comté	25	1	06	058	Beure	1356	22	1378
43	Franche-Comté	25	2	30	059	Beutal	275	2	277
43	Franche-Comté	25	3	11	060	Bians-les-Usiers	572	14	586
43	Franche-Comté	25	2	26	061	Bief	114	3	117
43	Franche-Comté	25	3	25	062	Le Bizot	267	9	276
43	Franche-Comté	25	2	09	063	Blamont	1113	19	1132
43	Franche-Comté	25	1	13	065	Blarians	53	0	53
43	Franche-Comté	25	2	10	066	Blussangeaux	76	1	77
43	Franche-Comté	25	2	10	067	Blussans	187	2	189
43	Franche-Comté	25	1	01	070	Bolandoz	349	11	360
43	Franche-Comté	25	2	09	071	Bondeval	473	14	487
43	Franche-Comté	25	1	23	072	Bonnal	20	2	22
43	Franche-Comté	25	1	13	073	Bonnay	838	8	846
43	Franche-Comté	25	3	25	074	Bonnétage	782	21	803
43	Franche-Comté	25	3	17	075	Bonnevaux	342	14	356
43	Franche-Comté	25	1	18	076	Bonnevaux-le-Prieuré	108	2	110
43	Franche-Comté	25	3	25	077	La Bosse	77	2	79
43	Franche-Comté	25	1	24	078	Bouclans	971	22	993
43	Franche-Comté	25	3	11	079	Boujailles	416	14	430
43	Franche-Comté	25	2	21	082	Bourguignon	955	17	972
43	Franche-Comté	25	2	10	083	Bournois	183	1	184
43	Franche-Comté	25	1	07	084	Boussières	1094	16	1110
43	Franche-Comté	25	3	20	085	Bouverans	338	4	342
43	Franche-Comté	25	1	13	086	Braillans	151	4	155
43	Franche-Comté	25	2	08	087	Branne	173	3	176
43	Franche-Comté	25	1	24	088	Breconchaux	91	2	93
43	Franche-Comté	25	3	27	089	Bremondans	79	0	79
43	Franche-Comté	25	1	22	090	Brères	36	0	36
43	Franche-Comté	25	2	12	091	Les Bréseux	419	16	435
43	Franche-Comté	25	1	13	092	La Bretenière	63	2	65
43	Franche-Comté	25	2	30	093	Bretigney	85	1	86
43	Franche-Comté	25	1	04	094	Bretigney-Notre-Dame	111	2	113
43	Franche-Comté	25	3	25	095	Bretonvillers	217	8	225
43	Franche-Comté	25	3	17	096	Brey-et-Maison-du-Bois	101	5	106
43	Franche-Comté	25	2	34	097	Brognard	467	12	479
43	Franche-Comté	25	1	22	098	Buffard	163	5	168
43	Franche-Comté	25	3	15	099	Bugny	158	6	164
43	Franche-Comté	25	3	11	100	Bulle	387	15	402
43	Franche-Comté	25	1	02	101	Burgille	522	5	527
43	Franche-Comté	25	2	26	102	Burnevillers	45	0	45
43	Franche-Comté	25	1	07	103	Busy	558	13	571
43	Franche-Comté	25	1	22	104	By	77	7	84
43	Franche-Comté	25	1	07	105	Byans-sur-Doubs	566	16	582
43	Franche-Comté	25	1	22	106	Cademène	90	4	94
43	Franche-Comté	25	1	13	107	Cendrey	182	0	182
43	Franche-Comté	25	2	12	108	Cernay-l;Église	272	7	279
43	Franche-Comté	25	1	22	109	Cessey	348	5	353
43	Franche-Comté	25	3	20	110	Chaffois	887	30	917
43	Franche-Comté	25	1	28	111	Chalèze	356	4	360
43	Franche-Comté	25	1	28	112	Chalezeule	1234	25	1259
43	Franche-Comté	25	3	25	113	Chamesey	119	1	120
43	Franche-Comté	25	2	26	114	Chamesol	398	12	410
43	Franche-Comté	25	1	02	115	Champagney	264	5	269
43	Franche-Comté	25	1	24	116	Champlive	260	5	265
43	Franche-Comté	25	1	13	117	Champoux	88	1	89
43	Franche-Comté	25	1	02	119	Champvans-les-Moulins	347	3	350
43	Franche-Comté	25	1	18	120	Chantrans	418	15	433
43	Franche-Comté	25	3	11	122	Chapelle-d;Huin	441	8	449
43	Franche-Comté	25	3	17	121	Chapelle-des-Bois	264	16	280
43	Franche-Comté	25	1	18	123	Charbonnières-les-Sapins	192	7	199
43	Franche-Comté	25	2	12	124	Charmauvillers	270	4	274
43	Franche-Comté	25	2	12	125	Charmoille	303	10	313
43	Franche-Comté	25	1	22	126	Charnay	452	7	459
43	Franche-Comté	25	2	12	127	Charquemont	2467	56	2523
43	Franche-Comté	25	3	27	128	Chasnans	240	5	245
43	Franche-Comté	25	1	18	129	Chassagne-Saint-Denis	115	2	117
43	Franche-Comté	25	1	18	130	Châteauvieux-les-Fossés	12	0	12
43	Franche-Comté	25	3	17	131	Châtelblanc	115	2	117
43	Franche-Comté	25	1	24	132	Châtillon-Guyotte	131	5	136
43	Franche-Comté	25	1	13	133	Châtillon-le-Duc	1905	58	1963
43	Franche-Comté	25	1	22	134	Châtillon-sur-Lison	12	1	13
43	Franche-Comté	25	1	02	136	Chaucenne	542	6	548
43	Franche-Comté	25	1	13	137	Chaudefontaine	218	2	220
43	Franche-Comté	25	3	15	139	La Chaux	424	17	441
43	Franche-Comté	25	2	08	140	Chaux-lès-Clerval	195	5	200
43	Franche-Comté	25	3	27	141	Chaux-lès-Passavant	148	4	152
43	Franche-Comté	25	3	17	142	Chaux-Neuve	261	3	264
43	Franche-Comté	25	1	22	143	Chay	193	6	199
43	Franche-Comté	25	2	08	145	Chazot	128	6	134
43	Franche-Comté	25	1	02	147	Chemaudin	1430	39	1469
43	Franche-Comté	25	3	25	148	La Chenalotte	404	17	421
43	Franche-Comté	25	1	22	149	Chenecey-Buillon	556	7	563
43	Franche-Comté	25	3	27	151	Chevigney-lès-Vercel	124	1	125
43	Franche-Comté	25	1	02	150	Chevigney-sur-l;Ognon	245	4	249
43	Franche-Comté	25	1	06	152	La Chevillotte	98	2	100
43	Franche-Comté	25	1	13	153	Chevroz	105	1	106
43	Franche-Comté	25	1	22	154	Chouzelot	289	7	296
43	Franche-Comté	25	1	01	155	Cléron	312	12	324
43	Franche-Comté	25	2	08	156	Clerval	1045	14	1059
43	Franche-Comté	25	3	20	157	La Cluse-et-Mijoux	1197	33	1230
43	Franche-Comté	25	2	21	159	Colombier-Fontaine	1376	27	1403
43	Franche-Comté	25	3	16	160	Les Combes	725	23	748
43	Franche-Comté	25	3	19	161	Consolation-Maisonnettes	29	1	30
43	Franche-Comté	25	1	13	163	Corcelle-Mieslot	108	1	109
43	Franche-Comté	25	1	02	162	Corcelles-Ferrières	189	3	192
43	Franche-Comté	25	1	02	164	Corcondray	125	2	127
43	Franche-Comté	25	1	04	166	Côtebrune	72	0	72
43	Franche-Comté	25	2	12	173	Cour-Saint-Maurice	170	6	176
43	Franche-Comté	25	1	22	171	Courcelles	75	2	77
43	Franche-Comté	25	2	03	170	Courcelles-lès-Montbéliard	1127	33	1160
43	Franche-Comté	25	1	02	172	Courchapon	169	2	171
43	Franche-Comté	25	2	26	174	Courtefontaine	230	3	233
43	Franche-Comté	25	3	27	175	Courtetain-et-Salans	86	4	90
43	Franche-Comté	25	3	11	176	Courvières	265	9	274
43	Franche-Comté	25	2	08	177	Crosey-le-Grand	179	2	181
43	Franche-Comté	25	2	08	178	Crosey-le-Petit	116	5	121
43	Franche-Comté	25	3	17	179	Le Crouzet	68	0	68
43	Franche-Comté	25	1	01	180	Crouzet-Migette	130	4	134
43	Franche-Comté	25	1	23	181	Cubrial	137	3	140
43	Franche-Comté	25	1	23	182	Cubry	80	2	82
43	Franche-Comté	25	1	04	183	Cusance	84	0	84
43	Franche-Comté	25	1	23	184	Cuse-et-Adrisans	271	6	277
43	Franche-Comté	25	1	13	186	Cussey-sur-l;Ognon	946	19	965
43	Franche-Comté	25	1	22	185	Cussey-sur-Lison	61	2	63
43	Franche-Comté	25	2	21	187	Dambelin	487	7	494
43	Franche-Comté	25	2	34	188	Dambenois	768	21	789
43	Franche-Comté	25	1	24	189	Dammartin-les-Templiers	198	2	200
43	Franche-Comté	25	2	34	190	Dampierre-les-Bois	1642	33	1675
43	Franche-Comté	25	2	21	191	Dampierre-sur-le-Doubs	498	11	509
43	Franche-Comté	25	2	26	192	Dampjoux	148	2	150
43	Franche-Comté	25	2	12	193	Damprichard	1769	48	1817
43	Franche-Comté	25	2	09	194	Dannemarie	108	0	108
43	Franche-Comté	25	1	02	195	Dannemarie-sur-Crète	1326	289	1615
43	Franche-Comté	25	2	03	196	Dasle	1419	21	1440
43	Franche-Comté	25	1	24	197	Deluz	633	13	646
43	Franche-Comté	25	2	30	198	Désandans	714	9	723
43	Franche-Comté	25	1	01	199	Déservillers	322	4	326
43	Franche-Comté	25	1	13	200	Devecey	1350	23	1373
43	Franche-Comté	25	3	20	201	Dommartin	620	14	634
43	Franche-Comté	25	3	11	202	Dompierre-les-Tilleuls	248	9	257
43	Franche-Comté	25	3	19	203	Domprel	150	8	158
43	Franche-Comté	25	3	20	204	Doubs	2597	101	2698
43	Franche-Comté	25	2	30	207	Dung	654	21	675
43	Franche-Comté	25	1	18	208	Durnes	156	3	159
43	Franche-Comté	25	1	22	209	Échay	115	1	116
43	Franche-Comté	25	2	30	210	Échenans	132	3	135
43	Franche-Comté	25	1	18	211	Échevannes	84	1	85
43	Franche-Comté	25	1	02	212	École-Valentin	2309	40	2349
43	Franche-Comté	25	2	12	213	Les Écorces	641	24	665
43	Franche-Comté	25	2	21	214	Écot	500	5	505
43	Franche-Comté	25	1	24	215	L; Écouvotte	112	2	114
43	Franche-Comté	25	2	09	216	Écurcey	279	6	285
43	Franche-Comté	25	1	02	217	Émagny	616	12	628
43	Franche-Comté	25	3	27	218	Épenouse	132	2	134
43	Franche-Comté	25	3	27	219	Épenoy	579	14	593
43	Franche-Comté	25	1	22	220	Épeugney	530	7	537
43	Franche-Comté	25	1	04	221	Esnans	40	0	40
43	Franche-Comté	25	3	27	222	Étalans	1165	40	1205
43	Franche-Comté	25	1	01	223	Éternoz	341	8	349
43	Franche-Comté	25	2	21	224	Étouvans	760	12	772
43	Franche-Comté	25	1	02	225	Étrabonne	196	2	198
43	Franche-Comté	25	2	10	226	Étrappe	191	9	200
43	Franche-Comté	25	3	27	227	Étray	200	3	203
43	Franche-Comté	25	2	34	228	Étupes	3564	55	3619
43	Franche-Comté	25	3	11	229	Évillers	317	10	327
43	Franche-Comté	25	2	34	230	Exincourt	3164	68	3232
43	Franche-Comté	25	3	27	231	Eysson	91	2	93
43	Franche-Comté	25	2	10	232	Faimbe	112	1	113
43	Franche-Comté	25	3	27	233	Fallerans	249	8	257
43	Franche-Comté	25	2	12	234	Ferrières-le-Lac	184	1	185
43	Franche-Comté	25	1	02	235	Ferrières-les-Bois	322	4	326
43	Franche-Comté	25	1	01	236	Fertans	255	6	261
43	Franche-Comté	25	2	34	237	Fesches-le-Châtel	2282	28	2310
43	Franche-Comté	25	2	12	238	Fessevillers	174	1	175
43	Franche-Comté	25	2	21	239	Feule	178	2	180
43	Franche-Comté	25	3	16	240	Les Fins	2908	150	3058
43	Franche-Comté	25	1	01	241	Flagey	142	6	148
43	Franche-Comté	25	1	13	242	Flagey-Rigney	75	1	76
43	Franche-Comté	25	3	19	243	Flangebouche	686	6	692
43	Franche-Comté	25	2	26	244	Fleurey	97	0	97
43	Franche-Comté	25	1	06	245	Fontain	954	22	976
43	Franche-Comté	25	2	08	246	Fontaine-lès-Clerval	253	6	259
43	Franche-Comté	25	1	23	247	Fontenelle-Montby	102	2	104
43	Franche-Comté	25	3	25	248	Les Fontenelles	534	150	684
43	Franche-Comté	25	1	04	249	Fontenotte	57	2	59
43	Franche-Comté	25	1	18	250	Foucherans	444	16	460
43	Franche-Comté	25	1	04	251	Fourbanne	175	9	184
43	Franche-Comté	25	3	17	252	Fourcatier-et-Maison-Neuve	81	2	83
43	Franche-Comté	25	1	22	253	Fourg	321	5	326
43	Franche-Comté	25	3	20	254	Les Fourgs	1211	48	1259
43	Franche-Comté	25	2	12	255	Fournet-Blancheroche	348	12	360
43	Franche-Comté	25	3	19	288	Fournets-Luisans	631	16	647
43	Franche-Comté	25	2	12	256	Frambouhans	772	12	784
43	Franche-Comté	25	1	02	257	Franey	277	7	284
43	Franche-Comté	25	1	02	258	Franois	1860	42	1902
43	Franche-Comté	25	3	11	259	Frasne	1811	51	1862
43	Franche-Comté	25	2	26	261	Froidevaux	60	2	62
43	Franche-Comté	25	3	19	262	Fuans	475	6	481
43	Franche-Comté	25	3	17	263	Gellin	210	9	219
43	Franche-Comté	25	2	10	264	Gémonval	80	0	80
43	Franche-Comté	25	1	13	265	Geneuille	1339	15	1354
43	Franche-Comté	25	2	10	266	Geney	148	4	152
43	Franche-Comté	25	1	06	267	Gennes	599	9	608
43	Franche-Comté	25	3	19	268	Germéfontaine	121	0	121
43	Franche-Comté	25	1	13	269	Germondans	65	1	66
43	Franche-Comté	25	1	01	270	Gevresin	114	3	117
43	Franche-Comté	25	3	15	271	Gilley	1468	34	1502
43	Franche-Comté	25	1	24	273	Glamondans	190	4	194
43	Franche-Comté	25	2	09	274	Glay	356	11	367
43	Franche-Comté	25	2	26	275	Glère	220	1	221
43	Franche-Comté	25	1	23	277	Gondenans-les-Moulins	74	1	75
43	Franche-Comté	25	1	23	276	Gondenans-Montby	169	0	169
43	Franche-Comté	25	1	24	278	Gonsans	516	9	525
43	Franche-Comté	25	1	23	279	Gouhelans	113	6	119
43	Franche-Comté	25	2	12	280	Goumois	179	5	184
43	Franche-Comté	25	2	21	281	Goux-lès-Dambelin	274	1	275
43	Franche-Comté	25	3	11	282	Goux-les-Usiers	699	4	703
43	Franche-Comté	25	1	22	283	Goux-sous-Landet	51	0	51
43	Franche-Comté	25	2	31	284	Grand-Charmont	5194	78	5272
43	Franche-Comté	25	3	16	285	Grand;Combe-Châteleu	1365	38	1403
43	Franche-Comté	25	3	25	286	Grand;Combe-des-Bois	133	2	135
43	Franche-Comté	25	1	07	287	Grandfontaine	1415	36	1451
43	Franche-Comté	25	3	19	289	Grandfontaine-sur-Creuse	84	2	86
43	Franche-Comté	25	2	12	290	La Grange	90	1	91
43	Franche-Comté	25	3	20	293	Granges-Narboz	952	38	990
43	Franche-Comté	25	3	20	295	Les Grangettes	264	12	276
43	Franche-Comté	25	3	16	296	Les Gras	745	21	766
43	Franche-Comté	25	1	06	297	Le Gratteris	166	0	166
43	Franche-Comté	25	1	04	298	Grosbois	228	3	231
43	Franche-Comté	25	1	04	299	Guillon-les-Bains	112	2	114
43	Franche-Comté	25	1	18	300	Guyans-Durnes	250	4	254
43	Franche-Comté	25	3	19	301	Guyans-Vennes	730	11	741
43	Franche-Comté	25	3	27	302	Hautepierre-le-Châtelet	89	0	89
43	Franche-Comté	25	3	15	303	Hauterive-la-Fresse	212	9	221
43	Franche-Comté	25	2	09	304	Hérimoncourt	3750	98	3848
43	Franche-Comté	25	1	18	305	L; Hôpital-du-Grosbois	554	11	565
43	Franche-Comté	25	2	08	306	L; Hôpital-Saint-Lieffroy	92	6	98
43	Franche-Comté	25	3	20	307	Les Hôpitaux-Neufs	748	22	770
43	Franche-Comté	25	3	20	308	Les Hôpitaux-Vieux	355	9	364
43	Franche-Comté	25	3	20	309	Houtaud	961	30	991
43	Franche-Comté	25	1	23	310	Huanne-Montmartin	82	2	84
43	Franche-Comté	25	2	10	311	Hyémondans	204	2	206
43	Franche-Comté	25	1	04	312	Hyèvre-Magny	74	0	74
43	Franche-Comté	25	1	04	313	Hyèvre-Paroisse	193	1	194
43	Franche-Comté	25	2	26	314	Indevillers	241	4	245
43	Franche-Comté	25	2	10	315	L; Isle-sur-le-Doubs	3170	59	3229
43	Franche-Comté	25	2	30	316	Issans	257	20	277
43	Franche-Comté	25	1	02	317	Jallerange	191	1	192
43	Franche-Comté	25	3	17	318	Jougne	1443	39	1482
43	Franche-Comté	25	1	01	319	Labergement-du-Navois	110	4	114
43	Franche-Comté	25	3	17	320	Labergement-Sainte-Marie	1088	38	1126
43	Franche-Comté	25	2	30	322	Laire	386	9	395
43	Franche-Comté	25	1	24	323	Laissey	454	1	455
43	Franche-Comté	25	1	04	324	Lanans	130	4	134
43	Franche-Comté	25	3	19	325	Landresse	215	3	218
43	Franche-Comté	25	1	02	326	Lantenne-Vertière	538	10	548
43	Franche-Comté	25	2	10	327	Lanthenans	62	1	63
43	Franche-Comté	25	1	07	328	Larnod	650	20	670
43	Franche-Comté	25	3	25	329	Laval-le-Prieuré	34	2	36
43	Franche-Comté	25	1	22	330	Lavans-Quingey	188	6	194
43	Franche-Comté	25	1	18	331	Lavans-Vuillafans	218	4	222
43	Franche-Comté	25	1	02	332	Lavernay	594	7	601
43	Franche-Comté	25	3	19	333	Laviron	354	6	360
43	Franche-Comté	25	3	11	334	Levier	1963	195	2158
43	Franche-Comté	25	2	26	335	Liebvillers	168	6	174
43	Franche-Comté	25	1	22	336	Liesle	521	21	542
43	Franche-Comté	25	1	01	338	Lizine	92	5	97
43	Franche-Comté	25	1	18	339	Lods	236	3	239
43	Franche-Comté	25	1	22	340	Lombard	215	8	223
43	Franche-Comté	25	1	04	341	Lomont-sur-Crête	162	5	167
43	Franche-Comté	25	3	27	342	Longechaux	58	0	58
43	Franche-Comté	25	3	27	343	Longemaison	135	5	140
43	Franche-Comté	25	3	25	344	Longevelle-lès-Russey	49	1	50
43	Franche-Comté	25	2	10	345	Longevelle-sur-Doubs	627	14	641
43	Franche-Comté	25	1	18	346	Longeville	144	7	151
43	Franche-Comté	25	3	15	347	La Longeville	670	10	680
43	Franche-Comté	25	3	17	348	Longevilles-Mont-d;Or	429	9	438
43	Franche-Comté	25	3	19	349	Loray	495	12	507
43	Franche-Comté	25	2	30	350	Lougres	773	15	788
43	Franche-Comté	25	3	25	351	Le Luhier	200	9	209
43	Franche-Comté	25	1	04	354	Luxiol	166	6	172
43	Franche-Comté	25	3	27	355	Magny-Châtelard	43	0	43
43	Franche-Comté	25	2	12	356	Maîche	4355	112	4467
43	Franche-Comté	25	3	15	357	Maisons-du-Bois-Lièvremont	599	10	609
43	Franche-Comté	25	1	01	359	Malans	158	1	159
43	Franche-Comté	25	1	18	360	Malbrans	131	2	133
43	Franche-Comté	25	3	20	361	Malbuisson	704	15	719
43	Franche-Comté	25	3	20	362	Malpas	223	1	224
43	Franche-Comté	25	1	06	364	Mamirolle	1699	45	1744
43	Franche-Comté	25	2	10	365	Mancenans	330	7	337
43	Franche-Comté	25	2	12	366	Mancenans-Lizerne	185	6	191
43	Franche-Comté	25	2	35	367	Mandeure	4933	175	5108
43	Franche-Comté	25	1	13	368	Marchaux	1117	23	1140
43	Franche-Comté	25	2	10	369	Marvelise	155	1	156
43	Franche-Comté	25	2	21	370	Mathay	2151	41	2192
43	Franche-Comté	25	1	02	371	Mazerolles-le-Salin	201	3	204
43	Franche-Comté	25	2	10	372	Médière	319	9	328
43	Franche-Comté	25	3	25	373	Le Mémont	40	0	40
43	Franche-Comté	25	1	02	374	Mercey-le-Grand	480	6	486
43	Franche-Comté	25	1	18	375	Mérey-sous-Montrond	445	4	449
43	Franche-Comté	25	1	13	376	Mérey-Vieilley	103	2	105
43	Franche-Comté	25	1	23	377	Mésandans	190	3	193
43	Franche-Comté	25	2	09	378	Meslières	350	5	355
43	Franche-Comté	25	1	22	379	Mesmay	72	3	75
43	Franche-Comté	25	3	17	380	Métabief	1085	13	1098
43	Franche-Comté	25	1	02	381	Miserey-Salines	2137	54	2191
43	Franche-Comté	25	1	13	382	Moncey	483	8	491
43	Franche-Comté	25	1	02	383	Moncley	330	5	335
43	Franche-Comté	25	1	23	384	Mondon	81	0	81
43	Franche-Comté	25	3	25	391	Mont-de-Laval	192	10	202
43	Franche-Comté	25	2	12	392	Mont-de-Vougney	169	4	173
43	Franche-Comté	25	1	23	385	Montagney-Servigney	119	1	120
43	Franche-Comté	25	2	26	386	Montancy	161	5	166
43	Franche-Comté	25	2	26	387	Montandon	379	2	381
43	Franche-Comté	25	2	95	388	Montbéliard	25875	626	26501
43	Franche-Comté	25	3	25	389	Montbéliardot	103	3	106
43	Franche-Comté	25	3	15	390	Montbenoît	391	9	400
43	Franche-Comté	25	2	26	393	Montécheroux	566	10	576
43	Franche-Comté	25	2	10	394	Montenois	1549	44	1593
43	Franche-Comté	25	1	06	395	Montfaucon	1520	56	1576
43	Franche-Comté	25	1	07	397	Montferrand-le-Château	2195	42	2237
43	Franche-Comté	25	3	15	398	Montflovin	102	0	102
43	Franche-Comté	25	1	22	399	Montfort	90	35	125
43	Franche-Comté	25	1	18	400	Montgesoye	493	6	499
43	Franche-Comté	25	1	04	401	Montivernage	26	1	27
43	Franche-Comté	25	2	26	402	Montjoie-le-Château	31	1	32
43	Franche-Comté	25	3	16	403	Montlebon	1953	48	2001
43	Franche-Comté	25	1	01	404	Montmahoux	95	3	98
43	Franche-Comté	25	3	20	405	Montperreux	771	31	802
43	Franche-Comté	25	1	22	406	Montrond-le-Château	558	14	572
43	Franche-Comté	25	1	23	408	Montussaint	71	0	71
43	Franche-Comté	25	1	06	410	Morre	1326	42	1368
43	Franche-Comté	25	3	16	411	Morteau	6700	311	7011
43	Franche-Comté	25	3	17	413	Mouthe	968	31	999
43	Franche-Comté	25	1	02	414	Le Moutherot	120	0	120
43	Franche-Comté	25	1	18	415	Mouthier-Haute-Pierre	308	12	320
43	Franche-Comté	25	1	22	416	Myon	184	11	195
43	Franche-Comté	25	1	24	417	Naisey-les-Granges	738	10	748
43	Franche-Comté	25	1	24	418	Nancray	1256	21	1277
43	Franche-Comté	25	1	23	419	Nans	88	4	92
43	Franche-Comté	25	1	01	420	Nans-sous-Sainte-Anne	155	2	157
43	Franche-Comté	25	3	25	421	Narbief	73	1	74
43	Franche-Comté	25	2	21	422	Neuchâtel-Urtière	163	2	165
43	Franche-Comté	25	3	27	424	Nods	562	12	574
43	Franche-Comté	25	3	25	425	Noël-Cerneux	371	12	383
43	Franche-Comté	25	2	21	426	Noirefontaine	346	9	355
43	Franche-Comté	25	1	02	427	Noironte	336	10	346
43	Franche-Comté	25	2	31	428	Nommay	1637	45	1682
43	Franche-Comté	25	1	13	429	Novillars	1544	46	1590
43	Franche-Comté	25	1	13	430	Ollans	41	3	44
43	Franche-Comté	25	2	10	431	Onans	375	11	386
43	Franche-Comté	25	3	19	432	Orchamps-Vennes	1875	51	1926
43	Franche-Comté	25	2	12	433	Orgeans-Blanchefontaine	47	0	47
43	Franche-Comté	25	1	18	434	Ornans	4188	84	4272
43	Franche-Comté	25	3	27	435	Orsans	161	6	167
43	Franche-Comté	25	2	08	436	Orve	68	1	69
43	Franche-Comté	25	1	24	437	Osse	327	5	332
43	Franche-Comté	25	1	07	438	Osselle	397	5	402
43	Franche-Comté	25	1	24	439	Ougney-Douvot	197	6	203
43	Franche-Comté	25	3	15	440	Ouhans	370	7	377
43	Franche-Comté	25	3	19	441	Ouvans	75	1	76
43	Franche-Comté	25	3	20	442	Oye-et-Pallet	693	21	714
43	Franche-Comté	25	1	22	443	Palantine	49	0	49
43	Franche-Comté	25	1	13	444	Palise	131	0	131
43	Franche-Comté	25	1	22	445	Paroy	114	3	117
43	Franche-Comté	25	1	04	446	Passavant	236	8	244
43	Franche-Comté	25	3	27	447	Passonfontaine	281	6	287
43	Franche-Comté	25	1	02	448	Pelousey	1440	28	1468
43	Franche-Comté	25	2	21	449	Péseux	95	3	98
43	Franche-Comté	25	1	22	450	Pessans	78	3	81
43	Franche-Comté	25	3	17	451	Petite-Chaux	140	3	143
43	Franche-Comté	25	2	09	452	Pierrefontaine-lès-Blamont	400	12	412
43	Franche-Comté	25	3	19	453	Pierrefontaine-les-Varans	1365	41	1406
43	Franche-Comté	25	1	02	454	Pirey	1958	45	2003
43	Franche-Comté	25	1	02	455	Placey	146	4	150
43	Franche-Comté	25	3	25	456	Plaimbois-du-Miroir	215	3	218
43	Franche-Comté	25	3	19	457	Plaimbois-Vennes	76	4	80
43	Franche-Comté	25	2	26	458	Les Plains-et-Grands-Essarts	211	0	211
43	Franche-Comté	25	3	20	459	La Planée	241	6	247
43	Franche-Comté	25	1	22	460	Pointvillers	134	0	134
43	Franche-Comté	25	2	08	461	Pompierre-sur-Doubs	313	6	319
43	Franche-Comté	25	2	21	463	Pont-de-Roide	4468	82	4550
43	Franche-Comté	25	1	04	465	Pont-les-Moulins	177	2	179
43	Franche-Comté	25	3	20	462	Pontarlier	18456	771	19227
43	Franche-Comté	25	3	17	464	Les Pontets	115	3	118
43	Franche-Comté	25	1	02	466	Pouilley-Français	778	16	794
43	Franche-Comté	25	1	02	467	Pouilley-les-Vignes	1898	51	1949
43	Franche-Comté	25	1	24	468	Pouligney-Lusans	787	8	795
43	Franche-Comté	25	2	30	469	Présentevillers	467	12	479
43	Franche-Comté	25	2	10	470	La Prétière	177	0	177
43	Franche-Comté	25	2	12	471	Provenchère	122	7	129
43	Franche-Comté	25	1	23	472	Puessans	45	1	46
43	Franche-Comté	25	1	07	473	Pugey	778	11	789
43	Franche-Comté	25	1	24	474	Le Puy	89	2	91
43	Franche-Comté	25	1	22	475	Quingey	1331	19	1350
43	Franche-Comté	25	2	08	476	Rahon	121	4	125
43	Franche-Comté	25	1	07	477	Rancenay	306	7	313
43	Franche-Comté	25	2	08	478	Randevillers	106	4	110
43	Franche-Comté	25	2	10	479	Rang	418	7	425
43	Franche-Comté	25	3	27	480	Rantechaux	184	3	187
43	Franche-Comté	25	2	30	481	Raynans	274	9	283
43	Franche-Comté	25	1	02	482	Recologne	573	12	585
43	Franche-Comté	25	3	17	483	Reculfoz	53	1	54
43	Franche-Comté	25	2	21	485	Rémondans-Vaivre	227	4	231
43	Franche-Comté	25	3	17	486	Remoray-Boujeons	362	9	371
43	Franche-Comté	25	3	15	487	Renédale	37	1	38
43	Franche-Comté	25	1	22	488	Rennes-sur-Loue	92	3	95
43	Franche-Comté	25	1	01	489	Reugney	308	6	314
43	Franche-Comté	25	1	13	490	Rigney	430	6	436
43	Franche-Comté	25	1	13	491	Rignosot	120	0	120
43	Franche-Comté	25	1	23	492	Rillans	86	1	87
43	Franche-Comté	25	3	20	493	La Rivière-Drugeon	828	18	846
43	Franche-Comté	25	2	08	496	Roche-lès-Clerval	100	2	102
43	Franche-Comté	25	1	13	495	Roche-lez-Beaupré	2042	31	2073
43	Franche-Comté	25	3	17	494	Rochejean	622	15	637
43	Franche-Comté	25	2	09	497	Roches-lès-Blamont	627	18	645
43	Franche-Comté	25	1	23	498	Rognon	46	0	46
43	Franche-Comté	25	1	23	499	Romain	101	2	103
43	Franche-Comté	25	1	22	500	Ronchaux	89	3	92
43	Franche-Comté	25	3	17	501	Rondefontaine	30	1	31
43	Franche-Comté	25	1	07	502	Roset-Fluans	457	12	469
43	Franche-Comté	25	2	21	503	Rosières-sur-Barbèche	97	7	104
43	Franche-Comté	25	3	25	504	Rosureux	81	2	83
43	Franche-Comté	25	1	23	505	Rougemont	1236	21	1257
43	Franche-Comté	25	1	13	506	Rougemontot	86	1	87
43	Franche-Comté	25	1	22	507	Rouhe	80	0	80
43	Franche-Comté	25	1	24	508	Roulans	1107	15	1122
43	Franche-Comté	25	1	07	509	Routelle	481	9	490
43	Franche-Comté	25	1	02	510	Ruffey-le-Château	327	2	329
43	Franche-Comté	25	1	22	511	Rurey	324	5	329
43	Franche-Comté	25	3	25	512	Le Russey	2111	100	2211
43	Franche-Comté	25	3	17	514	Saint-Antoine	309	10	319
43	Franche-Comté	25	2	08	516	Saint-Georges-Armont	118	4	122
43	Franche-Comté	25	3	15	517	Saint-Gorgon-Main	270	10	280
43	Franche-Comté	25	1	24	518	Saint-Hilaire	161	2	163
43	Franche-Comté	25	2	26	519	Saint-Hippolyte	911	14	925
43	Franche-Comté	25	1	04	520	Saint-Juan	182	4	186
43	Franche-Comté	25	2	30	521	Saint-Julien-lès-Montbéliard	176	6	182
43	Franche-Comté	25	3	25	522	Saint-Julien-lès-Russey	149	6	155
43	Franche-Comté	25	2	10	524	Saint-Maurice-Colombier	907	12	919
43	Franche-Comté	25	3	20	525	Saint-Point-Lac	276	18	294
43	Franche-Comté	25	1	07	527	Saint-Vit	4707	87	4794
43	Franche-Comté	25	1	01	513	Sainte-Anne	30	2	32
43	Franche-Comté	25	3	20	515	Sainte-Colombe	330	9	339
43	Franche-Comté	25	2	30	523	Sainte-Marie	731	11	742
43	Franche-Comté	25	2	30	526	Sainte-Suzanne	1513	21	1534
43	Franche-Comté	25	1	22	528	Samson	83	1	84
43	Franche-Comté	25	2	08	529	Sancey-le-Grand	947	29	976
43	Franche-Comté	25	2	08	530	Sancey-le-Long	360	20	380
43	Franche-Comté	25	2	08	531	Santoche	76	1	77
43	Franche-Comté	25	1	06	532	Saône	3260	82	3342
43	Franche-Comté	25	1	01	533	Saraz	12	3	15
43	Franche-Comté	25	3	17	534	Sarrageois	155	3	158
43	Franche-Comté	25	1	18	535	Saules	228	3	231
43	Franche-Comté	25	1	02	536	Sauvagney	159	8	167
43	Franche-Comté	25	1	18	537	Scey-Maisières	313	7	320
43	Franche-Comté	25	1	24	538	Séchin	132	2	134
43	Franche-Comté	25	2	09	539	Seloncourt	5922	164	6086
43	Franche-Comté	25	2	30	540	Semondans	313	6	319
43	Franche-Comté	25	3	11	541	Septfontaines	310	11	321
43	Franche-Comté	25	1	02	542	Serre-les-Sapins	1537	34	1571
43	Franche-Comté	25	1	04	544	Servin	188	10	198
43	Franche-Comté	25	1	01	545	Silley-Amancey	124	2	126
43	Franche-Comté	25	1	04	546	Silley-Bléfond	76	1	77
43	Franche-Comté	25	2	31	547	Sochaux	4060	58	4118
43	Franche-Comté	25	2	21	548	Solemont	139	5	144
43	Franche-Comté	25	3	11	549	Sombacour	596	9	605
43	Franche-Comté	25	3	19	550	La Sommette	199	4	203
43	Franche-Comté	25	2	26	551	Soulce-Cernay	109	2	111
43	Franche-Comté	25	2	10	552	Sourans	133	0	133
43	Franche-Comté	25	2	10	553	Soye	354	4	358
43	Franche-Comté	25	2	08	554	Surmont	131	6	137
43	Franche-Comté	25	2	03	555	Taillecourt	1028	19	1047
43	Franche-Comté	25	1	23	556	Tallans	43	0	43
43	Franche-Comté	25	1	13	557	Tallenay	396	10	406
43	Franche-Comté	25	1	18	558	Tarcenay	939	23	962
43	Franche-Comté	25	2	26	138	Les Terres-de-Chaux	132	1	133
43	Franche-Comté	25	2	12	559	Thiébouhans	229	3	232
43	Franche-Comté	25	1	13	560	Thise	3191	75	3266
43	Franche-Comté	25	1	07	561	Thoraise	288	7	295
43	Franche-Comté	25	2	09	562	Thulay	220	7	227
43	Franche-Comté	25	1	13	563	Thurey-le-Mont	106	3	109
43	Franche-Comté	25	1	07	564	Torpes	922	21	943
43	Franche-Comté	25	3	20	565	Touillon-et-Loutelet	227	6	233
43	Franche-Comté	25	1	13	566	La Tour-de-Sçay	236	7	243
43	Franche-Comté	25	1	23	567	Tournans	120	4	124
43	Franche-Comté	25	1	18	569	Trépot	503	4	507
43	Franche-Comté	25	1	23	570	Tressandans	34	1	35
43	Franche-Comté	25	2	12	571	Trévillers	476	12	488
43	Franche-Comté	25	1	23	572	Trouvans	86	0	86
43	Franche-Comté	25	2	12	573	Urtière	8	0	8
43	Franche-Comté	25	1	23	574	Uzelle	154	2	156
43	Franche-Comté	25	1	13	575	Vaire-Arcier	528	7	535
43	Franche-Comté	25	1	13	576	Vaire-le-Petit	200	3	203
43	Franche-Comté	25	1	24	579	Val-de-Roulans	146	1	147
43	Franche-Comté	25	3	27	578	Valdahon	5088	118	5206
43	Franche-Comté	25	2	35	580	Valentigney	11388	245	11633
43	Franche-Comté	25	1	13	582	Valleroy	142	2	144
43	Franche-Comté	25	2	21	583	Valonne	233	2	235
43	Franche-Comté	25	2	26	584	Valoreille	107	5	112
43	Franche-Comté	25	3	27	585	Vanclans	207	10	217
43	Franche-Comté	25	2	09	586	Vandoncourt	829	21	850
43	Franche-Comté	25	1	24	587	Vauchamps	126	5	131
43	Franche-Comté	25	2	12	588	Vaucluse	115	36	151
43	Franche-Comté	25	2	12	589	Vauclusotte	97	2	99
43	Franche-Comté	25	1	04	590	Vaudrivillers	81	4	85
43	Franche-Comté	25	2	26	591	Vaufrey	146	1	147
43	Franche-Comté	25	3	17	592	Vaux-et-Chantegrue	567	8	575
43	Franche-Comté	25	1	02	593	Vaux-les-Prés	360	9	369
43	Franche-Comté	25	1	07	594	Velesmes-Essarts	325	5	330
43	Franche-Comté	25	2	08	595	Vellerot-lès-Belvoir	115	3	118
43	Franche-Comté	25	3	19	596	Vellerot-lès-Vercel	48	1	49
43	Franche-Comté	25	2	08	597	Vellevans	187	11	198
43	Franche-Comté	25	1	13	598	Venise	483	8	491
43	Franche-Comté	25	1	24	599	Vennans	187	5	192
43	Franche-Comté	25	3	19	600	Vennes	145	1	146
43	Franche-Comté	25	3	27	601	Vercel-Villedieu-le-Camp	1479	126	1605
43	Franche-Comté	25	1	04	602	Vergranne	110	3	113
43	Franche-Comté	25	1	04	604	Verne	134	5	139
43	Franche-Comté	25	3	27	605	Vernierfontaine	424	5	429
43	Franche-Comté	25	2	21	607	Vernois-lès-Belvoir	63	2	65
43	Franche-Comté	25	2	30	608	Le Vernoy	167	2	169
43	Franche-Comté	25	3	20	609	Verrières-de-Joux	429	7	436
43	Franche-Comté	25	3	27	610	Verrières-du-Grosbois	19	0	19
43	Franche-Comté	25	1	06	611	La Vèze	432	14	446
43	Franche-Comté	25	1	13	612	Vieilley	702	14	716
43	Franche-Comté	25	1	23	613	Viéthorey	121	1	122
43	Franche-Comté	25	2	31	614	Vieux-Charmont	2526	56	2582
43	Franche-Comté	25	2	09	615	Villars-lès-Blamont	445	13	458
43	Franche-Comté	25	1	07	616	Villars-Saint-Georges	246	1	247
43	Franche-Comté	25	2	21	617	Villars-sous-Dampjoux	395	7	402
43	Franche-Comté	25	2	21	618	Villars-sous-Écot	379	7	386
43	Franche-Comté	25	3	15	620	Ville-du-Pont	301	4	305
43	Franche-Comté	25	3	17	619	Les Villedieu	172	3	175
43	Franche-Comté	25	3	11	621	Villeneuve-d;Amont	273	36	309
43	Franche-Comté	25	1	02	622	Villers-Buzon	262	13	275
43	Franche-Comté	25	3	19	623	Villers-Chief	114	4	118
43	Franche-Comté	25	1	24	624	Villers-Grélot	154	3	157
43	Franche-Comté	25	3	19	625	Villers-la-Combe	49	3	52
43	Franche-Comté	25	3	16	321	Villers-le-Lac	4435	137	4572
43	Franche-Comté	25	1	04	626	Villers-Saint-Martin	217	2	219
43	Franche-Comté	25	3	11	627	Villers-sous-Chalamont	271	13	284
43	Franche-Comté	25	1	18	628	Villers-sous-Montrond	180	10	190
43	Franche-Comté	25	1	04	629	Voillans	208	8	216
43	Franche-Comté	25	1	18	630	Voires	55	2	57
43	Franche-Comté	25	1	07	631	Vorges-les-Pins	542	8	550
43	Franche-Comté	25	2	35	632	Voujeaucourt	3411	79	3490
43	Franche-Comté	25	1	18	633	Vuillafans	697	18	715
43	Franche-Comté	25	3	20	634	Vuillecin	588	22	610
43	Franche-Comté	25	2	08	635	Vyt-lès-Belvoir	180	9	189
82	Rhône-Alpes	26	1	09	001	Aix-en-Diois	357	9	366
82	Rhône-Alpes	26	3	26	002	Albon	1727	41	1768
82	Rhône-Alpes	26	2	10	003	Aleyrac	51	2	53
82	Rhône-Alpes	26	3	02	004	Alixan	2408	53	2461
82	Rhône-Alpes	26	2	33	005	Allan	1600	53	1653
82	Rhône-Alpes	26	1	07	006	Allex	2495	81	2576
82	Rhône-Alpes	26	3	13	007	Ambonil	119	7	126
82	Rhône-Alpes	26	2	16	008	Ancône	1114	29	1143
82	Rhône-Alpes	26	3	26	009	Andancette	1265	20	1285
82	Rhône-Alpes	26	3	26	010	Anneyron	3859	111	3970
82	Rhône-Alpes	26	1	07	011	Aouste-sur-Sye	2347	74	2421
82	Rhône-Alpes	26	1	17	012	Arnayon	32	0	32
82	Rhône-Alpes	26	2	18	013	Arpavon	80	2	82
82	Rhône-Alpes	26	3	23	014	Arthémonay	539	16	555
82	Rhône-Alpes	26	1	22	015	Aubenasson	68	3	71
82	Rhône-Alpes	26	2	18	016	Aubres	424	13	437
82	Rhône-Alpes	26	1	14	017	Aucelon	23	5	28
82	Rhône-Alpes	26	2	27	018	Aulan	5	0	5
82	Rhône-Alpes	26	1	22	019	Aurel	238	9	247
82	Rhône-Alpes	26	1	08	021	Autichamp	139	7	146
82	Rhône-Alpes	26	2	27	022	Ballons	81	2	83
82	Rhône-Alpes	26	3	02	023	Barbières	834	10	844
82	Rhône-Alpes	26	3	04	024	Barcelonne	359	7	366
82	Rhône-Alpes	26	1	14	025	Barnave	166	5	171
82	Rhône-Alpes	26	2	27	026	Barret-de-Lioure	75	2	77
82	Rhône-Alpes	26	1	09	027	Barsac	159	7	166
82	Rhône-Alpes	26	3	23	028	Bathernay	251	11	262
82	Rhône-Alpes	26	1	14	030	La Bâtie-des-Fonds	8	0	8
82	Rhône-Alpes	26	2	15	031	La Bâtie-Rolland	921	20	941
82	Rhône-Alpes	26	3	04	032	La Baume-Cornillane	454	13	467
82	Rhône-Alpes	26	3	02	034	La Baume-d;Hostun	545	10	555
82	Rhône-Alpes	26	2	25	033	La Baume-de-Transit	838	29	867
82	Rhône-Alpes	26	1	07	035	Beaufort-sur-Gervanne	417	12	429
82	Rhône-Alpes	26	1	14	036	Beaumont-en-Diois	79	5	84
82	Rhône-Alpes	26	3	34	037	Beaumont-lès-Valence	3796	114	3910
82	Rhône-Alpes	26	3	28	038	Beaumont-Monteux	1103	22	1125
82	Rhône-Alpes	26	3	02	039	Beauregard-Baret	792	14	806
82	Rhône-Alpes	26	1	14	040	Beaurières	85	2	87
82	Rhône-Alpes	26	3	26	041	Beausemblant	1301	36	1337
82	Rhône-Alpes	26	3	34	042	Beauvallon	1595	39	1634
82	Rhône-Alpes	26	2	03	043	Beauvoisin	181	8	189
82	Rhône-Alpes	26	2	10	045	La Bégude-de-Mazenc	1519	53	1572
82	Rhône-Alpes	26	2	03	046	Bellecombe-Tarendol	96	4	100
82	Rhône-Alpes	26	1	17	047	Bellegarde-en-Diois	75	2	77
82	Rhône-Alpes	26	2	03	048	Bénivay-Ollon	67	3	70
82	Rhône-Alpes	26	3	02	049	Bésayes	1103	29	1132
82	Rhône-Alpes	26	2	03	050	Bésignan	65	3	68
82	Rhône-Alpes	26	1	01	051	Bézaudun-sur-Bîne	87	5	92
82	Rhône-Alpes	26	2	15	052	Bonlieu-sur-Roubion	372	8	380
82	Rhône-Alpes	26	2	25	054	Bouchet	1204	22	1226
82	Rhône-Alpes	26	1	06	055	Boulc	128	3	131
82	Rhône-Alpes	26	1	01	056	Bourdeaux	621	15	636
82	Rhône-Alpes	26	3	02	057	Bourg-de-Péage	10128	253	10381
82	Rhône-Alpes	26	3	32	058	Bourg-lès-Valence	18623	510	19133
82	Rhône-Alpes	26	3	24	059	Bouvante	243	9	252
82	Rhône-Alpes	26	1	01	060	Bouvières	150	7	157
82	Rhône-Alpes	26	3	23	061	Bren	536	11	547
82	Rhône-Alpes	26	1	17	062	Brette	33	0	33
82	Rhône-Alpes	26	2	03	063	Buis-les-Baronnies	2271	100	2371
82	Rhône-Alpes	26	3	04	064	Chabeuil	6690	179	6869
82	Rhône-Alpes	26	1	08	065	Chabrillan	666	20	686
82	Rhône-Alpes	26	3	04	066	Le Chaffal	49	1	50
82	Rhône-Alpes	26	1	17	067	Chalancon	63	0	63
82	Rhône-Alpes	26	3	35	068	Le Chalon	210	2	212
82	Rhône-Alpes	26	1	09	069	Chamaloc	120	4	124
82	Rhône-Alpes	26	2	12	070	Chamaret	548	17	565
82	Rhône-Alpes	26	3	28	071	Chanos-Curson	1095	20	1115
82	Rhône-Alpes	26	3	28	072	Chantemerle-les-Blés	1114	22	1136
82	Rhône-Alpes	26	2	12	073	Chantemerle-lès-Grignan	223	7	230
82	Rhône-Alpes	26	1	05	074	La Chapelle-en-Vercors	675	123	798
82	Rhône-Alpes	26	2	20	075	La Charce	30	0	30
82	Rhône-Alpes	26	1	14	076	Charens	25	2	27
82	Rhône-Alpes	26	3	23	077	Charmes-sur-l;Herbasse	908	24	932
82	Rhône-Alpes	26	2	15	078	Charols	781	18	799
82	Rhône-Alpes	26	3	02	079	Charpey	1276	12	1288
82	Rhône-Alpes	26	1	22	080	Chastel-Arnaud	47	1	48
82	Rhône-Alpes	26	3	04	081	Châteaudouble	556	21	577
82	Rhône-Alpes	26	2	18	082	Châteauneuf-de-Bordette	99	1	100
82	Rhône-Alpes	26	3	26	083	Châteauneuf-de-Galaure	1572	520	2092
82	Rhône-Alpes	26	2	33	085	Châteauneuf-du-Rhône	2380	59	2439
82	Rhône-Alpes	26	3	02	084	Châteauneuf-sur-Isère	3807	117	3924
82	Rhône-Alpes	26	1	06	086	Châtillon-en-Diois	563	18	581
82	Rhône-Alpes	26	3	35	087	Châtillon-Saint-Jean	1178	24	1202
82	Rhône-Alpes	26	3	02	088	Chatuzange-le-Goubet	4733	106	4839
82	Rhône-Alpes	26	2	18	089	Chaudebonne	57	3	60
82	Rhône-Alpes	26	1	22	090	La Chaudière	21	0	21
82	Rhône-Alpes	26	2	20	091	Chauvac-Laux-Montaux	43	3	46
82	Rhône-Alpes	26	3	23	092	Chavannes	528	10	538
82	Rhône-Alpes	26	2	25	093	Clansayes	544	27	571
82	Rhône-Alpes	26	3	26	094	Claveyson	894	20	914
82	Rhône-Alpes	26	2	15	095	Cléon-d;Andran	883	10	893
82	Rhône-Alpes	26	3	21	096	Clérieux	2040	41	2081
82	Rhône-Alpes	26	3	13	097	Cliousclat	636	17	653
82	Rhône-Alpes	26	1	07	098	Cobonne	165	3	168
82	Rhône-Alpes	26	2	12	099	Colonzelle	478	20	498
82	Rhône-Alpes	26	3	04	100	Combovin	409	9	418
82	Rhône-Alpes	26	2	10	101	Comps	167	7	174
82	Rhône-Alpes	26	2	15	102	Condillac	147	8	155
82	Rhône-Alpes	26	2	18	103	Condorcet	484	11	495
82	Rhône-Alpes	26	2	20	104	Cornillac	85	0	85
82	Rhône-Alpes	26	2	20	105	Cornillon-sur-l;Oule	74	1	75
82	Rhône-Alpes	26	2	15	106	La Coucourde	978	21	999
82	Rhône-Alpes	26	3	35	107	Crépol	521	13	534
82	Rhône-Alpes	26	1	99	108	Crest	7915	298	8213
82	Rhône-Alpes	26	3	28	110	Crozes-Hermitage	557	5	562
82	Rhône-Alpes	26	1	01	111	Crupies	91	2	93
82	Rhône-Alpes	26	2	18	112	Curnier	197	10	207
82	Rhône-Alpes	26	1	09	113	Die	4357	271	4628
82	Rhône-Alpes	26	2	10	114	Dieulefit	3004	169	3173
82	Rhône-Alpes	26	1	08	115	Divajeu	608	74	682
82	Rhône-Alpes	26	2	19	116	Donzère	5343	117	5460
82	Rhône-Alpes	26	3	24	117	Échevis	52	2	54
82	Rhône-Alpes	26	3	11	118	Épinouze	1450	24	1474
82	Rhône-Alpes	26	3	28	119	Érôme	845	21	866
82	Rhône-Alpes	26	2	33	121	Espeluche	1050	44	1094
82	Rhône-Alpes	26	1	22	122	Espenel	116	7	123
82	Rhône-Alpes	26	1	17	123	Establet	28	2	30
82	Rhône-Alpes	26	3	34	124	Étoile-sur-Rhône	4731	115	4846
82	Rhône-Alpes	26	1	07	125	Eurre	1122	17	1139
82	Rhône-Alpes	26	2	27	126	Eygalayes	69	3	72
82	Rhône-Alpes	26	2	03	127	Eygaliers	107	6	113
82	Rhône-Alpes	26	1	22	128	Eygluy-Escoulin	64	1	65
82	Rhône-Alpes	26	3	02	129	Eymeux	1003	22	1025
82	Rhône-Alpes	26	2	18	130	Eyroles	27	0	27
82	Rhône-Alpes	26	2	10	131	Eyzahut	133	3	136
82	Rhône-Alpes	26	3	26	133	Fay-le-Clos	153	7	160
82	Rhône-Alpes	26	1	01	134	Félines-sur-Rimandoule	70	1	71
82	Rhône-Alpes	26	2	27	135	Ferrassières	118	2	120
82	Rhône-Alpes	26	1	08	137	Francillon-sur-Roubion	178	6	184
82	Rhône-Alpes	26	2	19	138	La Garde-Adhémar	1118	60	1178
82	Rhône-Alpes	26	3	35	139	Génissieux	1992	71	2063
82	Rhône-Alpes	26	3	28	380	Gervans	556	15	571
82	Rhône-Alpes	26	3	21	140	Geyssans	620	29	649
82	Rhône-Alpes	26	1	07	141	Gigors-et-Lozeron	168	9	177
82	Rhône-Alpes	26	1	06	142	Glandage	97	6	103
82	Rhône-Alpes	26	3	11	143	Le Grand-Serre	834	48	882
82	Rhône-Alpes	26	1	08	144	Grane	1746	68	1814
82	Rhône-Alpes	26	2	19	145	Les Granges-Gontardes	542	10	552
82	Rhône-Alpes	26	3	28	379	Granges-les-Beaumont	936	27	963
82	Rhône-Alpes	26	2	12	146	Grignan	1607	43	1650
82	Rhône-Alpes	26	1	17	147	Gumiane	24	0	24
82	Rhône-Alpes	26	3	11	148	Hauterives	1680	52	1732
82	Rhône-Alpes	26	3	02	149	Hostun	956	23	979
82	Rhône-Alpes	26	2	27	150	Izon-la-Bruisse	8	0	8
82	Rhône-Alpes	26	3	02	381	Jaillans	871	18	889
82	Rhône-Alpes	26	1	14	152	Jonchères	39	0	39
82	Rhône-Alpes	26	2	27	153	Laborel	105	3	108
82	Rhône-Alpes	26	2	27	154	Lachau	215	2	217
82	Rhône-Alpes	26	3	11	155	Lapeyrouse-Mornay	1127	26	1153
82	Rhône-Alpes	26	3	28	156	Larnage	993	22	1015
82	Rhône-Alpes	26	2	15	157	La Laupie	691	14	705
82	Rhône-Alpes	26	1	09	159	Laval-d;Aix	121	1	122
82	Rhône-Alpes	26	3	26	160	Laveyron	977	24	1001
82	Rhône-Alpes	26	2	20	161	Lemps	44	2	46
82	Rhône-Alpes	26	3	11	162	Lens-Lestang	825	20	845
82	Rhône-Alpes	26	3	24	163	Léoncel	57	2	59
82	Rhône-Alpes	26	1	14	164	Lesches-en-Diois	58	1	59
82	Rhône-Alpes	26	3	13	165	Livron-sur-Drôme	8972	121	9093
82	Rhône-Alpes	26	3	13	166	Loriol-sur-Drôme	5821	102	5923
82	Rhône-Alpes	26	1	14	167	Luc-en-Diois	499	15	514
82	Rhône-Alpes	26	1	06	168	Lus-la-Croix-Haute	517	10	527
82	Rhône-Alpes	26	2	33	169	Malataverne	1821	59	1880
82	Rhône-Alpes	26	3	04	170	Malissard	3224	139	3363
82	Rhône-Alpes	26	2	15	171	Manas	183	6	189
82	Rhône-Alpes	26	3	11	172	Manthes	633	14	647
82	Rhône-Alpes	26	3	02	173	Marches	751	21	772
82	Rhône-Alpes	26	3	23	174	Margès	925	20	945
82	Rhône-Alpes	26	1	09	175	Marignac-en-Diois	175	6	181
82	Rhône-Alpes	26	2	15	176	Marsanne	1181	35	1216
82	Rhône-Alpes	26	3	23	177	Marsaz	716	28	744
82	Rhône-Alpes	26	1	06	178	Menglon	411	13	424
82	Rhône-Alpes	26	3	28	179	Mercurol	2168	55	2223
82	Rhône-Alpes	26	2	03	180	Mérindol-les-Oliviers	205	10	215
82	Rhône-Alpes	26	2	27	181	Mévouillon	214	5	219
82	Rhône-Alpes	26	2	18	182	Mirabel-aux-Baronnies	1537	44	1581
82	Rhône-Alpes	26	1	07	183	Mirabel-et-Blacons	893	37	930
82	Rhône-Alpes	26	3	35	184	Miribel	263	4	267
82	Rhône-Alpes	26	3	13	185	Mirmande	497	18	515
82	Rhône-Alpes	26	1	14	186	Miscon	58	2	60
82	Rhône-Alpes	26	1	09	187	Molières-Glandaz	118	2	120
82	Rhône-Alpes	26	2	03	188	Mollans-sur-Ouvèze	1061	17	1078
82	Rhône-Alpes	26	2	27	189	Montauban-sur-l;Ouvèze	104	3	107
82	Rhône-Alpes	26	2	18	190	Montaulieu	74	3	77
82	Rhône-Alpes	26	2	33	191	Montboucher-sur-Jabron	2083	37	2120
82	Rhône-Alpes	26	2	12	192	Montbrison-sur-Lez	309	12	321
82	Rhône-Alpes	26	2	27	193	Montbrun-les-Bains	470	22	492
82	Rhône-Alpes	26	3	23	194	Montchenu	572	21	593
82	Rhône-Alpes	26	1	07	195	Montclar-sur-Gervanne	184	4	188
82	Rhône-Alpes	26	3	34	196	Montéléger	1836	130	1966
82	Rhône-Alpes	26	3	04	197	Montélier	3528	101	3629
82	Rhône-Alpes	26	2	96	198	Montélimar	35314	1355	36669
82	Rhône-Alpes	26	2	20	199	Montferrand-la-Fare	43	0	43
82	Rhône-Alpes	26	2	27	200	Montfroc	80	2	82
82	Rhône-Alpes	26	2	27	201	Montguers	57	0	57
82	Rhône-Alpes	26	2	10	202	Montjoux	322	4	326
82	Rhône-Alpes	26	2	12	203	Montjoyer	267	6	273
82	Rhône-Alpes	26	1	14	204	Montlaur-en-Diois	156	7	163
82	Rhône-Alpes	26	1	09	205	Montmaur-en-Diois	79	5	84
82	Rhône-Alpes	26	3	04	206	Montmeyran	2859	79	2938
82	Rhône-Alpes	26	3	35	207	Montmiral	620	27	647
82	Rhône-Alpes	26	1	07	208	Montoison	1734	41	1775
82	Rhône-Alpes	26	2	20	209	Montréal-les-Sources	32	2	34
82	Rhône-Alpes	26	3	11	210	Montrigaud	490	9	499
82	Rhône-Alpes	26	2	25	211	Montségur-sur-Lauzon	1181	41	1222
82	Rhône-Alpes	26	3	04	212	Montvendre	1054	34	1088
82	Rhône-Alpes	26	3	11	213	Moras-en-Valloire	612	23	635
82	Rhône-Alpes	26	1	01	214	Mornans	70	0	70
82	Rhône-Alpes	26	1	17	215	La Motte-Chalancon	395	4	399
82	Rhône-Alpes	26	3	26	216	La Motte-de-Galaure	772	14	786
82	Rhône-Alpes	26	3	24	217	La Motte-Fanjas	165	5	170
82	Rhône-Alpes	26	3	21	218	Mours-Saint-Eusèbe	2535	68	2603
82	Rhône-Alpes	26	3	26	219	Mureils	376	6	382
82	Rhône-Alpes	26	2	18	220	Nyons	6950	295	7245
82	Rhône-Alpes	26	1	07	221	Omblèze	68	0	68
82	Rhône-Alpes	26	2	10	222	Orcinas	30	1	31
82	Rhône-Alpes	26	3	24	223	Oriol-en-Royans	533	20	553
82	Rhône-Alpes	26	1	07	224	Ourches	233	8	241
82	Rhône-Alpes	26	3	35	225	Parnans	672	13	685
82	Rhône-Alpes	26	2	12	226	Le Pègue	395	11	406
82	Rhône-Alpes	26	2	20	227	Pelonne	18	0	18
82	Rhône-Alpes	26	2	03	229	La Penne-sur-l;Ouvèze	95	10	105
82	Rhône-Alpes	26	1	14	228	Pennes-le-Sec	23	0	23
82	Rhône-Alpes	26	3	21	231	Peyrins	2424	97	2521
82	Rhône-Alpes	26	3	04	232	Peyrus	632	24	656
82	Rhône-Alpes	26	2	18	233	Piégon	258	13	271
82	Rhône-Alpes	26	1	08	234	Piégros-la-Clastre	845	34	879
82	Rhône-Alpes	26	2	19	235	Pierrelatte	13026	311	13337
82	Rhône-Alpes	26	2	03	236	Pierrelongue	209	6	215
82	Rhône-Alpes	26	2	18	238	Les Pilles	254	5	259
82	Rhône-Alpes	26	2	03	239	Plaisians	175	9	184
82	Rhône-Alpes	26	1	07	240	Plan-de-Baix	131	5	136
82	Rhône-Alpes	26	1	01	241	Le Poët-Célard	127	2	129
82	Rhône-Alpes	26	2	03	242	Le Poët-en-Percip	19	0	19
82	Rhône-Alpes	26	2	10	243	Le Poët-Laval	944	60	1004
82	Rhône-Alpes	26	2	20	244	Le Poët-Sigillat	118	2	120
82	Rhône-Alpes	26	2	20	245	Pommerol	17	1	18
82	Rhône-Alpes	26	1	09	246	Ponet-et-Saint-Auban	129	3	132
82	Rhône-Alpes	26	3	26	247	Ponsas	477	18	495
82	Rhône-Alpes	26	2	10	249	Pont-de-Barret	586	24	610
82	Rhône-Alpes	26	3	28	250	Pont-de-l;Isère	2871	37	2908
82	Rhône-Alpes	26	1	09	248	Pontaix	166	0	166
82	Rhône-Alpes	26	2	33	251	Portes-en-Valdaine	382	16	398
82	Rhône-Alpes	26	3	34	252	Portes-lès-Valence	9462	158	9620
82	Rhône-Alpes	26	1	14	253	Poyols	76	0	76
82	Rhône-Alpes	26	1	17	254	Pradelle	20	2	22
82	Rhône-Alpes	26	1	14	255	Les Prés	22	0	22
82	Rhône-Alpes	26	2	03	256	Propiac	107	3	110
82	Rhône-Alpes	26	1	08	258	Puy-Saint-Martin	842	25	867
82	Rhône-Alpes	26	2	33	257	Puygiron	447	12	459
82	Rhône-Alpes	26	3	26	259	Ratières	273	11	284
82	Rhône-Alpes	26	2	12	261	Réauville	377	10	387
82	Rhône-Alpes	26	1	14	262	Recoubeau-Jansac	244	8	252
82	Rhône-Alpes	26	2	27	263	Reilhanette	145	8	153
82	Rhône-Alpes	26	2	20	264	Rémuzat	329	7	336
82	Rhône-Alpes	26	1	08	020	La Répara-Auriples	237	7	244
82	Rhône-Alpes	26	1	22	266	Rimon-et-Savel	32	2	34
82	Rhône-Alpes	26	2	03	267	Rioms	26	3	29
82	Rhône-Alpes	26	3	28	271	La Roche-de-Glun	3167	63	3230
82	Rhône-Alpes	26	2	10	276	Roche-Saint-Secret-Béconne	363	13	376
82	Rhône-Alpes	26	1	08	277	La Roche-sur-Grane	164	1	165
82	Rhône-Alpes	26	2	03	278	La Roche-sur-le-Buis	336	9	345
82	Rhône-Alpes	26	2	10	268	Rochebaudin	124	5	129
82	Rhône-Alpes	26	2	03	269	Rochebrune	52	0	52
82	Rhône-Alpes	26	3	24	270	Rochechinard	100	13	113
82	Rhône-Alpes	26	2	33	272	Rochefort-en-Valdaine	344	16	360
82	Rhône-Alpes	26	3	02	273	Rochefort-Samson	948	26	974
82	Rhône-Alpes	26	1	17	274	Rochefourchat	1	0	1
82	Rhône-Alpes	26	2	25	275	Rochegude	1470	40	1510
82	Rhône-Alpes	26	2	03	279	La Rochette-du-Buis	65	3	68
82	Rhône-Alpes	26	3	97	281	Romans-sur-Isère	33536	785	34321
82	Rhône-Alpes	26	1	09	282	Romeyer	213	5	218
82	Rhône-Alpes	26	1	17	283	Rottier	30	2	32
82	Rhône-Alpes	26	2	12	284	Roussas	345	17	362
82	Rhône-Alpes	26	2	12	285	Rousset-les-Vignes	287	19	306
82	Rhône-Alpes	26	2	20	286	Roussieux	23	0	23
82	Rhône-Alpes	26	2	15	287	Roynac	458	22	480
82	Rhône-Alpes	26	2	20	288	Sahune	326	8	334
82	Rhône-Alpes	26	1	22	289	Saillans	1159	21	1180
82	Rhône-Alpes	26	1	05	290	Saint-Agnan-en-Vercors	378	19	397
82	Rhône-Alpes	26	1	09	291	Saint-Andéol	60	1	61
82	Rhône-Alpes	26	2	03	292	Saint-Auban-sur-l;Ouvèze	220	0	220
82	Rhône-Alpes	26	3	26	293	Saint-Avit	312	18	330
82	Rhône-Alpes	26	3	21	294	Saint-Bardoux	582	15	597
82	Rhône-Alpes	26	3	26	295	Saint-Barthélemy-de-Vals	1891	36	1927
82	Rhône-Alpes	26	1	22	296	Saint-Benoit-en-Diois	27	4	31
82	Rhône-Alpes	26	3	35	297	Saint-Bonnet-de-Valclérieux	216	3	219
82	Rhône-Alpes	26	3	11	298	Saint-Christophe-et-le-Laris	402	10	412
82	Rhône-Alpes	26	1	17	300	Saint-Dizier-en-Diois	34	0	34
82	Rhône-Alpes	26	3	23	301	Saint-Donat-sur-l;Herbasse	3854	99	3953
82	Rhône-Alpes	26	2	18	304	Saint-Ferréol-Trente-Pas	223	9	232
82	Rhône-Alpes	26	2	15	305	Saint-Gervais-sur-Roubion	825	22	847
82	Rhône-Alpes	26	3	24	307	Saint-Jean-en-Royans	2979	91	3070
82	Rhône-Alpes	26	1	09	308	Saint-Julien-en-Quint	137	3	140
82	Rhône-Alpes	26	1	05	309	Saint-Julien-en-Vercors	226	4	230
82	Rhône-Alpes	26	3	35	310	Saint-Laurent-d;Onay	138	3	141
82	Rhône-Alpes	26	3	24	311	Saint-Laurent-en-Royans	1324	78	1402
82	Rhône-Alpes	26	2	15	312	Saint-Marcel-lès-Sauzet	1147	31	1178
82	Rhône-Alpes	26	3	32	313	Saint-Marcel-lès-Valence	5293	114	5407
82	Rhône-Alpes	26	3	26	314	Saint-Martin-d;Août	401	16	417
82	Rhône-Alpes	26	1	05	315	Saint-Martin-en-Vercors	396	12	408
82	Rhône-Alpes	26	3	24	316	Saint-Martin-le-Colonel	163	6	169
82	Rhône-Alpes	26	2	18	317	Saint-Maurice-sur-Eygues	661	13	674
82	Rhône-Alpes	26	2	20	318	Saint-May	43	1	44
82	Rhône-Alpes	26	3	35	319	Saint-Michel-sur-Savasse	546	6	552
82	Rhône-Alpes	26	3	24	320	Saint-Nazaire-en-Royans	749	5	754
82	Rhône-Alpes	26	1	17	321	Saint-Nazaire-le-Désert	141	2	143
82	Rhône-Alpes	26	2	12	322	Saint-Pantaléon-les-Vignes	419	14	433
82	Rhône-Alpes	26	3	35	323	Saint-Paul-lès-Romans	1760	48	1808
82	Rhône-Alpes	26	2	25	324	Saint-Paul-Trois-Châteaux	8691	518	9209
82	Rhône-Alpes	26	3	26	325	Saint-Rambert-d;Albon	5961	74	6035
82	Rhône-Alpes	26	2	25	326	Saint-Restitut	1390	63	1453
82	Rhône-Alpes	26	1	06	327	Saint-Roman	163	12	175
82	Rhône-Alpes	26	1	22	328	Saint-Sauveur-en-Diois	63	0	63
82	Rhône-Alpes	26	2	03	329	Saint-Sauveur-Gouvernet	197	9	206
82	Rhône-Alpes	26	3	11	330	Saint-Sorlin-en-Valloire	2139	36	2175
82	Rhône-Alpes	26	3	24	331	Saint-Thomas-en-Royans	520	14	534
82	Rhône-Alpes	26	3	26	332	Saint-Uze	1949	19	1968
82	Rhône-Alpes	26	3	26	333	Saint-Vallier	4008	138	4146
82	Rhône-Alpes	26	3	02	382	Saint-Vincent-la-Commanderie	413	9	422
82	Rhône-Alpes	26	1	09	299	Sainte-Croix	82	3	85
82	Rhône-Alpes	26	3	24	302	Sainte-Eulalie-en-Royans	549	11	560
82	Rhône-Alpes	26	2	03	303	Sainte-Euphémie-sur-Ouvèze	86	3	89
82	Rhône-Alpes	26	2	18	306	Sainte-Jalle	277	7	284
82	Rhône-Alpes	26	2	10	334	Salettes	125	1	126
82	Rhône-Alpes	26	2	12	335	Salles-sous-Bois	193	10	203
82	Rhône-Alpes	26	1	08	336	Saou	515	12	527
82	Rhône-Alpes	26	3	13	337	Saulce-sur-Rhône	1768	37	1805
82	Rhône-Alpes	26	2	15	338	Sauzet	1836	84	1920
82	Rhône-Alpes	26	2	15	339	Savasse	1306	39	1345
82	Rhône-Alpes	26	2	27	340	Séderon	290	9	299
82	Rhône-Alpes	26	3	28	341	Serves-sur-Rhône	749	8	757
82	Rhône-Alpes	26	2	25	342	Solérieux	327	5	332
82	Rhône-Alpes	26	2	10	343	Souspierre	98	0	98
82	Rhône-Alpes	26	1	08	344	Soyans	338	18	356
82	Rhône-Alpes	26	1	07	346	Suze	234	11	245
82	Rhône-Alpes	26	2	25	345	Suze-la-Rousse	1905	67	1972
82	Rhône-Alpes	26	3	28	347	Tain-l;Hermitage	5853	197	6050
82	Rhône-Alpes	26	2	12	348	Taulignan	1580	36	1616
82	Rhône-Alpes	26	3	11	349	Tersanne	327	6	333
82	Rhône-Alpes	26	2	10	350	Teyssières	81	3	84
82	Rhône-Alpes	26	1	01	351	Les Tonils	15	0	15
82	Rhône-Alpes	26	2	33	352	La Touche	212	18	230
82	Rhône-Alpes	26	2	15	353	Les Tourrettes	964	7	971
82	Rhône-Alpes	26	1	06	354	Treschenu-Creyers	134	4	138
82	Rhône-Alpes	26	3	35	355	Triors	563	11	574
82	Rhône-Alpes	26	1	01	356	Truinas	130	1	131
82	Rhône-Alpes	26	2	25	357	Tulette	1931	35	1966
82	Rhône-Alpes	26	3	04	358	Upie	1466	44	1510
82	Rhône-Alpes	26	1	09	359	Vachères-en-Quint	28	2	30
82	Rhône-Alpes	26	1	14	136	Val-Maravel	40	2	42
82	Rhône-Alpes	26	2	12	360	Valaurie	528	20	548
82	Rhône-Alpes	26	1	14	361	Valdrôme	142	7	149
82	Rhône-Alpes	26	3	98	362	Valence	63405	1638	65043
82	Rhône-Alpes	26	2	18	363	Valouse	42	1	43
82	Rhône-Alpes	26	1	05	364	Vassieux-en-Vercors	344	14	358
82	Rhône-Alpes	26	1	07	365	Vaunaveys-la-Rochette	587	20	607
82	Rhône-Alpes	26	3	28	366	Veaunes	287	5	292
82	Rhône-Alpes	26	2	18	367	Venterol	662	23	685
82	Rhône-Alpes	26	1	22	368	Vercheny	434	14	448
82	Rhône-Alpes	26	2	20	369	Verclause	71	2	73
82	Rhône-Alpes	26	2	03	370	Vercoiran	121	2	123
82	Rhône-Alpes	26	1	22	371	Véronne	39	2	41
82	Rhône-Alpes	26	2	27	372	Vers-sur-Méouge	41	1	42
82	Rhône-Alpes	26	2	10	373	Vesc	284	15	299
82	Rhône-Alpes	26	2	27	374	Villebois-les-Pins	19	1	20
82	Rhône-Alpes	26	2	27	375	Villefranche-le-Château	22	1	23
82	Rhône-Alpes	26	2	20	376	Villeperdrix	105	3	108
82	Rhône-Alpes	26	2	18	377	Vinsobres	1116	57	1173
82	Rhône-Alpes	26	1	17	378	Volvent	42	2	44
23	Haute-Normandie	27	2	09	001	Aclou	266	1	267
23	Haute-Normandie	27	3	25	002	Acon	473	4	477
23	Haute-Normandie	27	1	39	003	Acquigny	1574	67	1641
23	Haute-Normandie	27	3	26	004	Aigleville	344	2	346
23	Haute-Normandie	27	1	42	005	Ailly	1095	21	1116
23	Haute-Normandie	27	2	29	006	Aizier	128	1	129
23	Haute-Normandie	27	2	03	007	Ajou	257	1	258
23	Haute-Normandie	27	1	28	008	Alizay	1410	10	1420
23	Haute-Normandie	27	3	31	009	Ambenay	546	8	554
23	Haute-Normandie	27	1	20	010	Amécourt	177	4	181
23	Haute-Normandie	27	2	01	011	Amfreville-la-Campagne	896	16	912
23	Haute-Normandie	27	1	18	012	Amfreville-les-Champs	446	7	453
23	Haute-Normandie	27	1	18	013	Amfreville-sous-les-Monts	543	10	553
23	Haute-Normandie	27	1	39	014	Amfreville-sur-Iton	772	14	786
23	Haute-Normandie	27	1	21	015	Andé	1094	22	1116
23	Haute-Normandie	27	1	02	016	Les Andelys	8205	196	8401
23	Haute-Normandie	27	3	17	017	Angerville-la-Campagne	1113	46	1159
23	Haute-Normandie	27	2	23	018	Appeville-Annebault	884	12	896
23	Haute-Normandie	27	3	35	019	Armentières-sur-Avre	186	3	189
23	Haute-Normandie	27	3	38	020	Arnières-sur-Iton	1614	45	1659
23	Haute-Normandie	27	2	12	021	Asnières	299	3	302
23	Haute-Normandie	27	1	19	022	Aubevoye	4794	73	4867
23	Haute-Normandie	27	3	38	023	Aulnay-sur-Iton	738	19	757
23	Haute-Normandie	27	1	42	025	Autheuil-Authouillet	865	22	887
23	Haute-Normandie	27	1	20	026	Authevernes	359	9	368
23	Haute-Normandie	27	3	32	027	Les Authieux	264	6	270
23	Haute-Normandie	27	2	23	028	Authou	355	3	358
23	Haute-Normandie	27	3	16	031	Aviron	1109	45	1154
23	Haute-Normandie	27	3	13	032	Avrilly	442	8	450
23	Haute-Normandie	27	3	16	033	Bacquepuis	324	9	333
23	Haute-Normandie	27	1	18	034	Bacqueville	552	11	563
23	Haute-Normandie	27	2	12	035	Bailleul-la-Vallée	118	1	119
23	Haute-Normandie	27	3	35	036	Bâlines	456	13	469
23	Haute-Normandie	27	2	04	037	Barc	1063	15	1078
23	Haute-Normandie	27	3	35	038	Les Barils	191	7	198
23	Haute-Normandie	27	2	30	039	Barneville-sur-Seine	467	39	506
23	Haute-Normandie	27	2	04	040	Barquet	394	10	404
23	Haute-Normandie	27	2	03	041	La Barre-en-Ouche	981	11	992
23	Haute-Normandie	27	2	34	042	Barville	76	2	78
23	Haute-Normandie	27	3	08	043	Les Baux-de-Breteuil	664	10	674
23	Haute-Normandie	27	3	17	044	Les Baux-Sainte-Croix	912	43	955
23	Haute-Normandie	27	1	20	045	Bazincourt-sur-Epte	681	9	690
23	Haute-Normandie	27	2	34	046	Bazoques	169	3	172
23	Haute-Normandie	27	3	11	047	Beaubray	292	10	302
23	Haute-Normandie	27	1	22	048	Beauficel-en-Lyons	175	4	179
23	Haute-Normandie	27	2	03	049	Beaumesnil	572	71	643
23	Haute-Normandie	27	2	04	051	Beaumont-le-Roger	2994	36	3030
23	Haute-Normandie	27	2	04	050	Beaumontel	713	16	729
23	Haute-Normandie	27	2	09	052	Le Bec-Hellouin	419	4	423
23	Haute-Normandie	27	2	01	053	Le Bec-Thomas	218	10	228
23	Haute-Normandie	27	3	08	054	Bémécourt	469	17	486
23	Haute-Normandie	27	3	24	055	Bérengeville-la-Campagne	288	5	293
23	Haute-Normandie	27	2	96	056	Bernay	10449	551	11000
23	Haute-Normandie	27	3	16	057	Bernienville	274	3	277
23	Haute-Normandie	27	1	42	058	Bernières-sur-Seine	328	9	337
23	Haute-Normandie	27	1	20	059	Bernouville	315	9	324
23	Haute-Normandie	27	1	14	060	Berthenonville	232	7	239
23	Haute-Normandie	27	2	09	061	Berthouville	290	5	295
23	Haute-Normandie	27	2	07	062	Berville-en-Roumois	760	17	777
23	Haute-Normandie	27	2	04	063	Berville-la-Campagne	160	2	162
23	Haute-Normandie	27	2	06	064	Berville-sur-Mer	601	7	608
23	Haute-Normandie	27	2	06	065	Beuzeville	4178	57	4235
23	Haute-Normandie	27	1	22	066	Bézu-la-Forêt	245	5	250
23	Haute-Normandie	27	1	20	067	Bézu-Saint-Éloi	1386	23	1409
23	Haute-Normandie	27	3	31	068	Bois-Anzeray	171	2	173
23	Haute-Normandie	27	3	31	069	Bois-Arnault	743	24	767
23	Haute-Normandie	27	2	12	071	Le Bois-Hellain	234	3	237
23	Haute-Normandie	27	1	14	072	Bois-Jérôme-Saint-Ouen	746	29	775
23	Haute-Normandie	27	3	32	073	Bois-le-Roi	1021	16	1037
23	Haute-Normandie	27	3	31	075	Bois-Normand-près-Lyre	365	1	366
23	Haute-Normandie	27	1	02	070	Boisemont	777	12	789
23	Haute-Normandie	27	2	09	074	Boisney	281	2	283
23	Haute-Normandie	27	3	26	076	Boisset-les-Prévanches	442	8	450
23	Haute-Normandie	27	2	07	077	Boissey-le-Châtel	879	12	891
23	Haute-Normandie	27	3	32	078	La Boissière	270	7	277
23	Haute-Normandie	27	2	34	079	Boissy-Lamberville	289	4	293
23	Haute-Normandie	27	3	26	081	Boncourt	172	0	172
23	Haute-Normandie	27	2	23	083	Bonneville-Aptot	225	4	229
23	Haute-Normandie	27	3	11	082	La Bonneville-sur-Iton	2301	43	2344
23	Haute-Normandie	27	2	07	084	Bosc-Bénard-Commin	313	0	313
23	Haute-Normandie	27	2	07	085	Bosc-Bénard-Crescy	363	5	368
23	Haute-Normandie	27	2	03	088	Bosc-Renoult-en-Ouche	166	2	168
23	Haute-Normandie	27	2	07	089	Bosc-Renoult-en-Roumois	427	11	438
23	Haute-Normandie	27	2	07	090	Le Bosc-Roger-en-Roumois	3178	61	3239
23	Haute-Normandie	27	2	30	091	Bosgouet	599	8	607
23	Haute-Normandie	27	2	07	092	Bosguérard-de-Marcouville	597	9	606
23	Haute-Normandie	27	2	07	093	Bosnormand	333	4	337
23	Haute-Normandie	27	1	22	094	Bosquentin	106	0	106
23	Haute-Normandie	27	2	09	095	Bosrobert	580	6	586
23	Haute-Normandie	27	3	31	096	Les Bottereaux	328	5	333
23	Haute-Normandie	27	1	02	097	Bouafles	671	16	687
23	Haute-Normandie	27	1	20	098	Bouchevilliers	74	0	74
23	Haute-Normandie	27	3	16	099	Le Boulay-Morin	682	13	695
23	Haute-Normandie	27	2	06	100	Boulleville	1005	16	1021
23	Haute-Normandie	27	2	29	101	Bouquelon	406	8	414
23	Haute-Normandie	27	2	30	102	Bouquetot	1041	15	1056
23	Haute-Normandie	27	2	30	103	Bourg-Achard	3011	47	3058
23	Haute-Normandie	27	1	18	104	Bourg-Beaudouin	768	10	778
23	Haute-Normandie	27	2	07	105	Bourgtheroulde-Infreville	2852	63	2915
23	Haute-Normandie	27	2	34	106	Bournainville-Faverolles	405	10	415
23	Haute-Normandie	27	2	29	107	Bourneville	882	22	904
23	Haute-Normandie	27	3	35	108	Bourth	1270	25	1295
23	Haute-Normandie	27	2	04	109	Bray	335	4	339
23	Haute-Normandie	27	2	23	110	Brestot	482	11	493
23	Haute-Normandie	27	3	32	111	Bretagnolles	184	5	189
23	Haute-Normandie	27	3	08	112	Breteuil	3347	127	3474
23	Haute-Normandie	27	2	09	113	Brétigny	168	1	169
23	Haute-Normandie	27	3	26	114	Breuilpont	1193	29	1222
23	Haute-Normandie	27	3	25	115	Breux-sur-Avre	360	7	367
23	Haute-Normandie	27	2	09	116	Brionne	4297	152	4449
23	Haute-Normandie	27	2	10	117	Broglie	1099	22	1121
23	Haute-Normandie	27	3	16	118	Brosville	656	24	680
23	Haute-Normandie	27	3	26	119	Bueil	1473	30	1503
23	Haute-Normandie	27	3	13	416	Buis-sur-Damville	977	22	999
23	Haute-Normandie	27	3	11	120	Burey	371	7	378
23	Haute-Normandie	27	1	14	121	Bus-Saint-Rémy	331	7	338
23	Haute-Normandie	27	1	14	122	Cahaignes	359	6	365
23	Haute-Normandie	27	3	26	123	Caillouet-Orgeville	412	36	448
23	Haute-Normandie	27	1	42	124	Cailly-sur-Eure	228	9	237
23	Haute-Normandie	27	2	09	125	Calleville	664	10	674
23	Haute-Normandie	27	2	27	126	Campigny	1018	10	1028
23	Haute-Normandie	27	3	24	127	Canappeville	660	14	674
23	Haute-Normandie	27	1	14	128	Cantiers	199	3	202
23	Haute-Normandie	27	2	05	129	Caorches-Saint-Nicolas	582	20	602
23	Haute-Normandie	27	2	10	130	Capelle-les-Grands	408	5	413
23	Haute-Normandie	27	2	41	131	Carsix	245	1	246
23	Haute-Normandie	27	3	38	132	Caugé	831	25	856
23	Haute-Normandie	27	2	30	133	Caumont	1002	17	1019
23	Haute-Normandie	27	2	30	134	Cauverville-en-Roumois	213	3	216
23	Haute-Normandie	27	3	24	135	Cesseville	441	10	451
23	Haute-Normandie	27	3	26	136	Chaignes	275	10	285
23	Haute-Normandie	27	3	31	137	Chaise-Dieu-du-Theil	227	18	245
23	Haute-Normandie	27	2	10	138	Chamblac	375	14	389
23	Haute-Normandie	27	3	31	139	Chambord	167	4	171
23	Haute-Normandie	27	3	36	140	Chambray	455	8	463
23	Haute-Normandie	27	3	11	141	Champ-Dolent	54	2	56
23	Haute-Normandie	27	1	42	142	Champenard	219	8	227
23	Haute-Normandie	27	3	31	143	Champignolles	40	0	40
23	Haute-Normandie	27	3	32	144	Champigny-la-Futelaye	248	5	253
23	Haute-Normandie	27	3	13	145	Chanteloup	89	1	90
23	Haute-Normandie	27	2	12	146	La Chapelle-Bayvel	329	1	330
23	Haute-Normandie	27	3	16	147	La Chapelle-du-Bois-des-Faulx	517	14	531
23	Haute-Normandie	27	2	10	148	La Chapelle-Gauthier	400	10	410
23	Haute-Normandie	27	2	34	149	La Chapelle-Hareng	85	1	86
23	Haute-Normandie	27	3	36	150	La Chapelle-Réanville	1150	18	1168
23	Haute-Normandie	27	1	18	151	Charleval	1845	21	1866
23	Haute-Normandie	27	1	14	152	Château-sur-Epte	578	14	592
23	Haute-Normandie	27	1	15	153	Chauvincourt-Provemont	340	4	344
23	Haute-Normandie	27	3	32	154	Chavigny-Bailleul	537	8	545
23	Haute-Normandie	27	3	35	155	Chennebrun	140	1	141
23	Haute-Normandie	27	3	31	156	Chéronvilliers	535	5	540
23	Haute-Normandie	27	3	08	157	Le Chesne	554	12	566
23	Haute-Normandie	27	3	26	158	Cierrey	657	25	682
23	Haute-Normandie	27	3	08	159	Cintray	438	16	454
23	Haute-Normandie	27	1	14	160	Civières	219	3	222
23	Haute-Normandie	27	3	38	161	Claville	1083	24	1107
23	Haute-Normandie	27	3	11	162	Collandres-Quincarnon	204	2	206
23	Haute-Normandie	27	2	27	163	Colletot	171	3	174
23	Haute-Normandie	27	2	04	164	Combon	771	10	781
23	Haute-Normandie	27	3	11	165	Conches-en-Ouche	4993	118	5111
23	Haute-Normandie	27	3	08	166	Condé-sur-Iton	891	10	901
23	Haute-Normandie	27	2	23	167	Condé-sur-Risle	553	8	561
23	Haute-Normandie	27	1	43	168	Connelles	204	0	204
23	Haute-Normandie	27	2	06	169	Conteville	921	19	940
23	Haute-Normandie	27	2	12	170	Cormeilles	1174	33	1207
23	Haute-Normandie	27	3	26	171	Le Cormier	391	7	398
23	Haute-Normandie	27	3	13	172	Corneuil	481	8	489
23	Haute-Normandie	27	2	41	173	Corneville-la-Fouquetière	102	1	103
23	Haute-Normandie	27	2	27	174	Corneville-sur-Risle	1248	35	1283
23	Haute-Normandie	27	1	02	175	Corny	347	7	354
23	Haute-Normandie	27	1	15	176	Coudray	246	0	246
23	Haute-Normandie	27	3	32	177	Coudres	519	14	533
23	Haute-Normandie	27	2	05	179	Courbépine	699	15	714
23	Haute-Normandie	27	1	02	180	Courcelles-sur-Seine	1731	44	1775
23	Haute-Normandie	27	3	25	181	Courdemanche	573	9	582
23	Haute-Normandie	27	3	35	182	Courteilles	144	5	149
23	Haute-Normandie	27	3	32	183	La Couture-Boussey	2232	40	2272
23	Haute-Normandie	27	1	39	184	Crasville	126	5	131
23	Haute-Normandie	27	3	24	185	Crestot	422	7	429
23	Haute-Normandie	27	3	24	187	Criquebeuf-la-Campagne	249	2	251
23	Haute-Normandie	27	1	28	188	Criquebeuf-sur-Seine	1189	14	1203
23	Haute-Normandie	27	3	11	189	La Croisille	431	14	445
23	Haute-Normandie	27	3	26	190	Croisy-sur-Eure	232	6	238
23	Haute-Normandie	27	1	42	191	La Croix-Saint-Leufroy	1087	29	1116
23	Haute-Normandie	27	3	24	192	Crosville-la-Vieille	569	11	580
23	Haute-Normandie	27	3	32	193	Croth	1259	28	1287
23	Haute-Normandie	27	1	02	194	Cuverville	221	4	225
23	Haute-Normandie	27	3	08	195	Dame-Marie	94	4	98
23	Haute-Normandie	27	1	28	196	Les Damps	1264	9	1273
23	Haute-Normandie	27	1	14	197	Dampsmesnil	200	3	203
23	Haute-Normandie	27	3	13	198	Damville	1982	55	2037
23	Haute-Normandie	27	1	20	199	Dangu	587	15	602
23	Haute-Normandie	27	3	16	200	Dardez	165	5	170
23	Haute-Normandie	27	3	24	201	Daubeuf-la-Campagne	223	4	227
23	Haute-Normandie	27	1	02	202	Daubeuf-près-Vatteville	486	9	495
23	Haute-Normandie	27	3	40	203	Douains	456	12	468
23	Haute-Normandie	27	1	15	204	Doudeauville-en-Vexin	313	7	320
23	Haute-Normandie	27	1	18	205	Douville-sur-Andelle	417	2	419
23	Haute-Normandie	27	3	25	206	Droisy	407	9	416
23	Haute-Normandie	27	2	34	207	Drucourt	608	17	625
23	Haute-Normandie	27	2	34	208	Duranville	162	8	170
23	Haute-Normandie	27	2	23	209	Écaquelon	518	5	523
23	Haute-Normandie	27	2	04	210	Écardenville-la-Campagne	421	4	425
23	Haute-Normandie	27	1	42	211	Écardenville-sur-Eure	531	10	541
23	Haute-Normandie	27	3	24	212	Écauville	116	1	117
23	Haute-Normandie	27	1	14	213	Écos	982	29	1011
23	Haute-Normandie	27	1	18	214	Écouis	794	27	821
23	Haute-Normandie	27	3	24	215	Ecquetot	350	8	358
23	Haute-Normandie	27	3	16	216	Émalleville	531	13	544
23	Haute-Normandie	27	3	11	217	Émanville	569	14	583
23	Haute-Normandie	27	2	12	218	Épaignes	1371	7	1378
23	Haute-Normandie	27	3	24	219	Épégard	503	8	511
23	Haute-Normandie	27	3	32	220	Épieds	372	2	374
23	Haute-Normandie	27	2	03	221	Épinay	325	5	330
23	Haute-Normandie	27	2	33	222	Épreville-en-Lieuvin	188	5	193
23	Haute-Normandie	27	2	07	223	Épreville-en-Roumois	384	4	388
23	Haute-Normandie	27	3	24	224	Épreville-près-le-Neubourg	498	5	503
23	Haute-Normandie	27	3	13	225	Les Essarts	386	4	390
23	Haute-Normandie	27	1	15	226	Étrépagny	3782	95	3877
23	Haute-Normandie	27	2	30	227	Étréville	616	5	621
23	Haute-Normandie	27	2	30	228	Éturqueraye	282	5	287
23	Haute-Normandie	27	3	99	229	Évreux	50537	2723	53260
23	Haute-Normandie	27	3	32	230	Ézy-sur-Eure	3270	59	3329
23	Haute-Normandie	27	3	26	231	Fains	415	8	423
23	Haute-Normandie	27	1	15	232	Farceaux	292	7	299
23	Haute-Normandie	27	2	06	233	Fatouville-Grestain	738	5	743
23	Haute-Normandie	27	3	37	234	Fauville	313	15	328
23	Haute-Normandie	27	3	11	235	Faverolles-la-Campagne	142	5	147
23	Haute-Normandie	27	2	34	237	Le Favril	170	1	171
23	Haute-Normandie	27	3	11	240	La Ferrière-sur-Risle	269	2	271
23	Haute-Normandie	27	3	11	238	Ferrières-Haut-Clocher	1122	17	1139
23	Haute-Normandie	27	2	10	239	Ferrières-Saint-Hilaire	397	10	407
23	Haute-Normandie	27	3	24	241	Feuguerolles	182	6	188
23	Haute-Normandie	27	3	11	242	Le Fidelaire	992	22	1014
23	Haute-Normandie	27	2	06	243	Fiquefleur-Équainville	645	11	656
23	Haute-Normandie	27	2	07	244	Flancourt-Catelon	479	9	488
23	Haute-Normandie	27	1	22	245	Fleury-la-Forêt	281	4	285
23	Haute-Normandie	27	1	18	246	Fleury-sur-Andelle	1876	19	1895
23	Haute-Normandie	27	1	18	247	Flipou	348	4	352
23	Haute-Normandie	27	2	34	248	Folleville	197	3	200
23	Haute-Normandie	27	1	42	249	Fontaine-Bellenger	1048	23	1071
23	Haute-Normandie	27	1	42	250	Fontaine-Heudebourg	714	15	729
23	Haute-Normandie	27	2	41	251	Fontaine-l;Abbé	598	14	612
23	Haute-Normandie	27	2	34	252	Fontaine-la-Louvet	301	4	305
23	Haute-Normandie	27	2	04	253	Fontaine-la-Soret	409	11	420
23	Haute-Normandie	27	3	37	254	Fontaine-sous-Jouy	775	61	836
23	Haute-Normandie	27	1	14	255	Fontenay	325	7	332
23	Haute-Normandie	27	3	32	256	La Forêt-du-Parc	506	19	525
23	Haute-Normandie	27	1	14	257	Forêt-la-Folie	467	11	478
23	Haute-Normandie	27	2	06	258	Fort-Moville	404	9	413
23	Haute-Normandie	27	3	32	259	Foucrainville	83	4	87
23	Haute-Normandie	27	2	06	260	Foulbec	554	4	558
23	Haute-Normandie	27	2	01	261	Fouqueville	456	9	465
23	Haute-Normandie	27	1	14	262	Fourges	808	20	828
23	Haute-Normandie	27	2	27	263	Fourmetot	632	10	642
23	Haute-Normandie	27	1	14	264	Fours-en-Vexin	188	9	197
23	Haute-Normandie	27	3	08	265	Francheville	1254	21	1275
23	Haute-Normandie	27	2	09	266	Franqueville	301	8	309
23	Haute-Normandie	27	2	23	267	Freneuse-sur-Risle	343	7	350
23	Haute-Normandie	27	3	11	268	Le Fresne	295	23	318
23	Haute-Normandie	27	2	12	269	Fresne-Cauverville	206	6	212
23	Haute-Normandie	27	1	02	270	Fresne-l;Archevêque	528	7	535
23	Haute-Normandie	27	3	32	271	Fresney	309	8	317
23	Haute-Normandie	27	3	26	273	Gadencourt	390	9	399
23	Haute-Normandie	27	1	18	274	Gaillardbois-Cressenville	415	7	422
23	Haute-Normandie	27	1	19	275	Gaillon	7271	183	7454
23	Haute-Normandie	27	1	15	276	Gamaches-en-Vexin	321	10	331
23	Haute-Normandie	27	3	32	277	Garencières	554	13	567
23	Haute-Normandie	27	3	32	278	Garennes-sur-Eure	1821	23	1844
23	Haute-Normandie	27	1	14	279	Gasny	3004	47	3051
23	Haute-Normandie	27	3	37	280	Gauciel	811	10	821
23	Haute-Normandie	27	3	11	281	Gaudreville-la-Rivière	245	4	249
23	Haute-Normandie	27	3	16	282	Gauville-la-Campagne	502	18	520
23	Haute-Normandie	27	2	03	283	Gisay-la-Coudre	234	4	238
23	Haute-Normandie	27	1	20	284	Gisors	11554	310	11864
23	Haute-Normandie	27	1	14	285	Giverny	500	16	516
23	Haute-Normandie	27	2	34	286	Giverville	321	3	324
23	Haute-Normandie	27	3	11	287	Glisolles	833	27	860
23	Haute-Normandie	27	2	23	288	Glos-sur-Risle	438	5	443
23	Haute-Normandie	27	2	10	289	La Goulafrière	173	2	175
23	Haute-Normandie	27	2	04	290	Goupillières	780	21	801
23	Haute-Normandie	27	3	35	291	Gournay-le-Guérin	145	7	152
23	Haute-Normandie	27	2	03	292	Gouttières	197	0	197
23	Haute-Normandie	27	3	13	293	Gouville	523	139	662
23	Haute-Normandie	27	1	18	294	Grainville	556	12	568
23	Haute-Normandie	27	2	03	296	Granchain	204	4	208
23	Haute-Normandie	27	2	10	295	Grand-Camp	455	9	464
23	Haute-Normandie	27	3	13	297	Grandvilliers	366	10	376
23	Haute-Normandie	27	3	16	298	Graveron-Sémerville	291	12	303
23	Haute-Normandie	27	3	16	299	Gravigny	4083	158	4241
23	Haute-Normandie	27	2	01	302	Le Gros-Theil	934	9	943
23	Haute-Normandie	27	2	04	300	Grosley-sur-Risle	549	9	558
23	Haute-Normandie	27	3	32	301	Grossoeuvre	1047	25	1072
23	Haute-Normandie	27	3	08	303	Guernanville	90	1	91
23	Haute-Normandie	27	1	20	304	Guerny	172	4	176
23	Haute-Normandie	27	3	08	305	La Guéroulde	781	11	792
23	Haute-Normandie	27	3	17	306	Guichainville	2522	107	2629
23	Haute-Normandie	27	1	02	307	Guiseniers	422	9	431
23	Haute-Normandie	27	1	14	308	Guitry	278	11	289
23	Haute-Normandie	27	3	32	309	L; Habit	541	8	549
23	Haute-Normandie	27	1	15	310	Hacqueville	463	10	473
23	Haute-Normandie	27	2	09	311	Harcourt	960	7	967
23	Haute-Normandie	27	3	26	312	Hardencourt-Cocherel	283	7	290
23	Haute-Normandie	27	2	01	313	La Harengère	531	9	540
23	Haute-Normandie	27	1	02	315	Harquency	270	8	278
23	Haute-Normandie	27	2	30	316	Hauville	1281	21	1302
23	Haute-Normandie	27	2	30	317	La Haye-Aubrée	445	10	455
23	Haute-Normandie	27	2	09	318	La Haye-de-Calleville	305	2	307
23	Haute-Normandie	27	2	30	319	La Haye-de-Routot	271	1	272
23	Haute-Normandie	27	2	01	320	La Haye-du-Theil	267	2	269
23	Haute-Normandie	27	1	39	321	La Haye-le-Comte	127	6	133
23	Haute-Normandie	27	1	39	322	La Haye-Malherbe	1502	21	1523
23	Haute-Normandie	27	3	31	323	La Haye-Saint-Sylvestre	253	3	256
23	Haute-Normandie	27	1	20	324	Hébécourt	596	12	608
23	Haute-Normandie	27	2	09	325	Hecmanville	137	3	140
23	Haute-Normandie	27	3	26	326	Hécourt	356	3	359
23	Haute-Normandie	27	3	24	327	Hectomare	227	1	228
23	Haute-Normandie	27	1	02	329	Hennezis	763	22	785
23	Haute-Normandie	27	1	43	330	Herqueville	148	1	149
23	Haute-Normandie	27	1	14	331	Heubécourt-Haricourt	456	5	461
23	Haute-Normandie	27	1	21	332	Heudebouville	807	23	830
23	Haute-Normandie	27	1	15	333	Heudicourt	639	21	660
23	Haute-Normandie	27	2	34	334	Heudreville-en-Lieuvin	105	5	110
23	Haute-Normandie	27	1	42	335	Heudreville-sur-Eure	1026	30	1056
23	Haute-Normandie	27	3	40	336	La Heunière	252	4	256
23	Haute-Normandie	27	1	02	337	Heuqueville	406	8	414
23	Haute-Normandie	27	1	22	338	Les Hogues	652	10	662
23	Haute-Normandie	27	1	39	339	Hondouville	771	18	789
23	Haute-Normandie	27	2	30	340	Honguemare-Guenouville	595	12	607
23	Haute-Normandie	27	3	13	341	L; Hosmes	80	1	81
23	Haute-Normandie	27	3	24	342	Houetteville	219	5	224
23	Haute-Normandie	27	3	40	343	Houlbec-Cocherel	1354	53	1407
23	Haute-Normandie	27	2	01	344	Houlbec-près-le-Gros-Theil	119	0	119
23	Haute-Normandie	27	2	04	345	La Houssaye	218	6	224
23	Haute-Normandie	27	1	18	346	Houville-en-Vexin	203	2	205
23	Haute-Normandie	27	3	37	347	Huest	675	25	700
23	Haute-Normandie	27	1	28	348	Igoville	1555	24	1579
23	Haute-Normandie	27	2	23	349	Illeville-sur-Montfort	881	8	889
23	Haute-Normandie	27	3	25	350	Illiers-l;Évêque	991	24	1015
23	Haute-Normandie	27	1	21	351	Incarville	1336	18	1354
23	Haute-Normandie	27	3	16	353	Irreville	438	10	448
23	Haute-Normandie	27	3	24	354	Iville	467	9	476
23	Haute-Normandie	27	3	32	355	Ivry-la-Bataille	2556	47	2603
23	Haute-Normandie	27	2	03	356	Jonquerets-de-Livet	287	9	296
23	Haute-Normandie	27	3	37	358	Jouy-sur-Eure	566	17	583
23	Haute-Normandie	27	3	31	359	Juignettes	239	6	245
23	Haute-Normandie	27	3	32	360	Jumelles	310	3	313
23	Haute-Normandie	27	2	06	361	La Lande-Saint-Léger	303	5	308
23	Haute-Normandie	27	2	03	362	Landepéreuse	349	11	360
23	Haute-Normandie	27	2	30	363	Le Landin	178	2	180
23	Haute-Normandie	27	2	04	364	Launay	212	6	218
23	Haute-Normandie	27	1	43	365	Léry	2082	38	2120
23	Haute-Normandie	27	1	18	366	Letteguives	210	4	214
23	Haute-Normandie	27	2	33	367	Lieurey	1399	18	1417
23	Haute-Normandie	27	3	32	368	Lignerolles	286	5	291
23	Haute-Normandie	27	1	22	369	Lilly	71	2	73
23	Haute-Normandie	27	1	22	370	Lisors	353	9	362
23	Haute-Normandie	27	2	09	371	Livet-sur-Authou	149	1	150
23	Haute-Normandie	27	1	15	372	Longchamps	610	7	617
23	Haute-Normandie	27	1	22	373	Lorleau	142	7	149
23	Haute-Normandie	27	3	11	374	Louversey	585	11	596
23	Haute-Normandie	27	1	98	375	Louviers	17734	598	18332
23	Haute-Normandie	27	3	25	376	Louye	232	5	237
23	Haute-Normandie	27	1	22	377	Lyons-la-Forêt	752	10	762
23	Haute-Normandie	27	3	25	378	La Madeleine-de-Nonancourt	1211	24	1235
23	Haute-Normandie	27	1	20	379	Mainneville	444	5	449
23	Haute-Normandie	27	2	09	380	Malleville-sur-le-Bec	227	2	229
23	Haute-Normandie	27	2	05	381	Malouy	134	7	141
23	Haute-Normandie	27	2	01	382	Mandeville	312	9	321
23	Haute-Normandie	27	3	35	383	Mandres	349	14	363
23	Haute-Normandie	27	2	06	384	Manneville-la-Raoult	523	6	529
23	Haute-Normandie	27	2	27	385	Manneville-sur-Risle	1468	42	1510
23	Haute-Normandie	27	1	28	386	Le Manoir	1195	13	1208
23	Haute-Normandie	27	3	13	387	Manthelon	308	6	314
23	Haute-Normandie	27	2	29	388	Marais-Vernier	494	10	504
23	Haute-Normandie	27	3	24	389	Marbeuf	374	10	384
23	Haute-Normandie	27	3	25	390	Marcilly-la-Campagne	1023	40	1063
23	Haute-Normandie	27	3	32	391	Marcilly-sur-Eure	1556	25	1581
23	Haute-Normandie	27	1	20	392	Martagny	140	4	144
23	Haute-Normandie	27	2	06	393	Martainville	348	5	353
23	Haute-Normandie	27	1	28	394	Martot	559	6	565
23	Haute-Normandie	27	2	10	395	Mélicourt	99	0	99
23	Haute-Normandie	27	1	18	396	Ménesqueville	432	3	435
23	Haute-Normandie	27	3	26	397	Ménilles	1529	27	1556
23	Haute-Normandie	27	2	41	398	Menneval	1472	64	1536
23	Haute-Normandie	27	3	40	399	Mercey	52	2	54
23	Haute-Normandie	27	3	26	400	Merey	332	6	338
23	Haute-Normandie	27	3	16	401	Le Mesnil-Fuguet	185	6	191
23	Haute-Normandie	27	3	11	402	Le Mesnil-Hardray	53	0	53
23	Haute-Normandie	27	1	39	403	Le Mesnil-Jourdain	229	9	238
23	Haute-Normandie	27	2	10	404	Mesnil-Rousset	110	2	112
23	Haute-Normandie	27	1	20	405	Mesnil-sous-Vienne	129	2	131
23	Haute-Normandie	27	3	25	406	Mesnil-sur-l;Estrée	976	20	996
23	Haute-Normandie	27	1	18	407	Mesnil-Verclives	274	6	280
23	Haute-Normandie	27	1	14	408	Mézières-en-Vexin	642	14	656
23	Haute-Normandie	27	3	37	410	Miserey	537	6	543
23	Haute-Normandie	27	3	25	411	Moisville	175	5	180
23	Haute-Normandie	27	1	28	412	Montaure	1003	19	1022
23	Haute-Normandie	27	2	23	413	Montfort-sur-Risle	812	7	819
23	Haute-Normandie	27	2	10	414	Montreuil-l;Argillé	800	11	811
23	Haute-Normandie	27	2	12	415	Morainville-Jouveaux	380	11	391
23	Haute-Normandie	27	1	15	417	Morgny	567	11	578
23	Haute-Normandie	27	2	09	418	Morsan	122	0	122
23	Haute-Normandie	27	3	32	419	Mouettes	716	13	729
23	Haute-Normandie	27	1	15	420	Mouflaines	155	0	155
23	Haute-Normandie	27	3	32	421	Mousseaux-Neuville	669	13	682
23	Haute-Normandie	27	1	02	422	Muids	861	26	887
23	Haute-Normandie	27	3	25	423	Muzy	802	24	826
23	Haute-Normandie	27	3	11	424	Nagel-Séez-Mesnil	327	8	335
23	Haute-Normandie	27	2	04	425	Nassandres	1375	48	1423
23	Haute-Normandie	27	3	31	427	Neaufles-Auvergny	437	7	444
23	Haute-Normandie	27	1	20	426	Neaufles-Saint-Martin	1184	34	1218
23	Haute-Normandie	27	3	24	428	Le Neubourg	4159	198	4357
23	Haute-Normandie	27	3	26	429	Neuilly	145	5	150
23	Haute-Normandie	27	1	15	430	La Neuve-Grange	325	11	336
23	Haute-Normandie	27	3	31	431	La Neuve-Lyre	602	8	610
23	Haute-Normandie	27	2	09	432	La Neuville-du-Bosc	558	7	565
23	Haute-Normandie	27	2	09	433	Neuville-sur-Authou	191	4	195
23	Haute-Normandie	27	2	33	434	Noards	59	1	60
23	Haute-Normandie	27	2	33	435	La Noë-Poulain	211	1	212
23	Haute-Normandie	27	3	11	436	Nogent-le-Sec	411	7	418
23	Haute-Normandie	27	1	15	437	Nojeon-en-Vexin	313	7	320
23	Haute-Normandie	27	3	25	438	Nonancourt	2247	129	2376
23	Haute-Normandie	27	3	16	439	Normanville	1090	30	1120
23	Haute-Normandie	27	2	09	441	Notre-Dame-d;Épine	74	3	77
23	Haute-Normandie	27	1	02	440	Notre-Dame-de-l;Isle	677	30	707
23	Haute-Normandie	27	2	10	442	Notre-Dame-du-Hamel	237	1	238
23	Haute-Normandie	27	2	03	444	Le Noyer-en-Ouche	196	2	198
23	Haute-Normandie	27	1	20	445	Noyers	300	5	305
23	Haute-Normandie	27	3	11	446	Ormes	468	8	476
23	Haute-Normandie	27	3	11	447	Orvaux	515	10	525
23	Haute-Normandie	27	3	26	448	Pacy-sur-Eure	4637	260	4897
23	Haute-Normandie	27	1	14	449	Panilleuse	458	13	471
23	Haute-Normandie	27	3	16	451	Parville	278	10	288
23	Haute-Normandie	27	2	04	452	Perriers-la-Campagne	369	10	379
23	Haute-Normandie	27	1	18	453	Perriers-sur-Andelle	1834	20	1854
23	Haute-Normandie	27	1	18	454	Perruel	466	3	469
23	Haute-Normandie	27	2	34	455	Piencourt	175	4	179
23	Haute-Normandie	27	1	39	456	Pinterville	775	17	792
23	Haute-Normandie	27	3	35	457	Piseux	653	16	669
23	Haute-Normandie	27	1	28	458	Pîtres	2315	52	2367
23	Haute-Normandie	27	2	34	459	Les Places	75	0	75
23	Haute-Normandie	27	2	05	460	Plainville	192	6	198
23	Haute-Normandie	27	2	34	462	Le Planquay	150	2	152
23	Haute-Normandie	27	2	05	463	Plasnes	673	25	698
23	Haute-Normandie	27	3	17	464	Le Plessis-Grohan	779	2	781
23	Haute-Normandie	27	3	26	465	Le Plessis-Hébert	412	19	431
23	Haute-Normandie	27	2	04	466	Le Plessis-Sainte-Opportune	275	9	284
23	Haute-Normandie	27	2	27	467	Pont-Audemer	8838	290	9128
23	Haute-Normandie	27	2	23	468	Pont-Authou	714	9	723
23	Haute-Normandie	27	1	28	469	Pont-de-l;Arche	4117	53	4170
23	Haute-Normandie	27	1	18	470	Pont-Saint-Pierre	1137	35	1172
23	Haute-Normandie	27	1	02	473	Port-Mort	970	20	990
23	Haute-Normandie	27	1	43	471	Porte-Joie	118	5	123
23	Haute-Normandie	27	3	11	472	Portes	265	7	272
23	Haute-Normandie	27	1	43	474	Poses	1156	14	1170
23	Haute-Normandie	27	2	33	475	La Poterie-Mathieu	148	2	150
23	Haute-Normandie	27	2	27	476	Les Préaux	428	12	440
23	Haute-Normandie	27	1	14	477	Pressagny-l;Orgueilleux	712	26	738
23	Haute-Normandie	27	3	32	478	Prey	907	26	933
23	Haute-Normandie	27	1	15	480	Puchay	562	12	574
23	Haute-Normandie	27	3	35	481	Pullay	386	48	434
23	Haute-Normandie	27	2	01	482	La Pyle	159	4	163
23	Haute-Normandie	27	1	39	483	Quatremare	389	5	394
23	Haute-Normandie	27	3	32	484	Quessigny	122	1	123
23	Haute-Normandie	27	2	29	485	Quillebeuf-sur-Seine	1024	5	1029
23	Haute-Normandie	27	3	16	486	Quittebeuf	598	6	604
23	Haute-Normandie	27	1	18	487	Radepont	746	6	752
23	Haute-Normandie	27	1	18	488	Renneville	220	6	226
23	Haute-Normandie	27	3	16	489	Reuilly	580	8	588
23	Haute-Normandie	27	1	15	490	Richeville	278	9	287
23	Haute-Normandie	27	3	13	491	Roman	280	6	286
23	Haute-Normandie	27	2	04	492	Romilly-la-Puthenaye	307	4	311
23	Haute-Normandie	27	1	18	493	Romilly-sur-Andelle	2861	29	2890
23	Haute-Normandie	27	3	13	024	Le Roncenay-Authenay	403	11	414
23	Haute-Normandie	27	1	02	495	La Roquette	227	0	227
23	Haute-Normandie	27	1	22	496	Rosay-sur-Lieure	561	4	565
23	Haute-Normandie	27	2	04	498	Rouge-Perriers	303	6	309
23	Haute-Normandie	27	2	30	497	Rougemontiers	920	11	931
23	Haute-Normandie	27	2	03	499	La Roussière	218	6	224
23	Haute-Normandie	27	2	30	500	Routot	1384	69	1453
23	Haute-Normandie	27	3	40	501	Rouvray	278	2	280
23	Haute-Normandie	27	3	31	502	Rugles	2367	57	2424
23	Haute-Normandie	27	3	13	503	Le Sacq	316	6	322
23	Haute-Normandie	27	3	16	504	Sacquenville	1077	25	1102
23	Haute-Normandie	27	2	10	505	Saint-Agnan-de-Cernières	137	0	137
23	Haute-Normandie	27	2	01	506	Saint-Amand-des-Hautes-Terres	282	5	287
23	Haute-Normandie	27	3	32	507	Saint-André-de-l;Eure	3481	114	3595
23	Haute-Normandie	27	3	31	508	Saint-Antonin-de-Sommaire	166	3	169
23	Haute-Normandie	27	3	26	510	Saint-Aquilin-de-Pacy	561	17	578
23	Haute-Normandie	27	3	24	511	Saint-Aubin-d;Écrosville	663	39	702
23	Haute-Normandie	27	2	34	512	Saint-Aubin-de-Scellon	345	0	345
23	Haute-Normandie	27	2	03	513	Saint-Aubin-des-Hayes	145	1	146
23	Haute-Normandie	27	2	10	514	Saint-Aubin-du-Thenney	357	11	368
23	Haute-Normandie	27	2	03	515	Saint-Aubin-le-Guichard	293	2	295
23	Haute-Normandie	27	2	41	516	Saint-Aubin-le-Vertueux	879	35	914
23	Haute-Normandie	27	1	42	517	Saint-Aubin-sur-Gaillon	1710	44	1754
23	Haute-Normandie	27	2	29	518	Saint-Aubin-sur-Quillebeuf	628	3	631
23	Haute-Normandie	27	2	33	520	Saint-Benoît-des-Ombres	122	3	125
23	Haute-Normandie	27	3	35	521	Saint-Christophe-sur-Avre	147	1	148
23	Haute-Normandie	27	2	33	522	Saint-Christophe-sur-Condé	412	5	417
23	Haute-Normandie	27	2	41	523	Saint-Clair-d;Arcey	329	10	339
23	Haute-Normandie	27	2	09	527	Saint-Cyr-de-Salerne	211	5	216
23	Haute-Normandie	27	2	01	529	Saint-Cyr-la-Campagne	414	5	419
23	Haute-Normandie	27	2	10	530	Saint-Denis-d;Augerons	86	2	88
23	Haute-Normandie	27	2	07	531	Saint-Denis-des-Monts	219	2	221
23	Haute-Normandie	27	3	08	532	Saint-Denis-du-Béhélan	180	3	183
23	Haute-Normandie	27	1	20	533	Saint-Denis-le-Ferment	505	8	513
23	Haute-Normandie	27	2	01	534	Saint-Didier-des-Bois	835	15	850
23	Haute-Normandie	27	3	11	535	Saint-Élier	438	9	447
23	Haute-Normandie	27	2	09	536	Saint-Éloi-de-Fourques	463	10	473
23	Haute-Normandie	27	1	21	537	Saint-Étienne-du-Vauvray	749	16	765
23	Haute-Normandie	27	2	33	538	Saint-Étienne-l;Allier	513	4	517
23	Haute-Normandie	27	1	42	539	Saint-Étienne-sous-Bailleul	397	12	409
23	Haute-Normandie	27	2	33	541	Saint-Georges-du-Mesnil	112	1	113
23	Haute-Normandie	27	2	33	542	Saint-Georges-du-Vièvre	737	27	764
23	Haute-Normandie	27	3	25	543	Saint-Georges-Motel	955	21	976
23	Haute-Normandie	27	3	32	544	Saint-Germain-de-Fresney	208	1	209
23	Haute-Normandie	27	2	01	545	Saint-Germain-de-Pasquier	138	2	140
23	Haute-Normandie	27	3	16	546	Saint-Germain-des-Angles	208	4	212
23	Haute-Normandie	27	2	34	547	Saint-Germain-la-Campagne	860	10	870
23	Haute-Normandie	27	3	25	548	Saint-Germain-sur-Avre	1229	21	1250
23	Haute-Normandie	27	2	27	549	Saint-Germain-Village	1554	102	1656
23	Haute-Normandie	27	2	33	550	Saint-Grégoire-du-Vièvre	342	3	345
23	Haute-Normandie	27	2	33	551	Saint-Jean-de-la-Léqueraye	52	1	53
23	Haute-Normandie	27	2	10	552	Saint-Jean-du-Thenney	217	3	220
23	Haute-Normandie	27	1	42	553	Saint-Julien-de-la-Liègue	461	13	474
23	Haute-Normandie	27	3	36	554	Saint-Just	1344	38	1382
23	Haute-Normandie	27	3	32	555	Saint-Laurent-des-Bois	238	5	243
23	Haute-Normandie	27	2	10	556	Saint-Laurent-du-Tencement	51	0	51
23	Haute-Normandie	27	2	41	557	Saint-Léger-de-Rôtes	409	12	421
23	Haute-Normandie	27	2	07	558	Saint-Léger-du-Gennetey	159	2	161
23	Haute-Normandie	27	3	17	560	Saint-Luc	244	7	251
23	Haute-Normandie	27	2	06	561	Saint-Maclou	563	3	566
23	Haute-Normandie	27	3	36	562	Saint-Marcel	4909	136	5045
23	Haute-Normandie	27	2	27	563	Saint-Mards-de-Blacarville	780	30	810
23	Haute-Normandie	27	2	34	564	Saint-Mards-de-Fresne	348	7	355
23	Haute-Normandie	27	2	05	569	Saint-Martin-du-Tilleul	243	7	250
23	Haute-Normandie	27	3	16	570	Saint-Martin-la-Campagne	103	1	104
23	Haute-Normandie	27	2	33	571	Saint-Martin-Saint-Firmin	268	4	272
23	Haute-Normandie	27	2	01	572	Saint-Meslin-du-Bosc	238	1	239
23	Haute-Normandie	27	3	08	573	Saint-Nicolas-d;Attez	151	0	151
23	Haute-Normandie	27	2	01	574	Saint-Nicolas-du-Bosc	270	7	277
23	Haute-Normandie	27	3	08	578	Saint-Ouen-d;Attez	272	3	275
23	Haute-Normandie	27	2	01	579	Saint-Ouen-de-Pontcheuil	97	2	99
23	Haute-Normandie	27	2	30	580	Saint-Ouen-de-Thouberville	2303	34	2337
23	Haute-Normandie	27	2	29	581	Saint-Ouen-des-Champs	293	6	299
23	Haute-Normandie	27	2	07	582	Saint-Ouen-du-Tilleul	1563	22	1585
23	Haute-Normandie	27	2	09	584	Saint-Paul-de-Fourques	287	3	290
23	Haute-Normandie	27	2	07	586	Saint-Philbert-sur-Boissey	168	1	169
23	Haute-Normandie	27	2	23	587	Saint-Philbert-sur-Risle	790	16	806
23	Haute-Normandie	27	3	36	588	Saint-Pierre-d;Autils	993	33	1026
23	Haute-Normandie	27	1	42	589	Saint-Pierre-de-Bailleul	1005	26	1031
23	Haute-Normandie	27	2	10	590	Saint-Pierre-de-Cernières	237	4	241
23	Haute-Normandie	27	2	12	591	Saint-Pierre-de-Cormeilles	619	10	629
23	Haute-Normandie	27	2	09	592	Saint-Pierre-de-Salerne	257	8	265
23	Haute-Normandie	27	2	01	593	Saint-Pierre-des-Fleurs	1306	13	1319
23	Haute-Normandie	27	2	33	594	Saint-Pierre-des-Ifs	274	0	274
23	Haute-Normandie	27	2	01	595	Saint-Pierre-du-Bosguérard	1047	14	1061
23	Haute-Normandie	27	2	03	596	Saint-Pierre-du-Mesnil	110	2	112
23	Haute-Normandie	27	2	06	597	Saint-Pierre-du-Val	549	6	555
23	Haute-Normandie	27	1	21	598	Saint-Pierre-du-Vauvray	1334	30	1364
23	Haute-Normandie	27	1	42	599	Saint-Pierre-la-Garenne	922	13	935
23	Haute-Normandie	27	2	10	600	Saint-Quentin-des-Isles	238	11	249
23	Haute-Normandie	27	2	29	601	Saint-Samson-de-la-Roque	388	4	392
23	Haute-Normandie	27	3	38	602	Saint-Sébastien-de-Morsent	4882	125	5007
23	Haute-Normandie	27	2	12	603	Saint-Siméon	318	5	323
23	Haute-Normandie	27	2	06	604	Saint-Sulpice-de-Grimbouville	185	2	187
23	Haute-Normandie	27	2	12	605	Saint-Sylvestre-de-Cormeilles	205	3	208
23	Haute-Normandie	27	2	27	606	Saint-Symphorien	413	3	416
23	Haute-Normandie	27	2	29	607	Saint-Thurien	221	4	225
23	Haute-Normandie	27	2	09	609	Saint-Victor-d;Épine	318	6	324
23	Haute-Normandie	27	2	05	608	Saint-Victor-de-Chrétienville	454	6	460
23	Haute-Normandie	27	3	35	610	Saint-Victor-sur-Avre	65	3	68
23	Haute-Normandie	27	3	37	611	Saint-Vigor	321	4	325
23	Haute-Normandie	27	3	40	612	Saint-Vincent-des-Bois	318	11	329
23	Haute-Normandie	27	2	34	613	Saint-Vincent-du-Boulay	318	5	323
23	Haute-Normandie	27	1	42	519	Sainte-Barbe-sur-Gaillon	251	11	262
23	Haute-Normandie	27	3	16	524	Sainte-Colombe-la-Commanderie	709	11	720
23	Haute-Normandie	27	3	36	525	Sainte-Colombe-près-Vernon	308	9	317
23	Haute-Normandie	27	2	29	526	Sainte-Croix-sur-Aizier	261	3	264
23	Haute-Normandie	27	1	14	540	Sainte-Geneviève-lès-Gasny	652	12	664
23	Haute-Normandie	27	3	08	565	Sainte-Marguerite-de-l;Autel	530	5	535
23	Haute-Normandie	27	2	03	566	Sainte-Marguerite-en-Ouche	133	1	134
23	Haute-Normandie	27	1	15	567	Sainte-Marie-de-Vatimesnil	252	2	254
23	Haute-Normandie	27	3	11	568	Sainte-Marthe	449	16	465
23	Haute-Normandie	27	2	04	576	Sainte-Opportune-du-Bosc	657	6	663
23	Haute-Normandie	27	2	29	577	Sainte-Opportune-la-Mare	442	8	450
23	Haute-Normandie	27	1	20	614	Sancourt	163	1	164
23	Haute-Normandie	27	3	37	615	Sassey	171	2	173
23	Haute-Normandie	27	1	15	617	Saussay-la-Campagne	456	7	463
23	Haute-Normandie	27	2	01	616	La Saussaye	1909	51	1960
23	Haute-Normandie	27	3	11	618	Sébécourt	440	6	446
23	Haute-Normandie	27	2	27	620	Selles	433	9	442
23	Haute-Normandie	27	3	32	621	Serez	148	5	153
23	Haute-Normandie	27	2	41	622	Serquigny	2051	57	2108
23	Haute-Normandie	27	1	39	623	Surtauville	441	5	446
23	Haute-Normandie	27	1	39	624	Surville	927	22	949
23	Haute-Normandie	27	1	02	625	Suzay	272	7	279
23	Haute-Normandie	27	3	13	693	Sylvains-les-Moulins	1166	38	1204
23	Haute-Normandie	27	2	34	627	Le Theil-Nolent	229	3	232
23	Haute-Normandie	27	2	07	626	Theillement	384	7	391
23	Haute-Normandie	27	2	03	628	Thevray	292	5	297
23	Haute-Normandie	27	2	34	629	Thiberville	1790	39	1829
23	Haute-Normandie	27	2	04	630	Thibouville	284	46	330
23	Haute-Normandie	27	2	23	631	Thierville	308	1	309
23	Haute-Normandie	27	1	15	632	Le Thil	421	5	426
23	Haute-Normandie	27	1	15	633	Les Thilliers-en-Vexin	467	13	480
23	Haute-Normandie	27	3	13	634	Thomer-la-Sôgne	315	8	323
23	Haute-Normandie	27	1	02	635	Le Thuit	135	3	138
23	Haute-Normandie	27	2	01	636	Le Thuit-Anger	638	14	652
23	Haute-Normandie	27	2	07	637	Thuit-Hébert	314	4	318
23	Haute-Normandie	27	2	01	638	Le Thuit-Signol	2209	34	2243
23	Haute-Normandie	27	2	01	639	Le Thuit-Simer	417	7	424
23	Haute-Normandie	27	2	04	640	Tilleul-Dame-Agnès	217	5	222
23	Haute-Normandie	27	3	16	641	Le Tilleul-Lambert	209	6	215
23	Haute-Normandie	27	2	04	642	Le Tilleul-Othon	381	10	391
23	Haute-Normandie	27	3	35	643	Tillières-sur-Avre	1151	18	1169
23	Haute-Normandie	27	1	14	644	Tilly	563	33	596
23	Haute-Normandie	27	2	29	645	Tocqueville	130	5	135
23	Haute-Normandie	27	2	06	646	Le Torpt	334	7	341
23	Haute-Normandie	27	1	42	647	Tosny	676	10	686
23	Haute-Normandie	27	1	28	648	Tostes	424	10	434
23	Haute-Normandie	27	1	22	649	Touffreville	329	1	330
23	Haute-Normandie	27	3	16	650	Tournedos-Bois-Hubert	407	6	413
23	Haute-Normandie	27	1	43	651	Tournedos-sur-Seine	99	3	102
23	Haute-Normandie	27	3	16	652	Tourneville	346	5	351
23	Haute-Normandie	27	1	14	653	Tourny	897	20	917
23	Haute-Normandie	27	2	01	654	Tourville-la-Campagne	947	15	962
23	Haute-Normandie	27	2	27	655	Tourville-sur-Pont-Audemer	733	145	878
23	Haute-Normandie	27	2	27	656	Toutainville	1250	24	1274
23	Haute-Normandie	27	2	23	657	Touville	144	3	147
23	Haute-Normandie	27	3	24	658	Le Tremblay-Omonville	312	9	321
23	Haute-Normandie	27	3	37	659	La Trinité	104	0	104
23	Haute-Normandie	27	2	10	660	La Trinité-de-Réville	259	1	260
23	Haute-Normandie	27	2	30	661	La Trinité-de-Thouberville	456	13	469
23	Haute-Normandie	27	2	27	662	Triqueville	321	3	324
23	Haute-Normandie	27	3	24	663	Le Troncq	155	1	156
23	Haute-Normandie	27	1	22	664	Le Tronquay	490	11	501
23	Haute-Normandie	27	2	29	665	Trouville-la-Haule	765	13	778
23	Haute-Normandie	27	1	39	666	La Vacherie	557	13	570
23	Haute-Normandie	27	3	37	668	Le Val-David	761	13	774
23	Haute-Normandie	27	1	43	701	Val-de-Reuil	13380	308	13688
23	Haute-Normandie	27	2	05	667	Valailles	382	7	389
23	Haute-Normandie	27	2	30	669	Valletot	341	5	346
23	Haute-Normandie	27	1	18	670	Vandrimare	1055	9	1064
23	Haute-Normandie	27	2	06	671	Vannecrocq	134	6	140
23	Haute-Normandie	27	1	22	672	Vascoeuil	337	4	341
23	Haute-Normandie	27	1	02	673	Vatteville	195	5	200
23	Haute-Normandie	27	1	43	528	Le Vaudreuil	3673	116	3789
23	Haute-Normandie	27	3	26	674	Vaux-sur-Eure	262	12	274
23	Haute-Normandie	27	1	42	676	Venables	789	19	808
23	Haute-Normandie	27	3	24	677	Venon	320	6	326
23	Haute-Normandie	27	3	17	678	Les Ventes	1037	22	1059
23	Haute-Normandie	27	3	35	679	Verneuil-sur-Avre	6205	403	6608
23	Haute-Normandie	27	2	10	680	Verneusses	206	3	209
23	Haute-Normandie	27	3	97	681	Vernon	25147	1159	26306
23	Haute-Normandie	27	1	20	682	Vesly	685	13	698
23	Haute-Normandie	27	1	02	683	Vézillon	240	4	244
23	Haute-Normandie	27	3	37	684	Le Vieil-Évreux	727	26	753
23	Haute-Normandie	27	3	31	685	La Vieille-Lyre	627	11	638
23	Haute-Normandie	27	2	29	686	Vieux-Port	58	2	60
23	Haute-Normandie	27	1	42	687	Vieux-Villez	212	2	214
23	Haute-Normandie	27	3	13	688	Villalet	89	4	93
23	Haute-Normandie	27	3	26	689	Villegats	339	7	346
23	Haute-Normandie	27	1	15	690	Villers-en-Vexin	279	3	282
23	Haute-Normandie	27	1	42	691	Villers-sur-le-Roule	714	14	728
23	Haute-Normandie	27	3	24	692	Villettes	177	2	179
23	Haute-Normandie	27	3	36	694	Villez-sous-Bailleul	308	6	314
23	Haute-Normandie	27	3	24	695	Villez-sur-le-Neubourg	277	8	285
23	Haute-Normandie	27	3	26	696	Villiers-en-Désoeuvre	880	15	895
23	Haute-Normandie	27	1	21	697	Vironvay	307	10	317
23	Haute-Normandie	27	3	24	698	Vitot	493	16	509
23	Haute-Normandie	27	2	07	699	Voiscreville	124	2	126
23	Haute-Normandie	27	2	01	700	Vraiville	596	6	602
24	Centre	28	3	01	001	Abondant	2160	46	2206
24	Centre	28	1	16	002	Allaines-Mervilliers	336	13	349
24	Centre	28	3	27	003	Allainville	142	3	145
24	Centre	28	1	24	004	Allonnes	337	10	347
24	Centre	28	2	04	005	Alluyes	737	91	828
24	Centre	28	1	29	006	Amilly	1871	52	1923
24	Centre	28	3	01	007	Anet	2641	109	2750
24	Centre	28	3	10	008	Ardelles	224	1	225
24	Centre	28	1	02	009	Ardelu	73	1	74
24	Centre	28	4	20	010	Argenvilliers	368	16	384
24	Centre	28	2	11	012	Arrou	1653	32	1685
24	Centre	28	1	02	013	Aunay-sous-Auneau	1406	29	1435
24	Centre	28	3	28	014	Aunay-sous-Crécy	568	8	576
24	Centre	28	1	02	015	Auneau	4133	83	4216
24	Centre	28	4	03	016	Les Autels-Villevillon	165	5	170
24	Centre	28	2	11	017	Autheuil	234	8	242
24	Centre	28	4	03	018	Authon-du-Perche	1301	19	1320
24	Centre	28	2	21	019	Baigneaux	221	4	225
24	Centre	28	1	24	020	Baignolet	130	4	134
24	Centre	28	1	18	023	Bailleau-Armenonville	1390	31	1421
24	Centre	28	1	30	022	Bailleau-l;Évêque	1183	21	1204
24	Centre	28	1	15	021	Bailleau-le-Pin	1511	32	1543
24	Centre	28	1	26	024	Barjouville	1619	63	1682
24	Centre	28	1	16	025	Barmainville	124	3	127
24	Centre	28	1	16	026	Baudreville	282	7	289
24	Centre	28	4	03	027	La Bazoche-Gouet	1319	13	1332
24	Centre	28	2	21	028	Bazoches-en-Dunois	261	8	269
24	Centre	28	2	21	029	Bazoches-les-Hautes	340	5	345
24	Centre	28	3	05	030	Beauche	292	16	308
24	Centre	28	4	03	031	Beaumont-les-Autels	459	99	558
24	Centre	28	1	24	032	Beauvilliers	303	9	312
24	Centre	28	4	17	033	Belhomert-Guéhouville	824	31	855
24	Centre	28	1	25	035	Berchères-les-Pierres	985	17	1002
24	Centre	28	1	07	034	Berchères-Saint-Germain	769	18	787
24	Centre	28	3	01	036	Berchères-sur-Vesgre	840	11	851
24	Centre	28	3	05	037	Bérou-la-Mulotière	331	12	343
24	Centre	28	4	03	038	Béthonvilliers	144	6	150
24	Centre	28	1	02	039	Béville-le-Comte	1458	45	1503
24	Centre	28	1	12	040	Billancelles	299	10	309
24	Centre	28	1	15	041	Blandainville	231	2	233
24	Centre	28	1	18	361	Bleury - Saint-Symphorien	1338	28	1366
24	Centre	28	2	11	044	Boisgasson	110	1	111
24	Centre	28	3	27	045	Boissy-en-Drouais	240	6	246
24	Centre	28	3	14	046	Boissy-lès-Perche	511	9	520
24	Centre	28	1	24	047	Boisville-la-Saint-Père	710	11	721
24	Centre	28	1	24	049	Boncé	243	2	245
24	Centre	28	3	01	050	Boncourt	276	5	281
24	Centre	28	2	04	051	Bonneval	4637	79	4716
24	Centre	28	1	18	052	Bouglainval	731	22	753
24	Centre	28	3	10	053	Le Boullay-les-Deux-Églises	248	1	249
24	Centre	28	3	19	054	Le Boullay-Mivoye	436	4	440
24	Centre	28	3	19	055	Le Boullay-Thierry	573	12	585
24	Centre	28	1	15	048	La Bourdinière-Saint-Loup	566	11	577
24	Centre	28	3	19	056	Boutigny-Prouais	1809	30	1839
24	Centre	28	2	04	057	Bouville	538	10	548
24	Centre	28	3	19	058	Bréchamps	327	9	336
24	Centre	28	3	05	059	Brezolles	1783	28	1811
24	Centre	28	1	07	060	Briconville	124	6	130
24	Centre	28	2	06	061	Brou	3471	40	3511
24	Centre	28	3	01	062	Broué	907	9	916
24	Centre	28	4	20	063	Brunelles	560	14	574
24	Centre	28	3	01	064	Bû	1849	40	1889
24	Centre	28	2	04	065	Bullainville	116	1	117
24	Centre	28	2	06	066	Bullou	226	2	228
24	Centre	28	1	15	067	Cernay	79	4	83
24	Centre	28	1	07	068	Challet	432	11	443
24	Centre	28	3	01	069	Champagne	240	5	245
24	Centre	28	1	07	070	Champhol	3470	143	3613
24	Centre	28	4	17	071	Champrond-en-Gâtine	541	13	554
24	Centre	28	4	20	072	Champrond-en-Perchet	401	5	406
24	Centre	28	1	02	073	Champseru	291	10	301
24	Centre	28	1	02	074	La Chapelle-d;Aunainville	297	4	301
24	Centre	28	2	09	075	La Chapelle-du-Noyer	1032	152	1184
24	Centre	28	3	13	076	La Chapelle-Forainvilliers	175	2	177
24	Centre	28	3	14	077	La Chapelle-Fortin	185	10	195
24	Centre	28	4	03	078	Chapelle-Guillaume	210	5	215
24	Centre	28	4	03	079	Chapelle-Royale	350	1	351
24	Centre	28	4	03	080	Charbonnières	262	5	267
24	Centre	28	1	15	081	Charonville	291	2	293
24	Centre	28	3	13	082	Charpont	564	29	593
24	Centre	28	2	11	083	Charray	104	2	106
24	Centre	28	1	18	084	Chartainvilliers	738	20	758
24	Centre	28	1	99	085	Chartres	38931	1489	40420
24	Centre	28	4	23	086	Chassant	323	5	328
24	Centre	28	3	05	087	Châtaincourt	240	3	243
24	Centre	28	2	09	088	Châteaudun	13640	395	14035
24	Centre	28	3	10	089	Châteauneuf-en-Thymerais	2607	39	2646
24	Centre	28	3	05	090	Les Châtelets	98	2	100
24	Centre	28	1	15	091	Les Châtelliers-Notre-Dame	122	2	124
24	Centre	28	1	02	092	Châtenay	240	5	245
24	Centre	28	2	11	093	Châtillon-en-Dunois	760	12	772
24	Centre	28	3	19	094	Chaudon	1624	29	1653
24	Centre	28	1	15	095	Chauffours	281	9	290
24	Centre	28	3	01	096	La Chaussée-d;Ivry	1004	14	1018
24	Centre	28	3	13	098	Cherisy	1865	36	1901
24	Centre	28	1	12	099	Chuisnes	1033	20	1053
24	Centre	28	1	29	100	Cintray	435	7	442
24	Centre	28	2	09	101	Civry	359	5	364
24	Centre	28	1	07	102	Clévilliers	748	19	767
24	Centre	28	2	11	103	Cloyes-sur-le-Loir	2715	56	2771
24	Centre	28	1	07	104	Coltainville	927	18	945
24	Centre	28	4	23	105	Combres	517	4	521
24	Centre	28	2	09	106	Conie-Molitard	379	8	387
24	Centre	28	1	26	107	Corancez	395	16	411
24	Centre	28	2	21	108	Cormainville	231	4	235
24	Centre	28	4	17	109	Les Corvées-les-Yys	314	3	317
24	Centre	28	1	25	110	Le Coudray	4099	121	4220
24	Centre	28	4	03	111	Coudray-au-Perche	384	7	391
24	Centre	28	4	23	112	Coudreceau	432	8	440
24	Centre	28	3	19	113	Coulombs	1433	29	1462
24	Centre	28	2	21	114	Courbehaye	124	2	126
24	Centre	28	2	11	115	Courtalain	616	10	626
24	Centre	28	1	12	116	Courville-sur-Eure	2794	35	2829
24	Centre	28	3	27	117	Crécy-Couvé	272	14	286
24	Centre	28	3	19	118	Croisilles	465	12	477
24	Centre	28	4	23	119	La Croix-du-Perche	203	2	205
24	Centre	28	3	05	120	Crucey-Villages	475	12	487
24	Centre	28	2	21	121	Dambron	89	1	90
24	Centre	28	1	26	122	Dammarie	1566	37	1603
24	Centre	28	2	06	123	Dampierre-sous-Brou	498	11	509
24	Centre	28	3	05	124	Dampierre-sur-Avre	701	8	709
24	Centre	28	2	04	126	Dancy	229	2	231
24	Centre	28	2	06	127	Dangeau	952	13	965
24	Centre	28	1	12	128	Dangers	417	13	430
24	Centre	28	1	02	129	Denonville	763	25	788
24	Centre	28	3	22	130	Digny	1033	7	1040
24	Centre	28	2	09	132	Donnemain-Saint-Mamès	692	26	718
24	Centre	28	2	11	133	Douy	548	15	563
24	Centre	28	3	97	134	Dreux	31031	579	31610
24	Centre	28	1	18	135	Droue-sur-Drouette	1281	28	1309
24	Centre	28	3	13	136	Écluzelles	167	3	170
24	Centre	28	1	18	137	Écrosnes	785	20	805
24	Centre	28	1	15	139	Épeautrolles	187	6	193
24	Centre	28	1	18	140	Épernon	5367	84	5451
24	Centre	28	1	15	141	Ermenonville-la-Grande	321	4	325
24	Centre	28	1	15	142	Ermenonville-la-Petite	185	2	187
24	Centre	28	3	05	143	Escorpain	264	9	273
24	Centre	28	4	03	144	Les Étilleux	249	5	254
24	Centre	28	1	24	145	Fains-la-Folie	322	9	331
24	Centre	28	3	19	146	Faverolles	893	16	909
24	Centre	28	3	10	147	Favières	497	14	511
24	Centre	28	1	12	148	Le Favril	327	7	334
24	Centre	28	3	14	149	La Ferté-Vidame	729	18	747
24	Centre	28	2	11	150	La Ferté-Villeneuil	402	18	420
24	Centre	28	3	05	151	Fessanvilliers-Mattanvilliers	174	1	175
24	Centre	28	2	04	153	Flacey	223	3	226
24	Centre	28	1	12	154	Fontaine-la-Guyon	1545	105	1650
24	Centre	28	3	10	155	Fontaine-les-Ribouts	236	3	239
24	Centre	28	4	17	156	Fontaine-Simon	901	26	927
24	Centre	28	2	21	157	Fontenay-sur-Conie	147	3	150
24	Centre	28	1	26	158	Fontenay-sur-Eure	839	31	870
24	Centre	28	3	22	159	La Framboisière	320	4	324
24	Centre	28	1	02	160	Francourville	777	22	799
24	Centre	28	4	23	161	Frazé	513	11	524
24	Centre	28	1	16	164	Fresnay-l;Évêque	697	16	713
24	Centre	28	1	26	162	Fresnay-le-Comte	347	5	352
24	Centre	28	1	07	163	Fresnay-le-Gilmert	201	8	209
24	Centre	28	4	23	165	Frétigny	492	10	502
24	Centre	28	4	17	166	Friaize	231	3	234
24	Centre	28	1	12	167	Fruncé	370	8	378
24	Centre	28	1	18	168	Gallardon	3485	99	3584
24	Centre	28	1	02	169	Garancières-en-Beauce	233	5	238
24	Centre	28	3	27	170	Garancières-en-Drouais	298	9	307
24	Centre	28	3	28	171	Garnay	911	21	932
24	Centre	28	1	18	172	Gas	760	23	783
24	Centre	28	1	07	173	Gasville-Oisème	1246	32	1278
24	Centre	28	4	20	175	La Gaudaine	177	3	180
24	Centre	28	2	04	176	Le Gault-Saint-Denis	708	4	712
24	Centre	28	1	25	177	Gellainville	519	12	531
24	Centre	28	3	13	178	Germainville	322	0	322
24	Centre	28	1	24	179	Germignonville	240	3	243
24	Centre	28	3	01	180	Gilles	564	9	573
24	Centre	28	2	06	182	Gohory	329	7	336
24	Centre	28	1	16	183	Gommerville	596	7	603
24	Centre	28	1	16	184	Gouillons	339	4	343
24	Centre	28	3	01	185	Goussainville	927	11	938
24	Centre	28	3	01	187	Guainville	670	12	682
24	Centre	28	1	02	188	Le Gué-de-Longroi	822	16	838
24	Centre	28	1	16	189	Guilleville	180	1	181
24	Centre	28	2	21	190	Guillonville	445	10	455
24	Centre	28	1	18	191	Hanches	2619	56	2675
24	Centre	28	4	23	192	Happonvilliers	319	1	320
24	Centre	28	3	01	193	Havelu	116	3	119
24	Centre	28	1	02	194	Houville-la-Branche	483	19	502
24	Centre	28	1	18	195	Houx	801	14	815
24	Centre	28	1	15	196	Illiers-Combray	3352	51	3403
24	Centre	28	1	16	197	Intréville	131	10	141
24	Centre	28	2	09	198	Jallans	795	19	814
24	Centre	28	1	16	199	Janville	1792	38	1830
24	Centre	28	3	22	200	Jaudrais	357	5	362
24	Centre	28	1	07	201	Jouy	1913	46	1959
24	Centre	28	3	14	202	Lamblore	404	10	414
24	Centre	28	1	12	203	Landelles	569	9	578
24	Centre	28	2	11	204	Langey	355	5	360
24	Centre	28	2	09	205	Lanneray	569	20	589
24	Centre	28	3	05	206	Laons	728	10	738
24	Centre	28	1	02	207	Léthuin	213	3	216
24	Centre	28	1	02	208	Levainville	406	6	412
24	Centre	28	1	30	209	Lèves	5669	224	5893
24	Centre	28	1	16	210	Levesville-la-Chenard	216	1	217
24	Centre	28	2	09	211	Logron	565	13	578
24	Centre	28	2	21	212	Loigny-la-Bataille	227	3	230
24	Centre	28	3	19	213	Lormaye	645	9	654
24	Centre	28	4	17	214	La Loupe	3483	132	3615
24	Centre	28	1	24	215	Louville-la-Chenard	282	9	291
24	Centre	28	3	27	216	Louvilliers-en-Drouais	205	4	209
24	Centre	28	3	22	217	Louvilliers-lès-Perche	160	6	166
24	Centre	28	1	29	218	Lucé	15926	336	16262
24	Centre	28	4	03	219	Luigny	425	6	431
24	Centre	28	1	26	220	Luisant	6834	293	7127
24	Centre	28	2	21	221	Lumeau	187	7	194
24	Centre	28	1	15	222	Luplanté	395	7	402
24	Centre	28	3	13	223	Luray	1590	19	1609
24	Centre	28	2	09	224	Lutz-en-Dunois	431	9	440
24	Centre	28	1	15	225	Magny	663	8	671
24	Centre	28	3	10	226	Maillebois	984	17	1001
24	Centre	28	1	18	227	Maintenon	4473	98	4571
24	Centre	28	1	30	229	Mainvilliers	10324	276	10600
24	Centre	28	1	02	230	Maisons	318	8	326
24	Centre	28	3	05	231	La Mancelière	191	3	194
24	Centre	28	4	17	232	Manou	570	41	611
24	Centre	28	2	09	233	Marboué	1137	37	1174
24	Centre	28	1	15	234	Marchéville	491	8	499
24	Centre	28	3	01	235	Marchezais	305	6	311
24	Centre	28	4	20	236	Margon	1203	45	1248
24	Centre	28	4	23	237	Marolles-les-Buis	249	9	258
24	Centre	28	3	28	239	Marville-Moutiers-Brûlé	906	27	933
24	Centre	28	4	17	240	Meaucé	509	13	522
24	Centre	28	2	11	241	Le Mée	270	9	279
24	Centre	28	1	15	242	Méréglise	97	0	97
24	Centre	28	1	16	243	Mérouville	218	3	221
24	Centre	28	1	15	245	Meslay-le-Grenet	292	21	313
24	Centre	28	2	04	246	Meslay-le-Vidame	503	20	523
24	Centre	28	3	01	247	Le Mesnil-Simon	517	11	528
24	Centre	28	3	22	248	Le Mesnil-Thomas	340	6	346
24	Centre	28	1	18	249	Mévoisins	636	18	654
24	Centre	28	2	06	250	Mézières-au-Perche	128	2	130
24	Centre	28	3	13	251	Mézières-en-Drouais	1061	21	1082
24	Centre	28	4	03	252	Miermaigne	218	20	238
24	Centre	28	1	26	253	Mignières	815	93	908
24	Centre	28	1	12	254	Mittainvilliers	469	7	476
24	Centre	28	1	02	255	Moinville-la-Jeulin	123	5	128
24	Centre	28	2	09	256	Moléans	475	12	487
24	Centre	28	1	02	257	Mondonville-Saint-Jean	91	2	93
24	Centre	28	1	24	258	Montainville	318	18	336
24	Centre	28	2	04	259	Montboissier	329	1	330
24	Centre	28	2	04	260	Montharville	113	1	114
24	Centre	28	4	23	261	Montigny-le-Chartif	590	6	596
24	Centre	28	2	11	262	Montigny-le-Gannelon	498	13	511
24	Centre	28	3	05	263	Montigny-sur-Avre	257	6	263
24	Centre	28	4	17	264	Montireau	135	3	138
24	Centre	28	4	17	265	Montlandon	265	8	273
24	Centre	28	3	27	267	Montreuil	510	7	517
24	Centre	28	1	02	268	Morainville	21	0	21
24	Centre	28	1	26	269	Morancez	1602	51	1653
24	Centre	28	2	04	270	Moriers	211	6	217
24	Centre	28	3	14	271	Morvilliers	142	3	145
24	Centre	28	2	06	272	Mottereau	157	4	161
24	Centre	28	4	03	273	Moulhard	158	3	161
24	Centre	28	1	24	274	Moutiers	250	12	262
24	Centre	28	3	19	275	Néron	598	21	619
24	Centre	28	1	16	276	Neuvy-en-Beauce	190	4	194
24	Centre	28	2	04	277	Neuvy-en-Dunois	336	7	343
24	Centre	28	1	25	278	Nogent-le-Phaye	1317	42	1359
24	Centre	28	3	19	279	Nogent-le-Roi	4158	50	4208
24	Centre	28	4	20	280	Nogent-le-Rotrou	10884	552	11436
24	Centre	28	1	15	281	Nogent-sur-Eure	504	10	514
24	Centre	28	4	23	282	Nonvilliers-Grandhoux	413	5	418
24	Centre	28	2	21	283	Nottonville	313	5	318
24	Centre	28	1	16	284	Oinville-Saint-Liphard	267	14	281
24	Centre	28	1	02	285	Oinville-sous-Auneau	340	4	344
24	Centre	28	1	15	286	Ollé	600	18	618
24	Centre	28	2	21	287	Orgères-en-Beauce	1120	7	1127
24	Centre	28	1	02	288	Orlu	47	0	47
24	Centre	28	3	19	289	Ormoy	248	7	255
24	Centre	28	1	12	290	Orrouer	272	3	275
24	Centre	28	1	24	291	Ouarville	579	12	591
24	Centre	28	3	13	292	Ouerre	674	13	687
24	Centre	28	3	01	293	Oulins	1158	14	1172
24	Centre	28	1	02	294	Oysonville	498	5	503
24	Centre	28	2	09	295	Ozoir-le-Breuil	442	8	450
24	Centre	28	2	21	296	Péronville	317	4	321
24	Centre	28	1	24	297	Pézy	252	2	254
24	Centre	28	1	18	298	Pierres	2790	43	2833
24	Centre	28	3	19	299	Les Pinthières	182	3	185
24	Centre	28	1	16	300	Poinville	136	1	137
24	Centre	28	1	07	301	Poisvilliers	410	11	421
24	Centre	28	1	12	302	Pontgouin	1049	300	1349
24	Centre	28	2	21	303	Poupry	103	2	105
24	Centre	28	1	24	304	Prasville	402	6	408
24	Centre	28	2	04	305	Pré-Saint-Évroult	298	2	300
24	Centre	28	2	04	306	Pré-Saint-Martin	164	1	165
24	Centre	28	3	05	308	Prudemanche	252	2	254
24	Centre	28	1	25	309	Prunay-le-Gillon	992	16	1008
24	Centre	28	3	22	310	La Puisaye	249	3	252
24	Centre	28	1	16	311	Le Puiset	402	17	419
24	Centre	28	3	10	312	Puiseux	118	1	119
24	Centre	28	1	24	313	Réclainville	181	1	182
24	Centre	28	3	14	314	Les Ressuintes	144	3	147
24	Centre	28	3	05	315	Revercourt	30	3	33
24	Centre	28	3	14	316	Rohaire	152	4	156
24	Centre	28	1	02	317	Roinville	387	5	392
24	Centre	28	2	11	318	Romilly-sur-Aigre	500	12	512
24	Centre	28	1	16	319	Rouvray-Saint-Denis	465	3	468
24	Centre	28	1	24	320	Rouvray-Saint-Florentin	197	8	205
24	Centre	28	3	01	321	Rouvres	875	19	894
24	Centre	28	3	05	322	Rueil-la-Gadelière	499	2	501
24	Centre	28	3	10	323	Saint-Ange-et-Torçay	278	9	287
24	Centre	28	1	12	324	Saint-Arnoult-des-Bois	889	8	897
24	Centre	28	1	30	325	Saint-Aubin-des-Bois	968	30	998
24	Centre	28	2	06	326	Saint-Avit-les-Guespières	341	11	352
24	Centre	28	4	03	327	Saint-Bomer	208	2	210
24	Centre	28	2	09	329	Saint-Christophe	147	2	149
24	Centre	28	2	09	330	Saint-Cloud-en-Dunois	230	3	233
24	Centre	28	4	23	331	Saint-Denis-d;Authou	501	5	506
24	Centre	28	1	12	333	Saint-Denis-des-Puits	133	0	133
24	Centre	28	2	09	334	Saint-Denis-les-Ponts	1802	52	1854
24	Centre	28	4	17	335	Saint-Éliph	870	24	894
24	Centre	28	1	15	336	Saint-Éman	113	2	115
24	Centre	28	1	12	337	Saint-Georges-sur-Eure	2468	90	2558
24	Centre	28	1	12	339	Saint-Germain-le-Gaillard	313	9	322
24	Centre	28	2	11	340	Saint-Hilaire-sur-Yerre	500	9	509
24	Centre	28	3	10	341	Saint-Jean-de-Rebervilliers	224	2	226
24	Centre	28	4	20	342	Saint-Jean-Pierre-Fixte	280	14	294
24	Centre	28	3	19	343	Saint-Laurent-la-Gâtine	445	13	458
24	Centre	28	1	02	344	Saint-Léger-des-Aubées	254	3	257
24	Centre	28	3	05	346	Saint-Lubin-de-Cravant	62	3	65
24	Centre	28	3	01	347	Saint-Lubin-de-la-Haye	903	15	918
24	Centre	28	3	05	348	Saint-Lubin-des-Joncherets	4193	49	4242
24	Centre	28	3	19	349	Saint-Lucien	243	5	248
24	Centre	28	1	12	350	Saint-Luperce	875	23	898
24	Centre	28	3	10	351	Saint-Maixme-Hauterive	453	3	456
24	Centre	28	1	18	352	Saint-Martin-de-Nigelles	1610	35	1645
24	Centre	28	2	04	353	Saint-Maur-sur-le-Loir	376	14	390
24	Centre	28	4	17	354	Saint-Maurice-Saint-Germain	404	40	444
24	Centre	28	3	01	355	Saint-Ouen-Marchefroy	336	8	344
24	Centre	28	2	11	356	Saint-Pellerin	362	4	366
24	Centre	28	1	18	357	Saint-Piat	1145	29	1174
24	Centre	28	1	07	358	Saint-Prest	2040	112	2152
24	Centre	28	3	05	359	Saint-Rémy-sur-Avre	3701	40	3741
24	Centre	28	3	10	360	Saint-Sauveur-Marville	928	20	948
24	Centre	28	4	17	362	Saint-Victor-de-Buthon	522	8	530
24	Centre	28	3	13	332	Sainte-Gemme-Moronval	1007	24	1031
24	Centre	28	1	02	363	Sainville	962	25	987
24	Centre	28	2	04	364	Sancheville	798	9	807
24	Centre	28	1	15	365	Sandarville	391	17	408
24	Centre	28	1	02	366	Santeuil	274	1	275
24	Centre	28	1	16	367	Santilly	356	1	357
24	Centre	28	3	22	368	La Saucelle	167	4	171
24	Centre	28	3	27	369	Saulnières	623	17	640
24	Centre	28	2	04	370	Saumeray	431	8	439
24	Centre	28	3	01	371	Saussay	1047	13	1060
24	Centre	28	3	19	372	Senantes	622	9	631
24	Centre	28	3	22	373	Senonches	3148	54	3202
24	Centre	28	3	10	374	Serazereux	517	11	528
24	Centre	28	3	01	375	Serville	361	6	367
24	Centre	28	4	03	376	Soizé	309	1	310
24	Centre	28	3	01	377	Sorel-Moussel	1767	32	1799
24	Centre	28	4	20	378	Souancé-au-Perche	547	18	565
24	Centre	28	1	18	379	Soulaires	450	10	460
24	Centre	28	1	25	380	Sours	1827	172	1999
24	Centre	28	2	21	382	Terminiers	990	12	1002
24	Centre	28	1	24	383	Theuville	424	18	442
24	Centre	28	4	17	385	Le Thieulin	409	57	466
24	Centre	28	3	10	386	Thimert-Gâtelles	1124	23	1147
24	Centre	28	4	23	387	Thiron-Gardais	1100	12	1112
24	Centre	28	1	26	388	Thivars	951	28	979
24	Centre	28	2	09	389	Thiville	368	12	380
24	Centre	28	2	21	390	Tillay-le-Péneux	355	16	371
24	Centre	28	1	16	391	Toury	2613	47	2660
24	Centre	28	1	16	392	Trancrainville	177	3	180
24	Centre	28	3	10	393	Tremblay-les-Villages	2248	22	2270
24	Centre	28	3	28	394	Tréon	1367	21	1388
24	Centre	28	4	20	395	Trizay-Coutretot-Saint-Serge	473	15	488
24	Centre	28	2	04	396	Trizay-lès-Bonneval	296	5	301
24	Centre	28	1	02	397	Umpeau	429	3	432
24	Centre	28	2	06	398	Unverre	1229	23	1252
24	Centre	28	2	21	400	Varize	211	4	215
24	Centre	28	4	17	401	Vaupillon	472	7	479
24	Centre	28	1	26	403	Ver-lès-Chartres	809	58	867
24	Centre	28	1	12	402	Vérigny	299	6	305
24	Centre	28	3	28	404	Vernouillet	11751	130	11881
24	Centre	28	3	27	405	Vert-en-Drouais	1121	22	1143
24	Centre	28	1	24	406	Viabon	320	8	328
24	Centre	28	4	20	407	Vichères	319	8	327
24	Centre	28	1	02	408	Vierville	115	1	116
24	Centre	28	2	06	409	Vieuvicq	465	8	473
24	Centre	28	2	09	410	Villampuy	320	5	325
24	Centre	28	1	24	411	Villars	155	2	157
24	Centre	28	1	24	412	Villeau	172	2	174
24	Centre	28	1	12	414	Villebon	72	2	74
24	Centre	28	3	19	415	Villemeux-sur-Eure	1620	34	1654
24	Centre	28	1	24	416	Villeneuve-Saint-Nicolas	143	5	148
24	Centre	28	3	19	417	Villiers-le-Morhier	1345	21	1366
24	Centre	28	2	04	418	Villiers-Saint-Orien	168	2	170
24	Centre	28	2	04	419	Vitray-en-Beauce	353	4	357
24	Centre	28	1	02	421	Voise	285	6	291
24	Centre	28	1	24	422	Voves	2946	57	3003
24	Centre	28	1	18	423	Yermenonville	571	10	581
24	Centre	28	2	06	424	Yèvres	1708	37	1745
24	Centre	28	1	18	425	Ymeray	606	13	619
24	Centre	28	1	24	426	Ymonville	496	20	516
53	Bretagne	29	2	11	001	Argol	888	25	913
53	Bretagne	29	4	01	002	Arzano	1403	23	1426
53	Bretagne	29	4	33	003	Audierne	2208	66	2274
53	Bretagne	29	4	02	004	Bannalec	5450	165	5615
53	Bretagne	29	4	36	005	Baye	1141	45	1186
53	Bretagne	29	4	15	006	Bénodet	3331	86	3417
53	Bretagne	29	2	16	007	Berrien	960	14	974
53	Bretagne	29	4	33	008	Beuzec-Cap-Sizun	1064	34	1098
53	Bretagne	29	3	18	010	Bodilis	1564	51	1615
53	Bretagne	29	1	44	011	Bohars	3363	115	3478
53	Bretagne	29	2	16	012	Bolazec	192	5	197
53	Bretagne	29	2	16	013	Botmeur	224	3	227
53	Bretagne	29	3	30	014	Botsorhel	463	11	474
53	Bretagne	29	1	24	015	Bourg-Blanc	3399	71	3470
53	Bretagne	29	2	25	016	Brasparts	1039	22	1061
53	Bretagne	29	1	27	017	Brélès	828	26	854
53	Bretagne	29	2	25	018	Brennilis	448	8	456
53	Bretagne	29	1	99	019	Brest	141303	4258	145561
53	Bretagne	29	4	06	020	Briec	5376	125	5501
53	Bretagne	29	1	21	021	Brignogan-Plage	813	25	838
53	Bretagne	29	2	11	022	Camaret-sur-Mer	2609	43	2652
53	Bretagne	29	3	43	023	Carantec	3189	121	3310
53	Bretagne	29	2	07	024	Carhaix-Plouguer	7659	544	8203
53	Bretagne	29	2	08	025	Cast	1587	57	1644
53	Bretagne	29	2	08	026	Châteaulin	5213	535	5748
53	Bretagne	29	2	09	027	Châteauneuf-du-Faou	3666	126	3792
53	Bretagne	29	4	33	028	Cléden-Cap-Sizun	1014	15	1029
53	Bretagne	29	2	07	029	Cléden-Poher	1094	31	1125
53	Bretagne	29	3	31	030	Cléder	3824	85	3909
53	Bretagne	29	4	36	031	Clohars-Carnoët	4057	129	4186
53	Bretagne	29	4	15	032	Clohars-Fouesnant	2243	53	2296
53	Bretagne	29	2	25	033	Le Cloître-Pleyben	579	17	596
53	Bretagne	29	3	40	034	Le Cloître-Saint-Thégonnec	635	14	649
53	Bretagne	29	1	24	035	Coat-Méal	1009	22	1031
53	Bretagne	29	2	09	036	Collorec	664	8	672
53	Bretagne	29	4	34	037	Combrit	3521	118	3639
53	Bretagne	29	3	42	038	Commana	1132	34	1166
53	Bretagne	29	4	10	039	Concarneau	19048	640	19688
53	Bretagne	29	4	33	145	Confort-Meilars	903	19	922
53	Bretagne	29	1	39	040	Le Conquet	2666	57	2723
53	Bretagne	29	2	09	041	Coray	1846	34	1880
53	Bretagne	29	2	11	042	Crozon	7809	256	8065
53	Bretagne	29	1	12	043	Daoulas	1782	62	1844
53	Bretagne	29	2	08	044	Dinéault	1757	75	1832
53	Bretagne	29	1	17	045	Dirinon	2455	87	2542
53	Bretagne	29	4	13	046	Douarnenez	14912	628	15540
53	Bretagne	29	1	24	047	Le Drennec	1803	44	1847
53	Bretagne	29	4	06	048	Edern	2112	59	2171
53	Bretagne	29	4	37	049	Elliant	3271	215	3486
53	Bretagne	29	4	48	051	Ergué-Gabéric	7864	253	8117
53	Bretagne	29	4	33	052	Esquibien	1605	38	1643
53	Bretagne	29	2	14	053	Le Faou	1738	80	1818
53	Bretagne	29	2	16	054	La Feuillée	654	23	677
53	Bretagne	29	1	21	055	Le Folgoët	3055	110	3165
53	Bretagne	29	1	17	056	La Forest-Landerneau	1829	33	1862
53	Bretagne	29	4	15	057	La Forêt-Fouesnant	3327	105	3432
53	Bretagne	29	4	15	058	Fouesnant	9155	443	9598
53	Bretagne	29	3	19	059	Garlan	990	20	1010
53	Bretagne	29	4	15	060	Gouesnach	2556	85	2641
53	Bretagne	29	1	46	061	Gouesnou	6126	243	6369
53	Bretagne	29	2	25	062	Gouézec	1112	31	1143
53	Bretagne	29	4	33	063	Goulien	430	11	441
53	Bretagne	29	1	21	064	Goulven	455	17	472
53	Bretagne	29	4	26	065	Gourlizon	881	23	904
53	Bretagne	29	4	13	066	Guengat	1635	47	1682
53	Bretagne	29	3	30	067	Guerlesquin	1369	28	1397
53	Bretagne	29	3	43	068	Guiclan	2252	70	2322
53	Bretagne	29	4	26	070	Guiler-sur-Goyen	498	16	514
53	Bretagne	29	1	44	069	Guilers	7415	181	7596
53	Bretagne	29	4	01	071	Guilligomarc;h	710	17	727
53	Bretagne	29	4	49	072	Guilvinec	2892	84	2976
53	Bretagne	29	3	19	073	Guimaëc	952	30	982
53	Bretagne	29	3	18	074	Guimiliau	986	31	1017
53	Bretagne	29	1	51	075	Guipavas	13403	442	13845
53	Bretagne	29	1	39	076	Guipronvel	762	9	771
53	Bretagne	29	1	20	077	Guissény	2012	42	2054
53	Bretagne	29	1	12	078	Hanvec	1959	41	2000
53	Bretagne	29	3	43	079	Henvic	1298	41	1339
53	Bretagne	29	1	12	080	Hôpital-Camfrout	2135	49	2184
53	Bretagne	29	2	16	081	Huelgoat	1638	25	1663
53	Bretagne	29	3	38	082	Île-de-Batz	507	16	523
53	Bretagne	29	4	33	083	Île-de-Sein	195	10	205
53	Bretagne	29	1	39	084	Île-Molène	208	5	213
53	Bretagne	29	4	34	085	Île-Tudy	729	21	750
53	Bretagne	29	1	12	086	Irvillac	1348	30	1378
53	Bretagne	29	4	13	087	Le Juch	740	16	756
53	Bretagne	29	2	07	089	Kergloff	939	30	969
53	Bretagne	29	2	08	090	Kerlaz	810	54	864
53	Bretagne	29	1	21	091	Kerlouan	2284	48	2332
53	Bretagne	29	1	24	093	Kernilis	1350	28	1378
53	Bretagne	29	1	21	094	Kernouës	707	19	726
53	Bretagne	29	1	24	095	Kersaint-Plabennec	1317	25	1342
53	Bretagne	29	3	18	097	Lampaul-Guimiliau	2024	67	2091
53	Bretagne	29	1	39	098	Lampaul-Plouarzel	2054	43	2097
53	Bretagne	29	1	27	099	Lampaul-Ploudalmézeau	761	14	775
53	Bretagne	29	1	24	100	Lanarvily	419	9	428
53	Bretagne	29	1	20	101	Landéda	3612	114	3726
53	Bretagne	29	2	09	102	Landeleau	1010	31	1041
53	Bretagne	29	1	17	103	Landerneau	15272	631	15903
53	Bretagne	29	2	11	104	Landévennec	346	17	363
53	Bretagne	29	3	18	105	Landivisiau	9167	352	9519
53	Bretagne	29	4	06	106	Landrévarzec	1653	54	1707
53	Bretagne	29	4	06	107	Landudal	819	22	841
53	Bretagne	29	4	26	108	Landudec	1337	20	1357
53	Bretagne	29	1	27	109	Landunvez	1417	38	1455
53	Bretagne	29	4	06	110	Langolen	881	23	904
53	Bretagne	29	3	29	111	Lanhouarneau	1165	17	1182
53	Bretagne	29	1	27	112	Lanildut	953	24	977
53	Bretagne	29	3	19	113	Lanmeur	2171	59	2230
53	Bretagne	29	3	30	114	Lannéanou	360	9	369
53	Bretagne	29	2	25	115	Lannédern	311	11	322
53	Bretagne	29	1	28	116	Lanneuffret	126	3	129
53	Bretagne	29	1	20	117	Lannilis	5293	110	5403
53	Bretagne	29	1	39	119	Lanrivoaré	1425	35	1460
53	Bretagne	29	2	11	120	Lanvéoc	2220	46	2266
53	Bretagne	29	2	09	122	Laz	696	18	714
53	Bretagne	29	2	25	123	Lennon	790	20	810
53	Bretagne	29	1	21	124	Lesneven	7083	506	7589
53	Bretagne	29	2	09	125	Leuhan	791	23	814
53	Bretagne	29	1	24	126	Loc-Brévalaire	211	4	215
53	Bretagne	29	1	28	128	Loc-Eguiner	346	13	359
53	Bretagne	29	3	40	127	Loc-Eguiner-Saint-Thégonnec	320	5	325
53	Bretagne	29	2	16	129	Locmaria-Berrien	229	7	236
53	Bretagne	29	1	39	130	Locmaria-Plouzané	4826	136	4962
53	Bretagne	29	3	42	131	Locmélar	440	16	456
53	Bretagne	29	3	43	132	Locquénolé	808	36	844
53	Bretagne	29	3	19	133	Locquirec	1476	46	1522
53	Bretagne	29	2	08	134	Locronan	793	39	832
53	Bretagne	29	4	49	135	Loctudy	4136	126	4262
53	Bretagne	29	4	01	136	Locunolé	1098	30	1128
53	Bretagne	29	1	12	137	Logonna-Daoulas	2093	67	2160
53	Bretagne	29	2	14	139	Lopérec	826	198	1024
53	Bretagne	29	1	12	140	Loperhet	3602	122	3724
53	Bretagne	29	2	25	141	Loqueffret	402	12	414
53	Bretagne	29	2	25	142	Lothey	423	12	435
53	Bretagne	29	4	33	143	Mahalon	881	25	906
53	Bretagne	29	1	28	144	La Martyre	763	10	773
53	Bretagne	29	4	02	146	Melgven	3304	78	3382
53	Bretagne	29	4	36	147	Mellac	2623	86	2709
53	Bretagne	29	3	38	148	Mespaul	891	20	911
53	Bretagne	29	1	39	149	Milizac	3009	54	3063
53	Bretagne	29	4	32	150	Moëlan-sur-Mer	6968	165	7133
53	Bretagne	29	3	22	151	Morlaix	15421	1126	16547
53	Bretagne	29	2	07	152	Motreff	741	11	752
53	Bretagne	29	4	32	153	Névez	2739	59	2798
53	Bretagne	29	1	23	155	Ouessant	871	23	894
53	Bretagne	29	1	17	156	Pencran	1770	44	1814
53	Bretagne	29	4	49	158	Penmarch	5796	169	5965
53	Bretagne	29	4	26	159	Peumérit	781	23	804
53	Bretagne	29	1	24	160	Plabennec	8084	346	8430
53	Bretagne	29	4	15	161	Pleuven	2643	100	2743
53	Bretagne	29	2	25	162	Pleyben	3690	293	3983
53	Bretagne	29	3	40	163	Pleyber-Christ	3070	139	3209
53	Bretagne	29	4	49	165	Plobannalec-Lesconil	3332	103	3435
53	Bretagne	29	2	08	166	Ploéven	508	10	518
53	Bretagne	29	4	26	167	Plogastel-Saint-Germain	1839	61	1900
53	Bretagne	29	4	33	168	Plogoff	1335	48	1383
53	Bretagne	29	4	13	169	Plogonnec	3043	69	3112
53	Bretagne	29	4	52	170	Plomelin	4113	191	4304
53	Bretagne	29	4	34	171	Plomeur	3689	110	3799
53	Bretagne	29	2	08	172	Plomodiern	2212	72	2284
53	Bretagne	29	4	26	173	Plonéis	1996	52	2048
53	Bretagne	29	4	26	174	Plonéour-Lanvern	5825	146	5971
53	Bretagne	29	2	09	175	Plonévez-du-Faou	2138	66	2204
53	Bretagne	29	2	08	176	Plonévez-Porzay	1717	47	1764
53	Bretagne	29	1	39	177	Plouarzel	3618	68	3686
53	Bretagne	29	1	27	178	Ploudalmézeau	6301	130	6431
53	Bretagne	29	1	21	179	Ploudaniel	3683	163	3846
53	Bretagne	29	1	28	180	Ploudiry	895	22	917
53	Bretagne	29	1	17	181	Plouédern	2793	81	2874
53	Bretagne	29	3	19	182	Plouégat-Guérand	1080	34	1114
53	Bretagne	29	3	30	183	Plouégat-Moysan	648	13	661
53	Bretagne	29	3	38	184	Plouénan	2418	48	2466
53	Bretagne	29	3	29	185	Plouescat	3609	112	3721
53	Bretagne	29	3	19	186	Plouezoc;h	1585	73	1658
53	Bretagne	29	3	29	187	Plougar	777	21	798
53	Bretagne	29	3	19	188	Plougasnou	3212	103	3315
53	Bretagne	29	1	12	189	Plougastel-Daoulas	13178	409	13587
53	Bretagne	29	1	39	190	Plougonvelin	3760	106	3866
53	Bretagne	29	3	30	191	Plougonven	3293	76	3369
53	Bretagne	29	3	38	192	Plougoulm	1798	57	1855
53	Bretagne	29	3	18	193	Plougourvest	1317	30	1347
53	Bretagne	29	1	20	195	Plouguerneau	6393	134	6527
53	Bretagne	29	1	27	196	Plouguin	2085	53	2138
53	Bretagne	29	4	33	197	Plouhinec	4165	143	4308
53	Bretagne	29	1	21	198	Plouider	1965	57	2022
53	Bretagne	29	3	30	199	Plouigneau	4753	230	4983
53	Bretagne	29	1	39	201	Ploumoguer	1960	44	2004
53	Bretagne	29	3	40	202	Plounéour-Ménez	1265	33	1298
53	Bretagne	29	1	21	203	Plounéour-Trez	1242	23	1265
53	Bretagne	29	3	18	204	Plounéventer	1923	39	1962
53	Bretagne	29	3	29	206	Plounévez-Lochrist	2404	110	2514
53	Bretagne	29	2	07	205	Plounévézel	1164	28	1192
53	Bretagne	29	1	27	208	Plourin	1194	19	1213
53	Bretagne	29	3	22	207	Plourin-lès-Morlaix	4448	320	4768
53	Bretagne	29	1	24	209	Plouvien	3693	71	3764
53	Bretagne	29	3	31	210	Plouvorn	2763	85	2848
53	Bretagne	29	2	16	211	Plouyé	742	15	757
53	Bretagne	29	1	03	212	Plouzané	11717	295	12012
53	Bretagne	29	3	31	213	Plouzévédé	1684	50	1734
53	Bretagne	29	4	26	214	Plovan	674	21	695
53	Bretagne	29	4	26	215	Plozévet	2998	96	3094
53	Bretagne	29	4	52	216	Pluguffan	3540	93	3633
53	Bretagne	29	4	32	217	Pont-Aven	2844	76	2920
53	Bretagne	29	4	33	218	Pont-Croix	1766	43	1809
53	Bretagne	29	2	14	302	Pont-de-Buis-lès-Quimerch	3867	170	4037
53	Bretagne	29	4	34	220	Pont-l;Abbé	8322	453	8775
53	Bretagne	29	3	30	219	Le Ponthou	164	5	169
53	Bretagne	29	1	27	221	Porspoder	1738	55	1793
53	Bretagne	29	2	08	222	Port-Launay	440	59	499
53	Bretagne	29	4	13	224	Pouldergat	1248	42	1290
53	Bretagne	29	4	26	225	Pouldreuzic	1980	51	2031
53	Bretagne	29	4	13	226	Poullan-sur-Mer	1523	124	1647
53	Bretagne	29	2	07	227	Poullaouen	1400	51	1451
53	Bretagne	29	4	33	228	Primelin	748	19	767
53	Bretagne	29	2	08	229	Quéménéven	1138	35	1173
53	Bretagne	29	4	41	230	Querrien	1696	34	1730
53	Bretagne	29	4	98	232	Quimper	63550	3581	67131
53	Bretagne	29	4	36	233	Quimperlé	11776	667	12443
53	Bretagne	29	4	01	234	Rédené	2849	109	2958
53	Bretagne	29	1	51	235	Le Relecq-Kerhuon	10762	279	11041
53	Bretagne	29	4	32	236	Riec-sur-Belon	4131	106	4237
53	Bretagne	29	1	28	237	La Roche-Maurice	1902	48	1950
53	Bretagne	29	2	11	238	Roscanvel	909	30	939
53	Bretagne	29	3	38	239	Roscoff	3626	100	3726
53	Bretagne	29	2	14	240	Rosnoën	1002	30	1032
53	Bretagne	29	4	37	241	Rosporden	7227	129	7356
53	Bretagne	29	2	08	243	Saint-Coulitz	421	19	440
53	Bretagne	29	3	18	244	Saint-Derrien	770	10	780
53	Bretagne	29	1	17	245	Saint-Divy	1353	33	1386
53	Bretagne	29	1	12	246	Saint-Eloy	212	4	216
53	Bretagne	29	4	15	247	Saint-Évarzec	3486	98	3584
53	Bretagne	29	1	21	248	Saint-Frégant	692	15	707
53	Bretagne	29	2	09	249	Saint-Goazec	699	17	716
53	Bretagne	29	2	07	250	Saint-Hernin	748	36	784
53	Bretagne	29	3	19	251	Saint-Jean-du-Doigt	617	18	635
53	Bretagne	29	4	34	252	Saint-Jean-Trolimon	998	30	1028
53	Bretagne	29	3	22	254	Saint-Martin-des-Champs	4759	208	4967
53	Bretagne	29	1	21	255	Saint-Méen	795	19	814
53	Bretagne	29	2	08	256	Saint-Nic	737	25	762
53	Bretagne	29	1	27	257	Saint-Pabu	1999	51	2050
53	Bretagne	29	3	38	259	Saint-Pol-de-Léon	6904	288	7192
53	Bretagne	29	1	39	260	Saint-Renan	7515	211	7726
53	Bretagne	29	2	25	261	Saint-Rivoal	170	4	174
53	Bretagne	29	3	42	262	Saint-Sauveur	771	10	781
53	Bretagne	29	2	08	263	Saint-Ségal	996	39	1035
53	Bretagne	29	3	18	264	Saint-Servais	720	9	729
53	Bretagne	29	3	40	266	Saint-Thégonnec	2648	95	2743
53	Bretagne	29	2	09	267	Saint-Thois	725	17	742
53	Bretagne	29	1	17	268	Saint-Thonan	1400	24	1424
53	Bretagne	29	4	41	269	Saint-Thurien	959	25	984
53	Bretagne	29	1	12	270	Saint-Urbain	1492	42	1534
53	Bretagne	29	3	31	271	Saint-Vougay	923	9	932
53	Bretagne	29	4	37	272	Saint-Yvi	2795	82	2877
53	Bretagne	29	3	22	265	Sainte-Sève	871	32	903
53	Bretagne	29	3	38	273	Santec	2284	74	2358
53	Bretagne	29	4	41	274	Scaër	5290	123	5413
53	Bretagne	29	2	16	275	Scrignac	802	30	832
53	Bretagne	29	3	38	276	Sibiril	1245	34	1279
53	Bretagne	29	3	42	277	Sizun	2227	67	2294
53	Bretagne	29	2	07	278	Spézet	1816	56	1872
53	Bretagne	29	3	43	279	Taulé	2929	97	3026
53	Bretagne	29	2	11	280	Telgruc-sur-Mer	2092	70	2162
53	Bretagne	29	4	37	281	Tourch	988	15	1003
53	Bretagne	29	1	39	282	Trébabu	365	10	375
53	Bretagne	29	4	49	284	Treffiagat	2378	101	2479
53	Bretagne	29	3	31	285	Tréflaouénan	534	14	548
53	Bretagne	29	1	28	286	Tréflévénez	281	8	289
53	Bretagne	29	3	29	287	Tréflez	908	23	931
53	Bretagne	29	1	21	288	Trégarantec	580	17	597
53	Bretagne	29	2	08	289	Trégarvan	140	4	144
53	Bretagne	29	1	20	290	Tréglonou	600	11	611
53	Bretagne	29	2	09	291	Trégourez	960	19	979
53	Bretagne	29	4	34	292	Tréguennec	340	16	356
53	Bretagne	29	4	10	293	Trégunc	6837	236	7073
53	Bretagne	29	1	28	294	Le Tréhou	583	8	591
53	Bretagne	29	1	17	295	Trémaouézan	516	12	528
53	Bretagne	29	4	34	296	Tréméoc	1236	36	1272
53	Bretagne	29	4	36	297	Tréméven	2239	45	2284
53	Bretagne	29	4	26	298	Tréogat	539	10	549
53	Bretagne	29	1	27	299	Tréouergat	302	4	306
53	Bretagne	29	4	02	300	Le Trévoux	1500	40	1540
53	Bretagne	29	3	31	301	Trézilidé	277	0	277
91	Languedoc-Roussillon	30	2	35	001	Aigaliers	489	6	495
91	Languedoc-Roussillon	30	1	14	002	Aigremont	670	8	678
91	Languedoc-Roussillon	30	2	01	003	Aigues-Mortes	8341	85	8426
91	Languedoc-Roussillon	30	2	32	004	Aigues-Vives	2990	41	3031
91	Languedoc-Roussillon	30	2	20	005	Aiguèze	230	2	232
91	Languedoc-Roussillon	30	2	46	006	Aimargues	4313	35	4348
91	Languedoc-Roussillon	30	1	98	007	Alès	41205	1492	42697
91	Languedoc-Roussillon	30	1	24	008	Allègre-les-Fumades	793	17	810
91	Languedoc-Roussillon	30	3	04	009	Alzon	220	7	227
91	Languedoc-Roussillon	30	1	05	010	Anduze	3287	58	3345
91	Languedoc-Roussillon	30	2	40	011	Les Angles	8240	215	8455
91	Languedoc-Roussillon	30	2	06	012	Aramon	3816	84	3900
91	Languedoc-Roussillon	30	2	22	013	Argilliers	387	2	389
91	Languedoc-Roussillon	30	2	35	014	Arpaillargues-et-Aureillac	1024	18	1042
91	Languedoc-Roussillon	30	3	39	015	Arphy	171	3	174
91	Languedoc-Roussillon	30	3	39	016	Arre	289	5	294
91	Languedoc-Roussillon	30	3	04	017	Arrigas	202	6	208
91	Languedoc-Roussillon	30	2	32	018	Aspères	493	12	505
91	Languedoc-Roussillon	30	2	32	019	Aubais	2412	52	2464
91	Languedoc-Roussillon	30	2	37	020	Aubord	2369	46	2415
91	Languedoc-Roussillon	30	2	26	021	Aubussargues	353	3	356
91	Languedoc-Roussillon	30	1	11	022	Aujac	181	6	187
91	Languedoc-Roussillon	30	2	32	023	Aujargues	847	15	862
91	Languedoc-Roussillon	30	3	39	024	Aulas	443	14	457
91	Languedoc-Roussillon	30	3	04	025	Aumessas	224	8	232
91	Languedoc-Roussillon	30	3	39	026	Avèze	1072	28	1100
91	Languedoc-Roussillon	30	1	05	027	Bagard	2448	78	2526
91	Languedoc-Roussillon	30	2	07	028	Bagnols-sur-Cèze	18245	460	18705
91	Languedoc-Roussillon	30	1	08	029	Barjac	1560	34	1594
91	Languedoc-Roussillon	30	2	26	030	Baron	331	3	334
91	Languedoc-Roussillon	30	2	15	031	La Bastide-d;Engras	213	7	220
91	Languedoc-Roussillon	30	2	09	032	Beaucaire	15946	237	16183
91	Languedoc-Roussillon	30	2	37	033	Beauvoisin	3741	53	3794
91	Languedoc-Roussillon	30	2	09	034	Bellegarde	6282	102	6384
91	Languedoc-Roussillon	30	2	15	035	Belvézet	248	8	256
91	Languedoc-Roussillon	30	2	37	036	Bernis	3178	33	3211
91	Languedoc-Roussillon	30	1	10	037	Bessèges	3106	29	3135
91	Languedoc-Roussillon	30	3	39	038	Bez-et-Esparon	360	26	386
91	Languedoc-Roussillon	30	2	16	039	Bezouce	2126	28	2154
91	Languedoc-Roussillon	30	3	04	040	Blandas	129	3	132
91	Languedoc-Roussillon	30	2	35	041	Blauzac	1129	21	1150
91	Languedoc-Roussillon	30	1	05	042	Boisset-et-Gaujac	2398	63	2461
91	Languedoc-Roussillon	30	2	32	043	Boissières	527	15	542
91	Languedoc-Roussillon	30	1	11	044	Bonnevaux	98	1	99
91	Languedoc-Roussillon	30	1	10	045	Bordezac	359	10	369
91	Languedoc-Roussillon	30	1	14	046	Boucoiran-et-Nozières	722	12	734
91	Languedoc-Roussillon	30	2	45	047	Bouillargues	6134	129	6263
91	Languedoc-Roussillon	30	1	24	048	Bouquet	181	3	184
91	Languedoc-Roussillon	30	2	26	049	Bourdic	377	3	380
91	Languedoc-Roussillon	30	3	21	050	Bragassargues	143	7	150
91	Languedoc-Roussillon	30	1	12	051	Branoux-les-Taillades	1363	24	1387
91	Languedoc-Roussillon	30	3	39	052	Bréau-et-Salagosse	425	35	460
91	Languedoc-Roussillon	30	1	38	053	Brignon	808	9	817
91	Languedoc-Roussillon	30	1	38	055	Brouzet-lès-Alès	608	10	618
91	Languedoc-Roussillon	30	3	21	054	Brouzet-lès-Quissac	239	8	247
91	Languedoc-Roussillon	30	2	15	056	La Bruguière	304	6	310
91	Languedoc-Roussillon	30	2	16	057	Cabrières	1397	22	1419
91	Languedoc-Roussillon	30	3	28	058	La Cadière-et-Cambo	203	5	208
91	Languedoc-Roussillon	30	2	46	059	Le Cailar	2362	43	2405
91	Languedoc-Roussillon	30	2	45	060	Caissargues	3735	55	3790
91	Languedoc-Roussillon	30	2	26	061	La Calmette	1942	32	1974
91	Languedoc-Roussillon	30	2	32	062	Calvisson	4994	90	5084
91	Languedoc-Roussillon	30	3	04	064	Campestre-et-Luc	118	1	119
91	Languedoc-Roussillon	30	3	31	065	Canaules-et-Argentières	398	4	402
91	Languedoc-Roussillon	30	3	21	066	Cannes-et-Clairan	469	7	476
91	Languedoc-Roussillon	30	2	35	067	La Capelle-et-Masmolène	401	4	405
91	Languedoc-Roussillon	30	1	14	068	Cardet	859	16	875
91	Languedoc-Roussillon	30	3	21	069	Carnas	430	5	435
91	Languedoc-Roussillon	30	2	20	070	Carsan	658	27	685
91	Languedoc-Roussillon	30	1	14	071	Cassagnoles	425	11	436
91	Languedoc-Roussillon	30	1	38	072	Castelnau-Valence	402	1	403
91	Languedoc-Roussillon	30	2	22	073	Castillon-du-Gard	1453	89	1542
91	Languedoc-Roussillon	30	3	34	074	Causse-Bégon	12	1	13
91	Languedoc-Roussillon	30	2	30	075	Caveirac	3867	89	3956
91	Languedoc-Roussillon	30	2	07	076	Cavillargues	806	32	838
91	Languedoc-Roussillon	30	1	03	077	Cendras	1914	60	1974
91	Languedoc-Roussillon	30	1	11	079	Chambon	287	9	296
91	Languedoc-Roussillon	30	1	11	080	Chamborigaud	794	12	806
91	Languedoc-Roussillon	30	2	07	081	Chusclan	983	24	1007
91	Languedoc-Roussillon	30	2	30	082	Clarensac	3820	75	3895
91	Languedoc-Roussillon	30	2	46	083	Codognan	2441	32	2473
91	Languedoc-Roussillon	30	2	07	084	Codolet	703	10	713
91	Languedoc-Roussillon	30	2	22	085	Collias	1015	26	1041
91	Languedoc-Roussillon	30	2	26	086	Collorgues	551	8	559
91	Languedoc-Roussillon	30	3	13	087	Colognac	199	3	202
91	Languedoc-Roussillon	30	2	30	088	Combas	569	15	584
91	Languedoc-Roussillon	30	2	06	089	Comps	1661	27	1688
91	Languedoc-Roussillon	30	1	11	090	Concoules	243	4	247
91	Languedoc-Roussillon	30	2	32	091	Congénies	1564	36	1600
91	Languedoc-Roussillon	30	2	07	092	Connaux	1563	38	1601
91	Languedoc-Roussillon	30	3	28	093	Conqueyrac	109	1	110
91	Languedoc-Roussillon	30	1	29	094	Corbès	148	2	150
91	Languedoc-Roussillon	30	3	21	095	Corconne	555	7	562
91	Languedoc-Roussillon	30	2	20	096	Cornillon	914	25	939
91	Languedoc-Roussillon	30	1	24	097	Courry	305	7	312
91	Languedoc-Roussillon	30	2	30	098	Crespian	334	6	340
91	Languedoc-Roussillon	30	3	28	099	Cros	253	3	256
91	Languedoc-Roussillon	30	1	38	100	Cruviers-Lascours	643	7	650
91	Languedoc-Roussillon	30	1	38	101	Deaux	608	12	620
91	Languedoc-Roussillon	30	2	26	102	Dions	584	8	592
91	Languedoc-Roussillon	30	2	06	103	Domazan	921	25	946
91	Languedoc-Roussillon	30	1	14	104	Domessargues	707	10	717
91	Languedoc-Roussillon	30	3	34	105	Dourbies	188	4	192
91	Languedoc-Roussillon	30	3	31	106	Durfort-et-Saint-Martin-de-Sossenac	729	21	750
91	Languedoc-Roussillon	30	2	06	107	Estézargues	471	17	488
91	Languedoc-Roussillon	30	3	25	108	L; Estréchure	176	5	181
91	Languedoc-Roussillon	30	1	38	109	Euzet	409	10	419
91	Languedoc-Roussillon	30	2	35	110	Flaux	320	1	321
91	Languedoc-Roussillon	30	2	26	111	Foissac	392	9	401
91	Languedoc-Roussillon	30	2	30	112	Fons	1175	18	1193
91	Languedoc-Roussillon	30	2	15	113	Fons-sur-Lussan	249	6	255
91	Languedoc-Roussillon	30	2	32	114	Fontanès	631	20	651
91	Languedoc-Roussillon	30	2	15	115	Fontarèches	237	3	240
91	Languedoc-Roussillon	30	2	22	116	Fournès	893	9	902
91	Languedoc-Roussillon	30	2	09	117	Fourques	2905	69	2974
91	Languedoc-Roussillon	30	3	31	119	Fressac	132	1	133
91	Languedoc-Roussillon	30	1	10	120	Gagnières	1104	10	1114
91	Languedoc-Roussillon	30	3	21	121	Gailhan	209	6	215
91	Languedoc-Roussillon	30	2	30	122	Gajan	703	14	717
91	Languedoc-Roussillon	30	2	46	123	Gallargues-le-Montueux	3314	85	3399
91	Languedoc-Roussillon	30	2	20	124	Le Garn	223	10	233
91	Languedoc-Roussillon	30	2	45	125	Garons	4475	55	4530
91	Languedoc-Roussillon	30	2	26	126	Garrigues-Sainte-Eulalie	745	19	764
91	Languedoc-Roussillon	30	2	07	127	Gaujac	1000	27	1027
91	Languedoc-Roussillon	30	2	27	128	Générac	3982	50	4032
91	Languedoc-Roussillon	30	1	05	129	Générargues	713	19	732
91	Languedoc-Roussillon	30	1	11	130	Génolhac	877	26	903
91	Languedoc-Roussillon	30	2	20	131	Goudargues	1042	29	1071
91	Languedoc-Roussillon	30	1	12	132	La Grand-Combe	5163	148	5311
91	Languedoc-Roussillon	30	2	01	133	Le Grau-du-Roi	8178	99	8277
91	Languedoc-Roussillon	30	2	20	134	Issirac	220	8	228
91	Languedoc-Roussillon	30	2	09	135	Jonquières-Saint-Vincent	3120	29	3149
91	Languedoc-Roussillon	30	2	32	136	Junas	1089	19	1108
91	Languedoc-Roussillon	30	1	12	137	Lamelouze	99	2	101
91	Languedoc-Roussillon	30	2	32	138	Langlade	2083	52	2135
91	Languedoc-Roussillon	30	3	34	139	Lanuéjols	346	15	361
91	Languedoc-Roussillon	30	3	13	140	Lasalle	1076	27	1103
91	Languedoc-Roussillon	30	2	23	141	Laudun-l;Ardoise	5723	138	5861
91	Languedoc-Roussillon	30	1	12	142	Laval-Pradel	1191	19	1210
91	Languedoc-Roussillon	30	2	20	143	Laval-Saint-Roman	231	12	243
91	Languedoc-Roussillon	30	2	32	144	Lecques	448	2	450
91	Languedoc-Roussillon	30	2	16	145	Lédenon	1380	21	1401
91	Languedoc-Roussillon	30	1	14	146	Lédignan	1417	21	1438
91	Languedoc-Roussillon	30	1	14	147	Lézan	1460	23	1483
91	Languedoc-Roussillon	30	3	21	148	Liouc	244	4	248
91	Languedoc-Roussillon	30	2	23	149	Lirac	882	31	913
91	Languedoc-Roussillon	30	3	31	150	Logrian-Florian	272	7	279
91	Languedoc-Roussillon	30	2	15	151	Lussan	480	9	489
91	Languedoc-Roussillon	30	1	24	152	Les Mages	1855	32	1887
91	Languedoc-Roussillon	30	1	11	153	Malons-et-Elze	105	2	107
91	Languedoc-Roussillon	30	3	39	154	Mandagout	386	19	405
91	Languedoc-Roussillon	30	2	16	155	Manduel	5690	85	5775
91	Languedoc-Roussillon	30	2	16	156	Marguerittes	8634	191	8825
91	Languedoc-Roussillon	30	3	39	157	Mars	174	9	183
91	Languedoc-Roussillon	30	1	38	158	Martignargues	411	11	422
91	Languedoc-Roussillon	30	1	24	159	Le Martinet	810	5	815
91	Languedoc-Roussillon	30	1	14	160	Maruéjols-lès-Gardon	247	1	248
91	Languedoc-Roussillon	30	1	14	161	Massanes	192	2	194
91	Languedoc-Roussillon	30	1	05	162	Massillargues-Attuech	688	24	712
91	Languedoc-Roussillon	30	1	14	163	Mauressargues	168	4	172
91	Languedoc-Roussillon	30	1	08	164	Méjannes-le-Clap	586	12	598
91	Languedoc-Roussillon	30	1	41	165	Méjannes-lès-Alès	1114	38	1152
91	Languedoc-Roussillon	30	2	06	166	Meynes	2344	121	2465
91	Languedoc-Roussillon	30	1	24	167	Meyrannes	843	20	863
91	Languedoc-Roussillon	30	1	29	168	Mialet	586	13	599
91	Languedoc-Roussillon	30	2	45	169	Milhaud	5798	151	5949
91	Languedoc-Roussillon	30	3	39	170	Molières-Cavaillac	910	39	949
91	Languedoc-Roussillon	30	1	24	171	Molières-sur-Cèze	1595	25	1620
91	Languedoc-Roussillon	30	3	13	172	Monoblet	632	52	684
91	Languedoc-Roussillon	30	1	41	173	Mons	1455	50	1505
91	Languedoc-Roussillon	30	2	30	354	Montagnac	174	2	176
91	Languedoc-Roussillon	30	2	35	174	Montaren-et-Saint-Médiers	1504	34	1538
91	Languedoc-Roussillon	30	2	20	175	Montclus	143	9	152
91	Languedoc-Roussillon	30	3	39	176	Montdardier	195	8	203
91	Languedoc-Roussillon	30	1	38	177	Monteils	617	23	640
91	Languedoc-Roussillon	30	2	23	178	Montfaucon	1425	26	1451
91	Languedoc-Roussillon	30	2	06	179	Montfrin	3117	47	3164
91	Languedoc-Roussillon	30	2	26	180	Montignargues	620	20	640
91	Languedoc-Roussillon	30	2	30	181	Montmirat	319	4	323
91	Languedoc-Roussillon	30	2	30	182	Montpezat	1103	18	1121
91	Languedoc-Roussillon	30	2	30	183	Moulézan	551	9	560
91	Languedoc-Roussillon	30	2	26	184	Moussac	1241	8	1249
91	Languedoc-Roussillon	30	2	46	185	Mus	1305	25	1330
91	Languedoc-Roussillon	30	2	32	186	Nages-et-Solorgues	1541	38	1579
91	Languedoc-Roussillon	30	1	24	187	Navacelles	308	9	317
91	Languedoc-Roussillon	30	1	38	188	Ners	694	14	708
91	Languedoc-Roussillon	30	2	99	189	Nîmes	142205	3296	145501
91	Languedoc-Roussillon	30	3	36	190	Notre-Dame-de-la-Rouvière	437	15	452
91	Languedoc-Roussillon	30	2	07	191	Orsan	1106	29	1135
91	Languedoc-Roussillon	30	3	21	192	Orthoux-Sérignac-Quilhan	402	7	409
91	Languedoc-Roussillon	30	2	30	193	Parignargues	581	9	590
91	Languedoc-Roussillon	30	1	10	194	Peyremale	284	7	291
91	Languedoc-Roussillon	30	3	25	195	Peyrolles	40	1	41
91	Languedoc-Roussillon	30	2	07	196	Le Pin	331	10	341
91	Languedoc-Roussillon	30	1	41	197	Les Plans	229	2	231
91	Languedoc-Roussillon	30	3	25	198	Les Plantiers	243	6	249
91	Languedoc-Roussillon	30	3	39	199	Pommiers	63	1	64
91	Languedoc-Roussillon	30	3	28	200	Pompignan	839	10	849
91	Languedoc-Roussillon	30	2	20	202	Pont-Saint-Esprit	10437	259	10696
91	Languedoc-Roussillon	30	1	11	201	Ponteils-et-Brésis	336	10	346
91	Languedoc-Roussillon	30	1	11	203	Portes	365	5	370
91	Languedoc-Roussillon	30	1	24	204	Potelières	324	3	327
91	Languedoc-Roussillon	30	2	15	205	Pougnadoresse	216	3	219
91	Languedoc-Roussillon	30	2	16	206	Poulx	4032	99	4131
91	Languedoc-Roussillon	30	2	22	207	Pouzilhac	618	6	624
91	Languedoc-Roussillon	30	3	31	208	Puechredon	37	1	38
91	Languedoc-Roussillon	30	2	40	209	Pujaut	4004	92	4096
91	Languedoc-Roussillon	30	3	21	210	Quissac	2728	46	2774
91	Languedoc-Roussillon	30	2	16	211	Redessan	3763	64	3827
91	Languedoc-Roussillon	30	2	22	212	Remoulins	2407	25	2432
91	Languedoc-Roussillon	30	3	34	213	Revens	28	0	28
91	Languedoc-Roussillon	30	1	05	214	Ribaute-les-Tavernes	1797	34	1831
91	Languedoc-Roussillon	30	1	08	215	Rivières	334	10	344
91	Languedoc-Roussillon	30	1	10	216	Robiac-Rochessadoule	866	16	882
91	Languedoc-Roussillon	30	2	40	217	Rochefort-du-Gard	7272	164	7436
91	Languedoc-Roussillon	30	1	08	218	Rochegude	214	5	219
91	Languedoc-Roussillon	30	2	45	356	Rodilhan	2576	219	2795
91	Languedoc-Roussillon	30	3	39	219	Rogues	108	2	110
91	Languedoc-Roussillon	30	2	07	222	La Roque-sur-Cèze	173	4	177
91	Languedoc-Roussillon	30	3	33	220	Roquedur	214	9	223
91	Languedoc-Roussillon	30	2	23	221	Roquemaure	5424	106	5530
91	Languedoc-Roussillon	30	1	02	223	Rousson	3747	65	3812
91	Languedoc-Roussillon	30	2	26	224	La Rouvière	612	8	620
91	Languedoc-Roussillon	30	2	07	225	Sabran	1764	24	1788
91	Languedoc-Roussillon	30	2	20	226	Saint-Alexandre	1090	48	1138
91	Languedoc-Roussillon	30	1	24	227	Saint-Ambroix	3389	82	3471
91	Languedoc-Roussillon	30	2	15	232	Saint-André-d;Olérargues	408	15	423
91	Languedoc-Roussillon	30	3	36	229	Saint-André-de-Majencoules	621	14	635
91	Languedoc-Roussillon	30	2	20	230	Saint-André-de-Roquepertuis	534	18	552
91	Languedoc-Roussillon	30	3	25	231	Saint-André-de-Valborgne	466	11	477
91	Languedoc-Roussillon	30	2	30	233	Saint-Bauzély	539	10	549
91	Languedoc-Roussillon	30	1	14	234	Saint-Bénézet	289	3	292
91	Languedoc-Roussillon	30	3	13	236	Saint-Bonnet-de-Salendrinque	98	2	100
91	Languedoc-Roussillon	30	2	06	235	Saint-Bonnet-du-Gard	751	11	762
91	Languedoc-Roussillon	30	1	24	237	Saint-Brès	639	16	655
91	Languedoc-Roussillon	30	3	33	238	Saint-Bresson	55	2	57
91	Languedoc-Roussillon	30	1	38	240	Saint-Césaire-de-Gauzignan	297	2	299
91	Languedoc-Roussillon	30	2	26	241	Saint-Chaptes	1651	32	1683
91	Languedoc-Roussillon	30	2	20	242	Saint-Christol-de-Rodières	166	2	168
91	Languedoc-Roussillon	30	1	03	243	Saint-Christol-lès-Alès	6691	197	6888
91	Languedoc-Roussillon	30	2	32	244	Saint-Clément	315	11	326
91	Languedoc-Roussillon	30	2	30	245	Saint-Côme-et-Maruéjols	798	23	821
91	Languedoc-Roussillon	30	1	24	247	Saint-Denis	250	4	254
91	Languedoc-Roussillon	30	2	26	248	Saint-Dézéry	387	13	400
91	Languedoc-Roussillon	30	2	32	249	Saint-Dionisy	898	22	920
91	Languedoc-Roussillon	30	1	38	250	Saint-Étienne-de-l;Olm	344	19	363
91	Languedoc-Roussillon	30	2	07	251	Saint-Étienne-des-Sorts	521	7	528
91	Languedoc-Roussillon	30	3	13	252	Saint-Félix-de-Pallières	220	5	225
91	Languedoc-Roussillon	30	1	24	253	Saint-Florent-sur-Auzonnet	1174	14	1188
91	Languedoc-Roussillon	30	2	23	254	Saint-Geniès-de-Comolas	1850	37	1887
91	Languedoc-Roussillon	30	2	26	255	Saint-Geniès-de-Malgoirès	2784	37	2821
91	Languedoc-Roussillon	30	2	07	256	Saint-Gervais	664	16	680
91	Languedoc-Roussillon	30	2	16	257	Saint-Gervasy	1751	25	1776
91	Languedoc-Roussillon	30	2	27	258	Saint-Gilles	13564	203	13767
91	Languedoc-Roussillon	30	2	22	260	Saint-Hilaire-d;Ozilhan	766	13	779
91	Languedoc-Roussillon	30	1	41	259	Saint-Hilaire-de-Brethmas	4182	123	4305
91	Languedoc-Roussillon	30	1	38	261	Saint-Hippolyte-de-Caton	208	11	219
91	Languedoc-Roussillon	30	2	35	262	Saint-Hippolyte-de-Montaigu	243	3	246
91	Languedoc-Roussillon	30	3	28	263	Saint-Hippolyte-du-Fort	3830	75	3905
91	Languedoc-Roussillon	30	1	38	264	Saint-Jean-de-Ceyrargues	163	4	167
91	Languedoc-Roussillon	30	3	31	265	Saint-Jean-de-Crieulon	228	11	239
91	Languedoc-Roussillon	30	1	08	266	Saint-Jean-de-Maruéjols-et-Avéjan	935	10	945
91	Languedoc-Roussillon	30	1	14	267	Saint-Jean-de-Serres	515	15	530
91	Languedoc-Roussillon	30	1	24	268	Saint-Jean-de-Valériscle	727	15	742
91	Languedoc-Roussillon	30	1	29	269	Saint-Jean-du-Gard	2684	165	2849
91	Languedoc-Roussillon	30	1	03	270	Saint-Jean-du-Pin	1324	21	1345
91	Languedoc-Roussillon	30	1	24	271	Saint-Julien-de-Cassagnas	625	13	638
91	Languedoc-Roussillon	30	3	33	272	Saint-Julien-de-la-Nef	124	7	131
91	Languedoc-Roussillon	30	2	20	273	Saint-Julien-de-Peyrolas	1259	39	1298
91	Languedoc-Roussillon	30	1	02	274	Saint-Julien-les-Rosiers	3085	60	3145
91	Languedoc-Roussillon	30	1	38	275	Saint-Just-et-Vacquières	299	0	299
91	Languedoc-Roussillon	30	2	01	276	Saint-Laurent-d;Aigouze	3278	37	3315
91	Languedoc-Roussillon	30	2	20	277	Saint-Laurent-de-Carnols	472	11	483
91	Languedoc-Roussillon	30	2	23	278	Saint-Laurent-des-Arbres	2511	49	2560
91	Languedoc-Roussillon	30	2	15	279	Saint-Laurent-la-Vernède	716	11	727
91	Languedoc-Roussillon	30	3	33	280	Saint-Laurent-le-Minier	365	9	374
91	Languedoc-Roussillon	30	2	30	281	Saint-Mamert-du-Gard	1484	35	1519
91	Languedoc-Roussillon	30	2	15	282	Saint-Marcel-de-Careiret	752	22	774
91	Languedoc-Roussillon	30	3	33	283	Saint-Martial	198	1	199
91	Languedoc-Roussillon	30	1	02	284	Saint-Martin-de-Valgalgues	4153	99	4252
91	Languedoc-Roussillon	30	1	38	285	Saint-Maurice-de-Cazevieille	653	7	660
91	Languedoc-Roussillon	30	2	35	286	Saint-Maximin	684	21	705
91	Languedoc-Roussillon	30	2	07	287	Saint-Michel-d;Euzet	583	28	611
91	Languedoc-Roussillon	30	2	07	288	Saint-Nazaire	1208	43	1251
91	Languedoc-Roussillon	30	3	31	289	Saint-Nazaire-des-Gardies	79	1	80
91	Languedoc-Roussillon	30	1	03	291	Saint-Paul-la-Coste	288	14	302
91	Languedoc-Roussillon	30	2	07	355	Saint-Paul-les-Fonts	832	23	855
91	Languedoc-Roussillon	30	2	20	290	Saint-Paulet-de-Caisson	1771	55	1826
91	Languedoc-Roussillon	30	2	07	292	Saint-Pons-la-Calm	426	16	442
91	Languedoc-Roussillon	30	1	08	293	Saint-Privat-de-Champclos	316	2	318
91	Languedoc-Roussillon	30	1	41	294	Saint-Privat-des-Vieux	4585	129	4714
91	Languedoc-Roussillon	30	2	35	295	Saint-Quentin-la-Poterie	2959	85	3044
91	Languedoc-Roussillon	30	3	33	296	Saint-Roman-de-Codières	187	6	193
91	Languedoc-Roussillon	30	3	34	297	Saint-Sauveur-Camprieu	269	0	269
91	Languedoc-Roussillon	30	1	05	298	Saint-Sébastien-d;Aigrefeuille	512	5	517
91	Languedoc-Roussillon	30	2	35	299	Saint-Siffret	1052	22	1074
91	Languedoc-Roussillon	30	3	21	300	Saint-Théodorit	461	7	468
91	Languedoc-Roussillon	30	1	24	303	Saint-Victor-de-Malcap	726	17	743
91	Languedoc-Roussillon	30	2	35	301	Saint-Victor-des-Oules	281	3	284
91	Languedoc-Roussillon	30	2	23	302	Saint-Victor-la-Coste	1893	49	1942
91	Languedoc-Roussillon	30	2	26	228	Sainte-Anastasie	1667	30	1697
91	Languedoc-Roussillon	30	1	12	239	Sainte-Cécile-d;Andorge	569	11	580
91	Languedoc-Roussillon	30	3	13	246	Sainte-Croix-de-Caderle	121	8	129
91	Languedoc-Roussillon	30	2	20	304	Salazac	187	1	188
91	Languedoc-Roussillon	30	1	41	305	Salindres	3101	64	3165
91	Languedoc-Roussillon	30	2	32	306	Salinelles	504	7	511
91	Languedoc-Roussillon	30	1	12	307	Les Salles-du-Gardon	2547	31	2578
91	Languedoc-Roussillon	30	2	35	308	Sanilhac-Sagriès	867	51	918
91	Languedoc-Roussillon	30	3	21	309	Sardan	282	2	284
91	Languedoc-Roussillon	30	3	25	310	Saumane	255	6	261
91	Languedoc-Roussillon	30	3	31	311	Sauve	1920	58	1978
91	Languedoc-Roussillon	30	2	23	312	Sauveterre	1779	52	1831
91	Languedoc-Roussillon	30	2	26	313	Sauzet	710	7	717
91	Languedoc-Roussillon	30	3	31	314	Savignargues	227	3	230
91	Languedoc-Roussillon	30	2	40	315	Saze	1840	36	1876
91	Languedoc-Roussillon	30	1	11	316	Sénéchas	227	18	245
91	Languedoc-Roussillon	30	2	06	317	Sernhac	1644	10	1654
91	Languedoc-Roussillon	30	1	41	318	Servas	194	5	199
91	Languedoc-Roussillon	30	2	35	319	Serviers-et-Labaume	557	8	565
91	Languedoc-Roussillon	30	1	38	320	Seynes	145	0	145
91	Languedoc-Roussillon	30	2	32	321	Sommières	4479	50	4529
91	Languedoc-Roussillon	30	3	13	322	Soudorgues	281	6	287
91	Languedoc-Roussillon	30	1	03	323	Soustelle	152	2	154
91	Languedoc-Roussillon	30	2	32	324	Souvignargues	769	21	790
91	Languedoc-Roussillon	30	3	33	325	Sumène	1614	63	1677
91	Languedoc-Roussillon	30	2	23	326	Tavel	1790	38	1828
91	Languedoc-Roussillon	30	1	08	327	Tharaux	63	2	65
91	Languedoc-Roussillon	30	2	06	328	Théziers	1052	11	1063
91	Languedoc-Roussillon	30	3	13	329	Thoiras	433	10	443
91	Languedoc-Roussillon	30	1	05	330	Tornac	893	17	910
91	Languedoc-Roussillon	30	2	07	331	Tresques	1772	57	1829
91	Languedoc-Roussillon	30	3	34	332	Trèves	112	2	114
91	Languedoc-Roussillon	30	2	46	333	Uchaud	4162	60	4222
91	Languedoc-Roussillon	30	2	35	334	Uzès	8552	427	8979
91	Languedoc-Roussillon	30	3	13	335	Vabres	97	3	100
91	Languedoc-Roussillon	30	2	09	336	Vallabrègues	1336	17	1353
91	Languedoc-Roussillon	30	2	35	337	Vallabrix	379	10	389
91	Languedoc-Roussillon	30	2	15	338	Vallérargues	138	1	139
91	Languedoc-Roussillon	30	3	36	339	Valleraugue	1059	23	1082
91	Languedoc-Roussillon	30	2	22	340	Valliguières	520	4	524
91	Languedoc-Roussillon	30	2	37	341	Vauvert	11023	197	11220
91	Languedoc-Roussillon	30	2	07	342	Vénéjan	1206	49	1255
91	Languedoc-Roussillon	30	2	15	343	Verfeuil	562	16	578
91	Languedoc-Roussillon	30	2	46	344	Vergèze	4465	74	4539
91	Languedoc-Roussillon	30	1	11	345	La Vernarède	347	5	352
91	Languedoc-Roussillon	30	2	22	346	Vers-Pont-du-Gard	1741	50	1791
91	Languedoc-Roussillon	30	2	46	347	Vestric-et-Candiac	1348	21	1369
91	Languedoc-Roussillon	30	1	38	348	Vézénobres	1721	85	1806
91	Languedoc-Roussillon	30	3	21	349	Vic-le-Fesq	396	10	406
91	Languedoc-Roussillon	30	3	39	350	Le Vigan	3942	170	4112
91	Languedoc-Roussillon	30	2	40	351	Villeneuve-lès-Avignon	12384	488	12872
91	Languedoc-Roussillon	30	2	32	352	Villevieille	1681	43	1724
91	Languedoc-Roussillon	30	3	04	353	Vissec	53	0	53
73	Midi-Pyrénées	31	2	16	001	Agassac	117	0	117
73	Midi-Pyrénées	31	1	12	002	Aignes	234	9	243
73	Midi-Pyrénées	31	3	17	003	Aigrefeuille	1077	36	1113
73	Midi-Pyrénées	31	2	02	005	Alan	306	5	311
73	Midi-Pyrénées	31	3	08	006	Albiac	202	3	205
73	Midi-Pyrénées	31	2	16	007	Ambax	70	0	70
73	Midi-Pyrénées	31	2	16	008	Anan	222	6	228
73	Midi-Pyrénées	31	2	05	009	Antichan-de-Frontignes	82	3	85
73	Midi-Pyrénées	31	2	04	010	Antignac	108	7	115
73	Midi-Pyrénées	31	2	01	011	Arbas	241	3	244
73	Midi-Pyrénées	31	2	01	012	Arbon	92	1	93
73	Midi-Pyrénées	31	2	05	013	Ardiège	400	9	409
73	Midi-Pyrénées	31	2	01	014	Arguenos	53	1	54
73	Midi-Pyrénées	31	2	28	015	Argut-Dessous	30	0	30
73	Midi-Pyrénées	31	2	28	017	Arlos	95	3	98
73	Midi-Pyrénées	31	2	31	018	Arnaud-Guilhem	215	4	219
73	Midi-Pyrénées	31	2	04	019	Artigue	35	2	37
73	Midi-Pyrénées	31	2	01	020	Aspet	950	97	1047
73	Midi-Pyrénées	31	2	29	021	Aspret-Sarrat	153	1	154
73	Midi-Pyrénées	31	3	49	022	Aucamville	8049	81	8130
73	Midi-Pyrénées	31	2	02	023	Aulon	360	2	362
73	Midi-Pyrénées	31	3	24	024	Auragne	401	7	408
73	Midi-Pyrénées	31	3	10	025	Aureville	731	19	750
73	Midi-Pyrénées	31	3	08	026	Auriac-sur-Vendinelle	996	30	1026
73	Midi-Pyrénées	31	1	03	027	Auribail	228	7	235
73	Midi-Pyrénées	31	2	02	028	Aurignac	1179	73	1252
73	Midi-Pyrénées	31	3	17	029	Aurin	330	5	335
73	Midi-Pyrénées	31	2	32	030	Ausseing	72	6	78
73	Midi-Pyrénées	31	2	22	031	Ausson	530	16	546
73	Midi-Pyrénées	31	3	15	032	Aussonne	6357	103	6460
73	Midi-Pyrénées	31	1	03	033	Auterive	9107	176	9283
73	Midi-Pyrénées	31	2	31	034	Auzas	193	2	195
73	Midi-Pyrénées	31	3	10	035	Auzeville-Tolosane	3552	277	3829
73	Midi-Pyrénées	31	3	10	036	Auzielle	1284	50	1334
73	Midi-Pyrénées	31	3	38	037	Avignonet-Lauragais	1323	25	1348
73	Midi-Pyrénées	31	3	21	004	Ayguesvives	2373	46	2419
73	Midi-Pyrénées	31	3	19	038	Azas	571	9	580
73	Midi-Pyrénées	31	2	02	039	Bachas	59	2	61
73	Midi-Pyrénées	31	2	28	040	Bachos	27	0	27
73	Midi-Pyrénées	31	2	05	041	Bagiry	83	7	90
73	Midi-Pyrénées	31	2	04	042	Bagnères-de-Luchon	2593	183	2776
73	Midi-Pyrénées	31	2	22	043	Balesta	177	4	181
73	Midi-Pyrénées	31	3	43	044	Balma	13474	358	13832
73	Midi-Pyrénées	31	2	05	045	Barbazan	447	10	457
73	Midi-Pyrénées	31	2	28	046	Baren	5	0	5
73	Midi-Pyrénées	31	1	27	047	Bax	83	7	90
73	Midi-Pyrénées	31	3	21	048	Baziège	3189	34	3223
73	Midi-Pyrénées	31	3	19	049	Bazus	577	10	587
73	Midi-Pyrénées	31	2	31	050	Beauchalot	492	21	513
73	Midi-Pyrénées	31	1	26	051	Beaufort	353	11	364
73	Midi-Pyrénées	31	1	03	052	Beaumont-sur-Lèze	1523	39	1562
73	Midi-Pyrénées	31	3	43	053	Beaupuy	1275	32	1307
73	Midi-Pyrénées	31	3	38	054	Beauteville	185	2	187
73	Midi-Pyrénées	31	3	08	055	Beauville	136	3	139
73	Midi-Pyrénées	31	3	51	056	Beauzelle	5179	117	5296
73	Midi-Pyrénées	31	3	21	057	Belberaud	1273	40	1313
73	Midi-Pyrénées	31	3	21	058	Belbèze-de-Lauragais	104	0	104
73	Midi-Pyrénées	31	2	32	059	Belbèze-en-Comminges	105	2	107
73	Midi-Pyrénées	31	3	25	060	Bélesta-en-Lauragais	112	5	117
73	Midi-Pyrénées	31	3	07	061	Bellegarde-Sainte-Marie	205	3	208
73	Midi-Pyrénées	31	3	07	062	Bellesserre	86	0	86
73	Midi-Pyrénées	31	2	02	063	Benque	163	1	164
73	Midi-Pyrénées	31	2	04	064	Benque-Dessous-et-Dessus	25	1	26
73	Midi-Pyrénées	31	1	26	065	Bérat	2747	61	2808
73	Midi-Pyrénées	31	3	19	066	Bessières	3253	37	3290
73	Midi-Pyrénées	31	2	28	067	Bezins-Garraux	51	0	51
73	Midi-Pyrénées	31	2	04	068	Billière	23	1	24
73	Midi-Pyrénées	31	2	28	590	Binos	35	1	36
73	Midi-Pyrénées	31	3	51	069	Blagnac	21710	409	22119
73	Midi-Pyrénées	31	2	06	070	Blajan	493	4	497
73	Midi-Pyrénées	31	1	09	071	Bois-de-la-Pierre	417	4	421
73	Midi-Pyrénées	31	2	16	072	Boissède	83	1	84
73	Midi-Pyrénées	31	3	39	073	Bondigoux	463	6	469
73	Midi-Pyrénées	31	3	37	074	Bonrepos-Riquet	241	9	250
73	Midi-Pyrénées	31	1	30	075	Bonrepos-sur-Aussonnelle	850	13	863
73	Midi-Pyrénées	31	2	22	076	Bordes-de-Rivière	496	13	509
73	Midi-Pyrénées	31	3	39	077	Le Born	431	10	441
73	Midi-Pyrénées	31	2	22	078	Boudrac	131	1	132
73	Midi-Pyrénées	31	3	14	079	Bouloc	4134	77	4211
73	Midi-Pyrénées	31	2	06	080	Boulogne-sur-Gesse	1612	75	1687
73	Midi-Pyrénées	31	2	04	081	Bourg-d;Oueil	8	0	8
73	Midi-Pyrénées	31	3	17	082	Bourg-Saint-Bernard	903	15	918
73	Midi-Pyrénées	31	2	02	083	Boussan	214	7	221
73	Midi-Pyrénées	31	1	11	084	Boussens	1088	27	1115
73	Midi-Pyrénées	31	2	28	085	Boutx	274	8	282
73	Midi-Pyrénées	31	2	02	086	Bouzin	81	3	84
73	Midi-Pyrénées	31	1	30	087	Bragayrac	272	3	275
73	Midi-Pyrénées	31	3	18	088	Brax	2531	85	2616
73	Midi-Pyrénées	31	3	15	089	Bretx	568	6	574
73	Midi-Pyrénées	31	3	07	090	Brignemont	390	3	393
73	Midi-Pyrénées	31	3	14	091	Bruguières	4967	60	5027
73	Midi-Pyrénées	31	2	28	092	Burgalays	131	5	136
73	Midi-Pyrénées	31	3	15	093	Le Burgaud	710	7	717
73	Midi-Pyrénées	31	3	19	094	Buzet-sur-Tarn	2351	23	2374
73	Midi-Pyrénées	31	2	01	095	Cabanac-Cazaux	122	2	124
73	Midi-Pyrénées	31	3	07	096	Cabanac-Séguenville	172	2	174
73	Midi-Pyrénées	31	3	08	097	Le Cabanial	338	1	339
73	Midi-Pyrénées	31	3	07	098	Cadours	1068	9	1077
73	Midi-Pyrénées	31	3	24	099	Caignac	293	0	293
73	Midi-Pyrénées	31	3	24	100	Calmont	2177	21	2198
73	Midi-Pyrénées	31	1	30	101	Cambernard	429	7	436
73	Midi-Pyrénées	31	3	08	102	Cambiac	227	3	230
73	Midi-Pyrénées	31	1	20	103	Canens	57	1	58
73	Midi-Pyrénées	31	1	09	104	Capens	559	6	565
73	Midi-Pyrénées	31	3	08	105	Caragoudes	233	12	245
73	Midi-Pyrénées	31	3	08	106	Caraman	2357	26	2383
73	Midi-Pyrénées	31	1	09	107	Carbonne	5205	100	5305
73	Midi-Pyrénées	31	2	06	108	Cardeilhac	256	6	262
73	Midi-Pyrénées	31	2	02	109	Cassagnabère-Tournas	432	4	436
73	Midi-Pyrénées	31	2	32	110	Cassagne	645	12	657
73	Midi-Pyrénées	31	1	20	111	Castagnac	301	4	305
73	Midi-Pyrénées	31	2	32	112	Castagnède	176	4	180
73	Midi-Pyrénées	31	3	10	113	Castanet-Tolosan	11033	252	11285
73	Midi-Pyrénées	31	2	32	114	Castelbiague	223	4	227
73	Midi-Pyrénées	31	2	16	115	Castelgaillard	58	1	59
73	Midi-Pyrénées	31	3	49	116	Castelginest	8745	139	8884
73	Midi-Pyrénées	31	3	50	117	Castelmaurou	3751	93	3844
73	Midi-Pyrénées	31	3	14	118	Castelnau-d;Estrétefonds	5600	62	5662
73	Midi-Pyrénées	31	1	13	119	Castelnau-Picampeau	198	2	200
73	Midi-Pyrénées	31	3	07	120	Le Castéra	787	16	803
73	Midi-Pyrénées	31	2	06	121	Castéra-Vignoles	63	1	64
73	Midi-Pyrénées	31	1	13	122	Casties-Labrande	108	1	109
73	Midi-Pyrénées	31	2	04	123	Castillon-de-Larboust	65	1	66
73	Midi-Pyrénées	31	2	31	124	Castillon-de-Saint-Martory	338	6	344
73	Midi-Pyrénées	31	2	04	125	Cathervielle	33	1	34
73	Midi-Pyrénées	31	3	07	126	Caubiac	296	6	302
73	Midi-Pyrénées	31	2	04	127	Caubous	6	1	7
73	Midi-Pyrénées	31	1	12	128	Caujac	777	7	784
73	Midi-Pyrénées	31	2	16	593	Cazac	84	1	85
73	Midi-Pyrénées	31	2	04	129	Cazaril-Laspènes	23	0	23
73	Midi-Pyrénées	31	2	22	130	Cazaril-Tambourès	73	1	74
73	Midi-Pyrénées	31	2	01	131	Cazaunous	62	1	63
73	Midi-Pyrénées	31	2	28	132	Cazaux-Layrisse	65	2	67
73	Midi-Pyrénées	31	2	04	133	Cazeaux-de-Larboust	93	0	93
73	Midi-Pyrénées	31	2	02	134	Cazeneuve-Montaut	70	3	73
73	Midi-Pyrénées	31	1	11	135	Cazères	4667	110	4777
73	Midi-Pyrénées	31	3	14	136	Cépet	1606	12	1618
73	Midi-Pyrénées	31	3	38	137	Cessales	127	7	134
73	Midi-Pyrénées	31	2	06	138	Charlas	224	5	229
73	Midi-Pyrénées	31	2	28	139	Chaum	214	2	216
73	Midi-Pyrénées	31	2	01	140	Chein-Dessus	194	3	197
73	Midi-Pyrénées	31	2	06	141	Ciadoux	264	1	265
73	Midi-Pyrénées	31	2	04	142	Cier-de-Luchon	239	7	246
73	Midi-Pyrénées	31	2	05	143	Cier-de-Rivière	261	6	267
73	Midi-Pyrénées	31	2	28	144	Cierp-Gaud	849	19	868
73	Midi-Pyrénées	31	1	12	145	Cintegabelle	2625	57	2682
73	Midi-Pyrénées	31	2	04	146	Cirès	13	0	13
73	Midi-Pyrénées	31	2	22	147	Clarac	558	22	580
73	Midi-Pyrénées	31	3	10	148	Clermont-le-Fort	532	16	548
73	Midi-Pyrénées	31	3	48	149	Colomiers	35186	294	35480
73	Midi-Pyrénées	31	3	51	150	Cornebarrieu	5724	160	5884
73	Midi-Pyrénées	31	3	21	151	Corronsac	712	17	729
73	Midi-Pyrénées	31	2	16	152	Coueilles	87	3	90
73	Midi-Pyrénées	31	1	11	153	Couladère	443	7	450
73	Midi-Pyrénées	31	2	01	155	Couret	187	3	190
73	Midi-Pyrénées	31	3	07	156	Cox	342	2	344
73	Midi-Pyrénées	31	3	53	157	Cugnaux	15807	235	16042
73	Midi-Pyrénées	31	2	22	158	Cuguron	195	7	202
73	Midi-Pyrénées	31	2	22	159	Le Cuing	424	4	428
73	Midi-Pyrénées	31	3	15	160	Daux	1920	26	1946
73	Midi-Pyrénées	31	3	21	161	Deyme	855	32	887
73	Midi-Pyrénées	31	3	21	162	Donneville	1033	59	1092
73	Midi-Pyrénées	31	3	43	163	Drémil-Lafage	2473	53	2526
73	Midi-Pyrénées	31	3	07	164	Drudas	181	7	188
73	Midi-Pyrénées	31	1	52	165	Eaunes	5390	107	5497
73	Midi-Pyrénées	31	1	30	166	Empeaux	234	5	239
73	Midi-Pyrénées	31	2	01	167	Encausse-les-Thermes	659	12	671
73	Midi-Pyrénées	31	2	02	168	Eoux	119	2	121
73	Midi-Pyrénées	31	3	21	169	Escalquens	5932	191	6123
73	Midi-Pyrénées	31	2	06	170	Escanecrabe	232	2	234
73	Midi-Pyrénées	31	2	32	591	Escoulis	84	0	84
73	Midi-Pyrénées	31	3	21	171	Espanès	262	9	271
73	Midi-Pyrénées	31	2	02	172	Esparron	61	0	61
73	Midi-Pyrénées	31	1	12	173	Esperce	237	9	246
73	Midi-Pyrénées	31	2	01	174	Estadens	511	4	515
73	Midi-Pyrénées	31	2	29	175	Estancarbon	579	11	590
73	Midi-Pyrénées	31	2	28	176	Esténos	185	1	186
73	Midi-Pyrénées	31	2	28	177	Eup	143	9	152
73	Midi-Pyrénées	31	2	16	178	Fabas	213	7	220
73	Midi-Pyrénées	31	3	08	179	Le Faget	366	6	372
73	Midi-Pyrénées	31	3	25	180	Falga	110	5	115
73	Midi-Pyrénées	31	1	23	181	Le Fauga	1776	32	1808
73	Midi-Pyrénées	31	3	49	182	Fenouillet	5166	45	5211
73	Midi-Pyrénées	31	2	32	183	Figarol	276	7	283
73	Midi-Pyrénées	31	3	43	184	Flourens	1791	30	1821
73	Midi-Pyrénées	31	3	38	185	Folcarde	126	4	130
73	Midi-Pyrénées	31	3	49	186	Fonbeauzard	2764	42	2806
73	Midi-Pyrénées	31	1	30	187	Fonsorbes	11111	190	11301
73	Midi-Pyrénées	31	1	30	188	Fontenilles	4505	101	4606
73	Midi-Pyrénées	31	1	26	189	Forgues	189	6	195
73	Midi-Pyrénées	31	2	28	190	Fos	252	16	268
73	Midi-Pyrénées	31	2	01	191	Fougaron	96	0	96
73	Midi-Pyrénées	31	3	21	192	Fourquevaux	752	23	775
73	Midi-Pyrénées	31	1	13	193	Le Fousseret	1714	37	1751
73	Midi-Pyrénées	31	3	08	194	Francarville	175	5	180
73	Midi-Pyrénées	31	2	32	195	Francazal	20	0	20
73	Midi-Pyrénées	31	1	11	196	Francon	210	5	215
73	Midi-Pyrénées	31	2	22	197	Franquevielle	361	3	364
73	Midi-Pyrénées	31	2	31	198	Le Fréchet	114	1	115
73	Midi-Pyrénées	31	2	28	199	Fronsac	202	9	211
73	Midi-Pyrénées	31	2	05	200	Frontignan-de-Comminges	68	3	71
73	Midi-Pyrénées	31	2	16	201	Frontignan-Savès	60	2	62
73	Midi-Pyrénées	31	3	14	202	Fronton	5594	89	5683
73	Midi-Pyrénées	31	1	23	203	Frouzins	7902	131	8033
73	Midi-Pyrénées	31	1	13	204	Fustignac	76	2	78
73	Midi-Pyrénées	31	3	49	205	Gagnac-sur-Garonne	2952	37	2989
73	Midi-Pyrénées	31	1	12	206	Gaillac-Toulza	1216	21	1237
73	Midi-Pyrénées	31	2	05	207	Galié	87	3	90
73	Midi-Pyrénées	31	2	01	208	Ganties	301	3	304
73	Midi-Pyrénées	31	3	07	209	Garac	170	3	173
73	Midi-Pyrénées	31	3	38	210	Gardouch	1312	15	1327
73	Midi-Pyrénées	31	3	14	211	Gargas	635	9	644
73	Midi-Pyrénées	31	3	19	212	Garidech	1591	15	1606
73	Midi-Pyrénées	31	2	04	213	Garin	133	3	136
73	Midi-Pyrénées	31	3	37	215	Gauré	492	7	499
73	Midi-Pyrénées	31	3	19	216	Gémil	273	5	278
73	Midi-Pyrénées	31	2	05	217	Génos	96	1	97
73	Midi-Pyrénées	31	2	06	218	Gensac-de-Boulogne	102	5	107
73	Midi-Pyrénées	31	1	27	219	Gensac-sur-Garonne	346	9	355
73	Midi-Pyrénées	31	3	24	220	Gibel	308	0	308
73	Midi-Pyrénées	31	2	04	221	Gouaux-de-Larboust	53	2	55
73	Midi-Pyrénées	31	2	04	222	Gouaux-de-Luchon	46	1	47
73	Midi-Pyrénées	31	2	16	223	Goudex	40	0	40
73	Midi-Pyrénées	31	2	05	224	Gourdan-Polignan	1359	160	1519
73	Midi-Pyrénées	31	1	27	225	Goutevernisse	159	2	161
73	Midi-Pyrénées	31	1	20	226	Gouzens	95	7	102
73	Midi-Pyrénées	31	3	10	227	Goyrans	911	34	945
73	Midi-Pyrénées	31	3	37	228	Gragnague	1772	29	1801
73	Midi-Pyrénées	31	1	13	229	Gratens	699	16	715
73	Midi-Pyrénées	31	3	14	230	Gratentour	3545	57	3602
73	Midi-Pyrénées	31	1	12	231	Grazac	508	10	518
73	Midi-Pyrénées	31	3	15	232	Grenade	8074	96	8170
73	Midi-Pyrénées	31	1	03	233	Grépiac	990	19	1009
73	Midi-Pyrénées	31	3	07	234	Le Grès	340	6	346
73	Midi-Pyrénées	31	2	28	235	Guran	50	1	51
73	Midi-Pyrénées	31	2	01	236	Herran	68	0	68
73	Midi-Pyrénées	31	2	32	237	His	232	24	256
73	Midi-Pyrénées	31	2	05	238	Huos	465	15	480
73	Midi-Pyrénées	31	2	16	239	L; Isle-en-Dodon	1984	20	2004
73	Midi-Pyrénées	31	3	21	240	Issus	444	4	448
73	Midi-Pyrénées	31	2	01	241	Izaut-de-l;Hôtel	293	9	302
73	Midi-Pyrénées	31	2	04	242	Jurvielle	23	0	23
73	Midi-Pyrénées	31	3	25	243	Juzes	80	2	82
73	Midi-Pyrénées	31	2	01	245	Juzet-d;Izaut	204	4	208
73	Midi-Pyrénées	31	2	04	244	Juzet-de-Luchon	389	10	399
73	Midi-Pyrénées	31	2	29	246	Labarthe-Inard	875	20	895
73	Midi-Pyrénées	31	2	29	247	Labarthe-Rivière	1363	29	1392
73	Midi-Pyrénées	31	1	52	248	Labarthe-sur-Lèze	4871	102	4973
73	Midi-Pyrénées	31	3	21	249	Labastide-Beauvoir	1080	14	1094
73	Midi-Pyrénées	31	1	26	250	Labastide-Clermont	695	15	710
73	Midi-Pyrénées	31	2	16	251	Labastide-Paumès	142	3	145
73	Midi-Pyrénées	31	3	14	252	Labastide-Saint-Sernin	1799	29	1828
73	Midi-Pyrénées	31	1	23	253	Labastidette	2146	34	2180
73	Midi-Pyrénées	31	3	10	254	Labège	3861	105	3966
73	Midi-Pyrénées	31	2	05	255	Labroquère	315	31	346
73	Midi-Pyrénées	31	1	03	256	Labruyère-Dorsa	248	5	253
73	Midi-Pyrénées	31	1	27	258	Lacaugne	198	3	201
73	Midi-Pyrénées	31	3	10	259	Lacroix-Falgarde	2028	35	2063
73	Midi-Pyrénées	31	2	31	260	Laffite-Toupière	85	0	85
73	Midi-Pyrénées	31	1	13	261	Lafitte-Vigordane	1059	14	1073
73	Midi-Pyrénées	31	3	38	262	Lagarde	328	4	332
73	Midi-Pyrénées	31	1	52	263	Lagardelle-sur-Lèze	2441	37	2478
73	Midi-Pyrénées	31	1	03	264	Lagrâce-Dieu	478	6	484
73	Midi-Pyrénées	31	3	07	265	Lagraulet-Saint-Nicolas	244	4	248
73	Midi-Pyrénées	31	1	26	266	Lahage	228	7	235
73	Midi-Pyrénées	31	1	20	267	Lahitère	52	1	53
73	Midi-Pyrénées	31	2	29	268	Lalouret-Laffiteau	140	6	146
73	Midi-Pyrénées	31	1	30	269	Lamasquère	1322	27	1349
73	Midi-Pyrénées	31	2	29	270	Landorthe	946	37	983
73	Midi-Pyrénées	31	3	17	271	Lanta	1715	31	1746
73	Midi-Pyrénées	31	1	20	272	Lapeyrère	72	2	74
73	Midi-Pyrénées	31	3	19	273	Lapeyrouse-Fossat	2686	67	2753
73	Midi-Pyrénées	31	2	29	274	Larcan	181	9	190
73	Midi-Pyrénées	31	3	07	275	Laréole	140	1	141
73	Midi-Pyrénées	31	3	15	592	Larra	1432	30	1462
73	Midi-Pyrénées	31	2	06	276	Larroque	309	6	315
73	Midi-Pyrénées	31	3	18	277	Lasserre	932	10	942
73	Midi-Pyrénées	31	2	02	278	Latoue	323	3	326
73	Midi-Pyrénées	31	1	20	279	Latour	80	2	82
73	Midi-Pyrénées	31	1	27	280	Latrape	344	4	348
73	Midi-Pyrénées	31	3	15	281	Launac	1267	17	1284
73	Midi-Pyrénées	31	3	49	282	Launaguet	7149	113	7262
73	Midi-Pyrénées	31	1	26	283	Lautignac	286	6	292
73	Midi-Pyrénées	31	3	17	284	Lauzerville	1291	41	1332
73	Midi-Pyrénées	31	3	37	285	Lavalette	622	17	639
73	Midi-Pyrénées	31	1	27	286	Lavelanet-de-Comminges	558	15	573
73	Midi-Pyrénées	31	1	23	287	Lavernose-Lacasse	2699	43	2742
73	Midi-Pyrénées	31	3	39	288	Layrac-sur-Tarn	329	5	334
73	Midi-Pyrénées	31	2	22	289	Lécussan	289	9	298
73	Midi-Pyrénées	31	2	28	290	Lège	41	2	43
73	Midi-Pyrénées	31	3	18	291	Léguevin	8475	207	8682
73	Midi-Pyrénées	31	1	11	292	Lescuns	57	1	58
73	Midi-Pyrénées	31	3	14	293	Lespinasse	2526	20	2546
73	Midi-Pyrénées	31	2	29	294	Lespiteau	75	2	77
73	Midi-Pyrénées	31	2	06	295	Lespugue	74	0	74
73	Midi-Pyrénées	31	2	31	296	Lestelle-de-Saint-Martory	445	7	452
73	Midi-Pyrénées	31	3	18	297	Lévignac	2018	47	2065
73	Midi-Pyrénées	31	2	28	298	Lez	62	1	63
73	Midi-Pyrénées	31	1	23	299	Lherm	3417	63	3480
73	Midi-Pyrénées	31	2	29	300	Lieoux	118	1	119
73	Midi-Pyrénées	31	2	16	301	Lilhac	132	1	133
73	Midi-Pyrénées	31	2	29	302	Lodes	279	7	286
73	Midi-Pyrénées	31	1	09	303	Longages	2650	49	2699
73	Midi-Pyrénées	31	3	08	304	Loubens-Lauragais	417	19	436
73	Midi-Pyrénées	31	2	22	305	Loudet	206	8	214
73	Midi-Pyrénées	31	2	05	306	Lourde	98	2	100
73	Midi-Pyrénées	31	2	06	307	Lunax	60	0	60
73	Midi-Pyrénées	31	2	05	308	Luscan	69	3	72
73	Midi-Pyrénées	31	1	13	309	Lussan-Adeilhac	229	3	232
73	Midi-Pyrénées	31	3	38	310	Lux	358	3	361
73	Midi-Pyrénées	31	3	39	311	La Magdelaine-sur-Tarn	1006	17	1023
73	Midi-Pyrénées	31	1	27	312	Mailholas	40	1	41
73	Midi-Pyrénées	31	2	05	313	Malvezie	124	3	127
73	Midi-Pyrénées	31	2	31	314	Mancioux	423	11	434
73	Midi-Pyrénées	31	2	32	315	Mane	988	39	1027
73	Midi-Pyrénées	31	2	28	316	Marignac	530	15	545
73	Midi-Pyrénées	31	1	13	317	Marignac-Lasclares	410	6	416
73	Midi-Pyrénées	31	1	11	318	Marignac-Laspeyres	196	5	201
73	Midi-Pyrénées	31	1	12	319	Marliac	122	1	123
73	Midi-Pyrénées	31	1	09	320	Marquefave	1031	84	1115
73	Midi-Pyrénées	31	2	32	321	Marsoulas	131	5	136
73	Midi-Pyrénées	31	2	16	322	Martisserre	60	3	63
73	Midi-Pyrénées	31	2	05	323	Martres-de-Rivière	386	8	394
73	Midi-Pyrénées	31	1	11	324	Martres-Tolosane	2231	48	2279
73	Midi-Pyrénées	31	3	08	325	Mascarville	183	6	189
73	Midi-Pyrénées	31	1	20	326	Massabrac	78	0	78
73	Midi-Pyrénées	31	1	11	327	Mauran	178	4	182
73	Midi-Pyrénées	31	3	38	328	Mauremont	318	2	320
73	Midi-Pyrénées	31	3	25	329	Maurens	203	5	208
73	Midi-Pyrénées	31	1	03	330	Mauressac	437	11	448
73	Midi-Pyrénées	31	3	08	331	Maureville	301	8	309
73	Midi-Pyrénées	31	3	24	332	Mauvaisin	223	8	231
73	Midi-Pyrénées	31	2	16	333	Mauvezin	83	0	83
73	Midi-Pyrénées	31	1	09	334	Mauzac	1111	23	1134
73	Midi-Pyrénées	31	2	04	335	Mayrègne	27	3	30
73	Midi-Pyrénées	31	2	32	336	Mazères-sur-Salat	593	23	616
73	Midi-Pyrénées	31	2	28	337	Melles	113	2	115
73	Midi-Pyrénées	31	3	15	338	Menville	574	11	585
73	Midi-Pyrénées	31	3	18	339	Mérenvielle	472	12	484
73	Midi-Pyrénées	31	3	10	340	Mervilla	266	2	268
73	Midi-Pyrénées	31	3	15	341	Merville	4783	67	4850
73	Midi-Pyrénées	31	2	01	342	Milhas	175	2	177
73	Midi-Pyrénées	31	2	16	343	Mirambeau	53	3	56
73	Midi-Pyrénées	31	2	29	344	Miramont-de-Comminges	793	12	805
73	Midi-Pyrénées	31	1	03	345	Miremont	2086	23	2109
73	Midi-Pyrénées	31	3	39	346	Mirepoix-sur-Tarn	701	13	714
73	Midi-Pyrénées	31	2	16	347	Molas	162	4	166
73	Midi-Pyrénées	31	2	01	348	Moncaup	32	0	32
73	Midi-Pyrénées	31	1	11	349	Mondavezan	787	12	799
73	Midi-Pyrénées	31	2	06	350	Mondilhan	91	0	91
73	Midi-Pyrénées	31	3	51	351	Mondonville	4236	46	4282
73	Midi-Pyrénées	31	3	43	352	Mondouzil	239	4	243
73	Midi-Pyrénées	31	1	26	353	Monès	69	1	70
73	Midi-Pyrénées	31	3	24	354	Monestrol	60	1	61
73	Midi-Pyrénées	31	3	43	355	Mons	1455	36	1491
73	Midi-Pyrénées	31	2	05	369	Mont-de-Galié	37	2	39
73	Midi-Pyrénées	31	3	15	356	Montaigut-sur-Save	1569	25	1594
73	Midi-Pyrénées	31	2	32	357	Montastruc-de-Salies	272	7	279
73	Midi-Pyrénées	31	3	19	358	Montastruc-la-Conseillère	3149	85	3234
73	Midi-Pyrénées	31	1	26	359	Montastruc-Savès	64	2	66
73	Midi-Pyrénées	31	2	04	360	Montauban-de-Luchon	465	19	484
73	Midi-Pyrénées	31	1	09	361	Montaut	510	1	511
73	Midi-Pyrénées	31	1	11	362	Montberaud	210	4	214
73	Midi-Pyrénées	31	2	16	363	Montbernard	215	6	221
73	Midi-Pyrénées	31	3	50	364	Montberon	2768	53	2821
73	Midi-Pyrénées	31	1	20	365	Montbrun-Bocage	469	10	479
73	Midi-Pyrénées	31	3	21	366	Montbrun-Lauragais	548	13	561
73	Midi-Pyrénées	31	1	11	367	Montclar-de-Comminges	75	1	76
73	Midi-Pyrénées	31	3	38	368	Montclar-Lauragais	197	3	200
73	Midi-Pyrénées	31	1	13	370	Montégut-Bourjac	119	3	122
73	Midi-Pyrénées	31	3	25	371	Montégut-Lauragais	469	7	476
73	Midi-Pyrénées	31	2	32	372	Montespan	438	10	448
73	Midi-Pyrénées	31	2	16	373	Montesquieu-Guittaut	155	3	158
73	Midi-Pyrénées	31	3	38	374	Montesquieu-Lauragais	917	18	935
73	Midi-Pyrénées	31	1	20	375	Montesquieu-Volvestre	2997	80	3077
73	Midi-Pyrénées	31	2	32	376	Montgaillard-de-Salies	97	2	99
73	Midi-Pyrénées	31	3	38	377	Montgaillard-Lauragais	633	14	647
73	Midi-Pyrénées	31	2	06	378	Montgaillard-sur-Save	78	2	80
73	Midi-Pyrénées	31	1	09	379	Montgazin	165	6	171
73	Midi-Pyrénées	31	3	24	380	Montgeard	441	12	453
73	Midi-Pyrénées	31	3	21	381	Montgiscard	2068	56	2124
73	Midi-Pyrénées	31	1	26	382	Montgras	92	0	92
73	Midi-Pyrénées	31	3	19	383	Montjoire	1201	17	1218
73	Midi-Pyrénées	31	3	21	384	Montlaur	1213	24	1237
73	Midi-Pyrénées	31	2	06	385	Montmaurin	226	10	236
73	Midi-Pyrénées	31	2	02	386	Montoulieu-Saint-Bernard	187	9	196
73	Midi-Pyrénées	31	1	13	387	Montoussin	122	0	122
73	Midi-Pyrénées	31	3	19	388	Montpitol	399	8	407
73	Midi-Pyrénées	31	3	43	389	Montrabé	3585	76	3661
73	Midi-Pyrénées	31	2	22	390	Montréjeau	2781	57	2838
73	Midi-Pyrénées	31	2	32	391	Montsaunès	415	38	453
73	Midi-Pyrénées	31	3	08	392	Mourvilles-Basses	72	3	75
73	Midi-Pyrénées	31	3	25	393	Mourvilles-Hautes	173	10	183
73	Midi-Pyrénées	31	2	04	394	Moustajon	169	9	178
73	Midi-Pyrénées	31	1	23	395	Muret	23864	789	24653
73	Midi-Pyrénées	31	3	24	396	Nailloux	3076	36	3112
73	Midi-Pyrénées	31	2	06	397	Nénigan	60	0	60
73	Midi-Pyrénées	31	2	06	398	Nizan-Gesse	92	0	92
73	Midi-Pyrénées	31	1	09	399	Noé	2627	32	2659
73	Midi-Pyrénées	31	3	25	400	Nogaret	70	2	72
73	Midi-Pyrénées	31	3	21	401	Noueilles	335	7	342
73	Midi-Pyrénées	31	3	21	402	Odars	738	13	751
73	Midi-Pyrénées	31	3	15	403	Ondes	740	124	864
73	Midi-Pyrénées	31	2	04	404	Oô	111	0	111
73	Midi-Pyrénées	31	2	05	405	Ore	119	3	122
73	Midi-Pyrénées	31	1	11	406	Palaminy	801	22	823
73	Midi-Pyrénées	31	3	19	407	Paulhac	1128	27	1155
73	Midi-Pyrénées	31	2	05	408	Payssous	92	0	92
73	Midi-Pyrénées	31	3	10	409	Péchabou	2011	74	2085
73	Midi-Pyrénées	31	3	50	410	Pechbonnieu	3940	56	3996
73	Midi-Pyrénées	31	3	10	411	Pechbusque	837	28	865
73	Midi-Pyrénées	31	2	06	412	Péguilhan	251	2	253
73	Midi-Pyrénées	31	3	07	413	Pelleport	515	12	527
73	Midi-Pyrénées	31	2	02	414	Peyrissas	94	2	96
73	Midi-Pyrénées	31	2	02	415	Peyrouzet	93	4	97
73	Midi-Pyrénées	31	1	09	416	Peyssies	465	12	477
73	Midi-Pyrénées	31	3	18	417	Pibrac	8091	333	8424
73	Midi-Pyrénées	31	3	43	418	Pin-Balma	887	23	910
73	Midi-Pyrénées	31	1	26	419	Le Pin-Murelet	184	3	187
73	Midi-Pyrénées	31	1	52	421	Pins-Justaret	4454	75	4529
73	Midi-Pyrénées	31	1	52	420	Pinsaguel	2611	51	2662
73	Midi-Pyrénées	31	1	11	422	Plagne	89	1	90
73	Midi-Pyrénées	31	1	26	423	Plagnole	266	6	272
73	Midi-Pyrénées	31	3	18	424	Plaisance-du-Touch	16091	351	16442
73	Midi-Pyrénées	31	1	11	425	Le Plan	494	6	500
73	Midi-Pyrénées	31	2	05	426	Pointis-de-Rivière	847	22	869
73	Midi-Pyrénées	31	2	29	427	Pointis-Inard	829	15	844
73	Midi-Pyrénées	31	1	13	428	Polastron	58	1	59
73	Midi-Pyrénées	31	3	21	429	Pompertuzat	2023	45	2068
73	Midi-Pyrénées	31	2	22	430	Ponlat-Taillebourg	557	13	570
73	Midi-Pyrénées	31	2	01	431	Portet-d;Aspet	71	1	72
73	Midi-Pyrénées	31	2	04	432	Portet-de-Luchon	28	0	28
73	Midi-Pyrénées	31	1	52	433	Portet-sur-Garonne	9435	127	9562
73	Midi-Pyrénées	31	2	04	434	Poubeau	73	1	74
73	Midi-Pyrénées	31	1	26	435	Poucharramet	837	22	859
73	Midi-Pyrénées	31	1	13	436	Pouy-de-Touges	363	8	371
73	Midi-Pyrénées	31	3	21	437	Pouze	97	3	100
73	Midi-Pyrénées	31	3	18	438	Pradère-les-Bourguets	224	7	231
73	Midi-Pyrénées	31	3	17	439	Préserville	648	6	654
73	Midi-Pyrénées	31	2	31	440	Proupiary	69	2	71
73	Midi-Pyrénées	31	3	08	441	Prunet	144	1	145
73	Midi-Pyrénées	31	1	03	442	Puydaniel	408	5	413
73	Midi-Pyrénées	31	2	16	443	Puymaurin	300	4	304
73	Midi-Pyrénées	31	3	07	444	Puysségur	129	0	129
73	Midi-Pyrénées	31	3	43	445	Quint-Fonsegrives	4850	109	4959
73	Midi-Pyrénées	31	3	44	446	Ramonville-Saint-Agne	11994	333	12327
73	Midi-Pyrénées	31	2	01	447	Razecueillé	34	0	34
73	Midi-Pyrénées	31	3	10	448	Rebigue	524	5	529
73	Midi-Pyrénées	31	2	29	449	Régades	132	0	132
73	Midi-Pyrénées	31	3	38	450	Renneville	506	6	512
73	Midi-Pyrénées	31	3	25	451	Revel	9361	434	9795
73	Midi-Pyrénées	31	2	29	452	Rieucazé	46	2	48
73	Midi-Pyrénées	31	3	38	453	Rieumajou	137	3	140
73	Midi-Pyrénées	31	1	26	454	Rieumes	3384	84	3468
73	Midi-Pyrénées	31	1	27	455	Rieux-Volvestre	2486	58	2544
73	Midi-Pyrénées	31	2	16	456	Riolas	52	3	55
73	Midi-Pyrénées	31	2	32	457	Roquefort-sur-Garonne	783	14	797
73	Midi-Pyrénées	31	1	52	458	Roques	3850	75	3925
73	Midi-Pyrénées	31	3	19	459	Roquesérière	702	18	720
73	Midi-Pyrénées	31	1	52	460	Roquettes	3612	49	3661
73	Midi-Pyrénées	31	2	32	461	Rouède	289	5	294
73	Midi-Pyrénées	31	3	50	462	Rouffiac-Tolosan	1732	28	1760
73	Midi-Pyrénées	31	3	25	463	Roumens	249	8	257
73	Midi-Pyrénées	31	1	26	464	Sabonnères	294	3	297
73	Midi-Pyrénées	31	2	04	465	Saccourvielle	13	1	14
73	Midi-Pyrénées	31	1	30	466	Saiguède	742	12	754
73	Midi-Pyrénées	31	3	49	467	Saint-Alban	5634	60	5694
73	Midi-Pyrénées	31	2	02	468	Saint-André	213	4	217
73	Midi-Pyrénées	31	1	13	469	Saint-Araille	138	1	139
73	Midi-Pyrénées	31	2	04	470	Saint-Aventin	87	6	93
73	Midi-Pyrénées	31	2	28	471	Saint-Béat	393	11	404
73	Midi-Pyrénées	31	2	05	472	Saint-Bertrand-de-Comminges	256	4	260
73	Midi-Pyrénées	31	3	15	473	Saint-Cézert	369	4	373
73	Midi-Pyrénées	31	1	20	474	Saint-Christaud	260	2	262
73	Midi-Pyrénées	31	1	23	475	Saint-Clar-de-Rivière	1174	32	1206
73	Midi-Pyrénées	31	1	13	476	Saint-Élix-le-Château	728	18	746
73	Midi-Pyrénées	31	2	02	477	Saint-Élix-Séglan	41	0	41
73	Midi-Pyrénées	31	3	25	478	Saint-Félix-Lauragais	1336	37	1373
73	Midi-Pyrénées	31	2	06	479	Saint-Ferréol-de-Comminges	53	1	54
73	Midi-Pyrénées	31	2	16	482	Saint-Frajou	197	4	201
73	Midi-Pyrénées	31	2	29	483	Saint-Gaudens	11248	505	11753
73	Midi-Pyrénées	31	3	50	484	Saint-Geniès-Bellevue	2164	56	2220
73	Midi-Pyrénées	31	3	38	485	Saint-Germier	103	1	104
73	Midi-Pyrénées	31	1	23	486	Saint-Hilaire	1078	16	1094
73	Midi-Pyrénées	31	2	29	487	Saint-Ignan	267	8	275
73	Midi-Pyrénées	31	3	50	488	Saint-Jean	10259	143	10402
73	Midi-Pyrénées	31	3	19	489	Saint-Jean-Lherm	377	4	381
73	Midi-Pyrénées	31	3	14	490	Saint-Jory	5082	55	5137
73	Midi-Pyrénées	31	3	25	491	Saint-Julia	369	10	379
73	Midi-Pyrénées	31	1	27	492	Saint-Julien-sur-Garonne	516	5	521
73	Midi-Pyrénées	31	2	06	493	Saint-Lary-Boujean	131	2	133
73	Midi-Pyrénées	31	2	16	494	Saint-Laurent	168	3	171
73	Midi-Pyrénées	31	3	24	495	Saint-Léon	1133	8	1141
73	Midi-Pyrénées	31	3	50	497	Saint-Loup-Cammas	1801	17	1818
73	Midi-Pyrénées	31	2	06	498	Saint-Loup-en-Comminges	38	1	39
73	Midi-Pyrénées	31	1	30	499	Saint-Lys	8537	160	8697
73	Midi-Pyrénées	31	2	04	500	Saint-Mamet	574	19	593
73	Midi-Pyrénées	31	3	37	501	Saint-Marcel-Paulel	449	18	467
73	Midi-Pyrénées	31	2	29	502	Saint-Marcet	411	8	419
73	Midi-Pyrénées	31	2	31	503	Saint-Martory	876	7	883
73	Midi-Pyrénées	31	2	31	504	Saint-Médard	210	6	216
73	Midi-Pyrénées	31	1	11	505	Saint-Michel	330	11	341
73	Midi-Pyrénées	31	3	10	506	Saint-Orens-de-Gameville	10918	326	11244
73	Midi-Pyrénées	31	2	04	508	Saint-Paul-d;Oueil	50	5	55
73	Midi-Pyrénées	31	3	15	507	Saint-Paul-sur-Save	1314	31	1345
73	Midi-Pyrénées	31	2	05	509	Saint-Pé-d;Ardet	126	2	128
73	Midi-Pyrénées	31	2	06	510	Saint-Pé-Delbosc	138	0	138
73	Midi-Pyrénées	31	3	37	511	Saint-Pierre	252	7	259
73	Midi-Pyrénées	31	3	17	512	Saint-Pierre-de-Lages	770	12	782
73	Midi-Pyrénées	31	2	22	513	Saint-Plancard	374	7	381
73	Midi-Pyrénées	31	3	38	514	Saint-Rome	57	2	59
73	Midi-Pyrénées	31	3	14	515	Saint-Rustice	436	5	441
73	Midi-Pyrénées	31	3	14	516	Saint-Sauveur	1746	56	1802
73	Midi-Pyrénées	31	1	09	517	Saint-Sulpice-sur-Lèze	1845	52	1897
73	Midi-Pyrénées	31	1	30	518	Saint-Thomas	565	6	571
73	Midi-Pyrénées	31	3	38	519	Saint-Vincent	178	0	178
73	Midi-Pyrénées	31	3	17	480	Sainte-Foy-d;Aigrefeuille	1979	48	2027
73	Midi-Pyrénées	31	1	30	481	Sainte-Foy-de-Peyrolières	2001	33	2034
73	Midi-Pyrénées	31	3	18	496	Sainte-Livrade	283	11	294
73	Midi-Pyrénées	31	1	26	520	Sajas	104	2	106
73	Midi-Pyrénées	31	2	32	521	Saleich	370	15	385
73	Midi-Pyrénées	31	2	16	522	Salerm	55	0	55
73	Midi-Pyrénées	31	2	32	523	Salies-du-Salat	1998	93	2091
73	Midi-Pyrénées	31	2	04	524	Salles-et-Pratviel	140	4	144
73	Midi-Pyrénées	31	1	27	525	Salles-sur-Garonne	516	11	527
73	Midi-Pyrénées	31	3	08	527	La Salvetat-Lauragais	137	6	143
73	Midi-Pyrénées	31	3	18	526	La Salvetat-Saint-Gilles	6911	127	7038
73	Midi-Pyrénées	31	2	06	528	Saman	159	3	162
73	Midi-Pyrénées	31	2	02	529	Samouillan	126	0	126
73	Midi-Pyrénées	31	1	11	530	Sana	221	5	226
73	Midi-Pyrénées	31	2	06	531	Sarrecave	78	2	80
73	Midi-Pyrénées	31	2	06	532	Sarremezan	98	0	98
73	Midi-Pyrénées	31	1	52	533	Saubens	1913	34	1947
73	Midi-Pyrénées	31	3	08	534	Saussens	238	4	242
73	Midi-Pyrénées	31	2	05	535	Sauveterre-de-Comminges	720	18	738
73	Midi-Pyrénées	31	2	29	536	Saux-et-Pomarède	270	16	286
73	Midi-Pyrénées	31	2	29	537	Savarthès	154	2	156
73	Midi-Pyrénées	31	1	26	538	Savères	205	7	212
73	Midi-Pyrénées	31	2	22	539	Sédeilhac	55	5	60
73	Midi-Pyrénées	31	3	08	540	Ségreville	213	2	215
73	Midi-Pyrénées	31	3	15	541	Seilh	3065	111	3176
73	Midi-Pyrénées	31	2	05	542	Seilhan	201	1	202
73	Midi-Pyrénées	31	1	13	543	Sénarens	119	1	120
73	Midi-Pyrénées	31	2	01	544	Sengouagnet	222	7	229
73	Midi-Pyrénées	31	2	31	545	Sepx	208	3	211
73	Midi-Pyrénées	31	3	24	546	Seyre	102	2	104
73	Midi-Pyrénées	31	1	23	547	Seysses	7839	100	7939
73	Midi-Pyrénées	31	2	28	548	Signac	49	0	49
73	Midi-Pyrénées	31	2	04	549	Sode	25	0	25
73	Midi-Pyrénées	31	2	01	550	Soueich	542	11	553
73	Midi-Pyrénées	31	3	17	551	Tarabel	355	8	363
73	Midi-Pyrénées	31	2	02	552	Terrebasse	139	2	141
73	Midi-Pyrénées	31	3	15	553	Thil	1140	15	1155
73	Midi-Pyrénées	31	2	32	554	Touille	258	5	263
73	Midi-Pyrénées	31	3	99	555	Toulouse	441802	7526	449328
73	Midi-Pyrénées	31	3	53	557	Tournefeuille	25340	514	25854
73	Midi-Pyrénées	31	2	22	556	Les Tourreilles	376	7	383
73	Midi-Pyrénées	31	3	08	558	Toutens	211	2	213
73	Midi-Pyrénées	31	2	04	559	Trébons-de-Luchon	8	0	8
73	Midi-Pyrénées	31	3	38	560	Trébons-sur-la-Grasse	417	11	428
73	Midi-Pyrénées	31	3	50	561	L; Union	11868	225	12093
73	Midi-Pyrénées	31	2	32	562	Urau	148	1	149
73	Midi-Pyrénées	31	3	14	563	Vacquiers	1312	22	1334
73	Midi-Pyrénées	31	2	05	564	Valcabrère	152	3	155
73	Midi-Pyrénées	31	2	29	565	Valentine	916	10	926
73	Midi-Pyrénées	31	3	38	566	Vallègue	530	4	534
73	Midi-Pyrénées	31	3	17	567	Vallesvilles	376	8	384
73	Midi-Pyrénées	31	3	21	568	Varennes	256	8	264
73	Midi-Pyrénées	31	3	25	569	Vaudreuille	351	4	355
73	Midi-Pyrénées	31	3	25	570	Vaux	278	3	281
73	Midi-Pyrénées	31	3	08	571	Vendine	248	8	256
73	Midi-Pyrénées	31	1	03	572	Venerque	2612	64	2676
73	Midi-Pyrénées	31	3	37	573	Verfeil	3146	48	3194
73	Midi-Pyrénées	31	1	03	574	Vernet	2080	78	2158
73	Midi-Pyrénées	31	3	10	575	Vieille-Toulouse	1120	41	1161
73	Midi-Pyrénées	31	3	38	576	Vieillevigne	305	5	310
73	Midi-Pyrénées	31	3	07	577	Vignaux	121	3	124
73	Midi-Pyrénées	31	3	10	578	Vigoulet-Auzil	944	30	974
73	Midi-Pyrénées	31	3	14	579	Villariès	816	17	833
73	Midi-Pyrénées	31	1	52	580	Villate	801	11	812
73	Midi-Pyrénées	31	3	14	581	Villaudric	1398	28	1426
73	Midi-Pyrénées	31	3	38	582	Villefranche-de-Lauragais	4106	56	4162
73	Midi-Pyrénées	31	3	39	583	Villematier	1022	24	1046
73	Midi-Pyrénées	31	3	39	584	Villemur-sur-Tarn	5654	104	5758
73	Midi-Pyrénées	31	2	29	585	Villeneuve-de-Rivière	1607	23	1630
73	Midi-Pyrénées	31	2	22	586	Villeneuve-Lécussan	545	9	554
73	Midi-Pyrénées	31	3	14	587	Villeneuve-lès-Bouloc	1025	15	1040
73	Midi-Pyrénées	31	3	53	588	Villeneuve-Tolosane	8637	150	8787
73	Midi-Pyrénées	31	3	38	589	Villenouvelle	1324	14	1338
73	Midi-Pyrénées	32	3	01	001	Aignan	775	90	865
73	Midi-Pyrénées	32	1	09	002	Ansan	96	4	100
73	Midi-Pyrénées	32	1	11	003	Antras	56	3	59
73	Midi-Pyrénées	32	3	24	004	Arblade-le-Bas	148	4	152
73	Midi-Pyrénées	32	2	22	005	Arblade-le-Haut	285	9	294
73	Midi-Pyrénées	32	1	05	007	Ardizas	198	4	202
73	Midi-Pyrénées	32	3	14	008	Armentieux	87	2	89
73	Midi-Pyrénées	32	3	20	009	Armous-et-Cau	95	4	99
73	Midi-Pyrénées	32	3	15	010	Arrouède	90	2	92
73	Midi-Pyrénées	32	1	09	012	Aubiet	1114	24	1138
73	Midi-Pyrénées	32	1	99	013	Auch	21576	1355	22931
73	Midi-Pyrénées	32	1	02	014	Augnax	88	4	92
73	Midi-Pyrénées	32	3	15	015	Aujan-Mournède	94	1	95
73	Midi-Pyrénées	32	1	10	016	Auradé	628	11	639
73	Midi-Pyrénées	32	3	24	017	Aurensan	129	4	133
73	Midi-Pyrénées	32	1	27	018	Aurimont	214	1	215
73	Midi-Pyrénées	32	3	15	468	Aussos	62	2	64
73	Midi-Pyrénées	32	1	03	019	Auterive	537	14	551
73	Midi-Pyrénées	32	3	17	020	Aux-Aussat	260	8	268
73	Midi-Pyrénées	32	2	16	021	Avensac	61	2	63
73	Midi-Pyrénées	32	3	01	022	Avéron-Bergelle	154	6	160
73	Midi-Pyrénées	32	2	25	023	Avezan	75	5	80
73	Midi-Pyrénées	32	2	28	024	Ayguetinte	185	3	188
73	Midi-Pyrénées	32	2	04	025	Ayzieu	155	2	157
73	Midi-Pyrénées	32	2	16	026	Bajonnette	105	3	108
73	Midi-Pyrénées	32	3	24	027	Barcelonne-du-Gers	1304	43	1347
73	Midi-Pyrénées	32	3	17	028	Barcugnan	120	4	124
73	Midi-Pyrénées	32	1	31	029	Barran	723	19	742
73	Midi-Pyrénées	32	3	20	030	Bars	129	8	137
73	Midi-Pyrénées	32	2	07	031	Bascous	153	2	155
73	Midi-Pyrénées	32	3	20	032	Bassoues	353	7	360
73	Midi-Pyrénées	32	1	29	033	Bazian	109	2	111
73	Midi-Pyrénées	32	3	19	034	Bazugues	67	3	70
73	Midi-Pyrénées	32	2	28	035	Beaucaire	286	6	292
73	Midi-Pyrénées	32	3	23	036	Beaumarchés	682	40	722
73	Midi-Pyrénées	32	2	06	037	Beaumont	141	2	143
73	Midi-Pyrénées	32	1	10	038	Beaupuy	198	5	203
73	Midi-Pyrénées	32	3	14	039	Beccas	94	4	98
73	Midi-Pyrénées	32	1	27	040	Bédéchan	134	1	135
73	Midi-Pyrénées	32	3	15	041	Bellegarde	172	1	173
73	Midi-Pyrénées	32	3	19	042	Belloc-Saint-Clamens	138	3	141
73	Midi-Pyrénées	32	1	29	043	Belmont	152	4	156
73	Midi-Pyrénées	32	2	06	044	Béraut	340	12	352
73	Midi-Pyrénées	32	3	19	045	Berdoues	452	13	465
73	Midi-Pyrénées	32	3	24	046	Bernède	216	12	228
73	Midi-Pyrénées	32	2	12	047	Berrac	108	1	109
73	Midi-Pyrénées	32	1	13	048	Betcave-Aguin	96	2	98
73	Midi-Pyrénées	32	2	22	049	Bétous	97	2	99
73	Midi-Pyrénées	32	3	17	050	Betplan	113	1	114
73	Midi-Pyrénées	32	1	26	051	Bézéril	116	0	116
73	Midi-Pyrénées	32	2	28	052	Bezolles	139	7	146
73	Midi-Pyrénées	32	3	15	053	Bézues-Bajon	209	3	212
73	Midi-Pyrénées	32	1	11	054	Biran	399	12	411
73	Midi-Pyrénées	32	2	25	055	Bivès	135	9	144
73	Midi-Pyrénées	32	1	09	056	Blanquefort	54	1	55
73	Midi-Pyrénées	32	2	06	057	Blaziert	136	5	141
73	Midi-Pyrénées	32	3	14	058	Blousson-Sérian	55	1	56
73	Midi-Pyrénées	32	2	28	059	Bonas	135	1	136
73	Midi-Pyrénées	32	1	03	060	Boucagnères	135	10	145
73	Midi-Pyrénées	32	1	27	061	Boulaur	161	0	161
73	Midi-Pyrénées	32	2	22	062	Bourrouillan	147	10	157
73	Midi-Pyrénées	32	3	01	063	Bouzon-Gellenave	192	3	195
73	Midi-Pyrénées	32	2	07	064	Bretagne-d;Armagnac	398	9	407
73	Midi-Pyrénées	32	1	31	065	Le Brouilh-Monbert	236	10	246
73	Midi-Pyrénées	32	2	08	066	Brugnens	251	12	263
73	Midi-Pyrénées	32	3	15	067	Cabas-Loumassès	51	3	54
73	Midi-Pyrénées	32	2	25	068	Cadeilhan	132	1	133
73	Midi-Pyrénées	32	1	13	069	Cadeillan	73	1	74
73	Midi-Pyrénées	32	3	23	070	Cahuzac-sur-Adour	239	1	240
73	Midi-Pyrénées	32	1	29	071	Caillavet	189	5	194
73	Midi-Pyrénées	32	1	29	072	Callian	50	0	50
73	Midi-Pyrénées	32	2	04	073	Campagne-d;Armagnac	199	8	207
73	Midi-Pyrénées	32	3	23	074	Cannet	55	2	57
73	Midi-Pyrénées	32	2	06	075	Cassaigne	218	1	219
73	Midi-Pyrénées	32	1	27	076	Castelnau-Barbarens	497	11	508
73	Midi-Pyrénées	32	3	20	077	Castelnau-d;Anglès	93	2	95
73	Midi-Pyrénées	32	2	08	078	Castelnau-d;Arbieu	211	3	214
73	Midi-Pyrénées	32	2	21	079	Castelnau-d;Auzan	1067	26	1093
73	Midi-Pyrénées	32	2	06	080	Castelnau-sur-l;Auvignon	170	5	175
73	Midi-Pyrénées	32	3	01	081	Castelnavet	141	7	148
73	Midi-Pyrénées	32	2	12	082	Castéra-Lectourois	305	8	313
73	Midi-Pyrénées	32	2	28	083	Castéra-Verduzan	949	32	981
73	Midi-Pyrénées	32	2	25	084	Castéron	63	3	66
73	Midi-Pyrénées	32	2	18	085	Castet-Arrouy	191	6	197
73	Midi-Pyrénées	32	3	17	086	Castex	94	0	94
73	Midi-Pyrénées	32	2	04	087	Castex-d;Armagnac	100	2	102
73	Midi-Pyrénées	32	1	29	088	Castillon-Debats	328	5	333
73	Midi-Pyrénées	32	1	11	089	Castillon-Massas	249	7	256
73	Midi-Pyrénées	32	1	10	090	Castillon-Savès	289	13	302
73	Midi-Pyrénées	32	1	30	091	Castin	290	9	299
73	Midi-Pyrénées	32	1	05	092	Catonvielle	101	5	106
73	Midi-Pyrénées	32	3	24	093	Caumont	129	0	129
73	Midi-Pyrénées	32	2	22	094	Caupenne-d;Armagnac	428	18	446
73	Midi-Pyrénées	32	2	06	095	Caussens	593	20	613
73	Midi-Pyrénées	32	2	04	096	Cazaubon	1707	46	1753
73	Midi-Pyrénées	32	1	29	097	Cazaux-d;Anglès	133	3	136
73	Midi-Pyrénées	32	1	26	098	Cazaux-Savès	274	4	278
73	Midi-Pyrénées	32	3	14	099	Cazaux-Villecomtal	91	1	92
73	Midi-Pyrénées	32	2	21	100	Cazeneuve	144	5	149
73	Midi-Pyrénées	32	2	08	101	Céran	181	5	186
73	Midi-Pyrénées	32	2	08	102	Cézan	172	5	177
73	Midi-Pyrénées	32	3	15	103	Chélan	190	4	194
73	Midi-Pyrénées	32	3	19	104	Clermont-Pouyguillès	165	5	170
73	Midi-Pyrénées	32	1	10	105	Clermont-Savès	249	7	256
73	Midi-Pyrénées	32	1	05	106	Cologne	850	61	911
73	Midi-Pyrénées	32	2	06	107	Condom	7012	299	7311
73	Midi-Pyrénées	32	3	24	108	Corneillan	139	2	141
73	Midi-Pyrénées	32	3	23	109	Couloumé-Mondebat	201	7	208
73	Midi-Pyrénées	32	2	07	110	Courrensan	391	4	395
73	Midi-Pyrénées	32	3	20	111	Courties	45	2	47
73	Midi-Pyrénées	32	1	02	112	Crastes	242	7	249
73	Midi-Pyrénées	32	2	22	113	Cravencères	105	5	110
73	Midi-Pyrénées	32	3	15	114	Cuélas	107	5	112
73	Midi-Pyrénées	32	2	07	115	Dému	324	8	332
73	Midi-Pyrénées	32	3	17	116	Duffort	136	4	140
73	Midi-Pyrénées	32	1	30	117	Duran	813	40	853
73	Midi-Pyrénées	32	1	31	118	Durban	144	5	149
73	Midi-Pyrénées	32	2	07	119	Eauze	4092	68	4160
73	Midi-Pyrénées	32	1	05	120	Encausse	386	7	393
73	Midi-Pyrénées	32	1	10	121	Endoufielle	568	21	589
73	Midi-Pyrénées	32	3	15	122	Esclassan-Labastide	355	14	369
73	Midi-Pyrénées	32	1	09	123	Escorneboeuf	502	17	519
73	Midi-Pyrénées	32	1	13	124	Espaon	195	5	200
73	Midi-Pyrénées	32	2	22	125	Espas	116	3	119
73	Midi-Pyrénées	32	3	17	126	Estampes	169	6	175
73	Midi-Pyrénées	32	2	04	127	Estang	630	12	642
73	Midi-Pyrénées	32	3	20	128	Estipouy	198	10	208
73	Midi-Pyrénées	32	2	25	129	Estramiac	134	3	137
73	Midi-Pyrénées	32	1	27	130	Faget-Abbatial	228	0	228
73	Midi-Pyrénées	32	2	18	131	Flamarens	122	3	125
73	Midi-Pyrénées	32	2	08	132	Fleurance	6339	129	6468
73	Midi-Pyrénées	32	2	21	133	Fourcès	279	8	287
73	Midi-Pyrénées	32	1	10	134	Frégouville	325	7	332
73	Midi-Pyrénées	32	3	01	135	Fustérouau	130	2	132
73	Midi-Pyrénées	32	3	23	136	Galiax	179	2	181
73	Midi-Pyrénées	32	1	13	138	Garravet	142	1	143
73	Midi-Pyrénées	32	2	25	139	Gaudonville	122	0	122
73	Midi-Pyrénées	32	1	13	140	Gaujac	64	0	64
73	Midi-Pyrénées	32	1	13	141	Gaujan	105	3	108
73	Midi-Pyrénées	32	2	08	142	Gavarret-sur-Aulouste	130	5	135
73	Midi-Pyrénées	32	2	06	143	Gazaupouy	285	5	290
73	Midi-Pyrénées	32	3	20	144	Gazax-et-Baccarisse	85	1	86
73	Midi-Pyrénées	32	3	24	145	Gée-Rivière	49	3	52
73	Midi-Pyrénées	32	2	18	146	Gimbrède	336	6	342
73	Midi-Pyrénées	32	1	09	147	Gimont	2815	64	2879
73	Midi-Pyrénées	32	1	10	148	Giscaro	82	2	84
73	Midi-Pyrénées	32	2	21	149	Gondrin	1161	42	1203
73	Midi-Pyrénées	32	2	08	150	Goutz	186	8	194
73	Midi-Pyrénées	32	3	23	151	Goux	84	0	84
73	Midi-Pyrénées	32	3	17	152	Haget	312	5	317
73	Midi-Pyrénées	32	1	03	153	Haulies	136	1	137
73	Midi-Pyrénées	32	2	16	154	Homps	103	2	105
73	Midi-Pyrénées	32	2	22	155	Le Houga	1180	80	1260
73	Midi-Pyrénées	32	3	19	156	Idrac-Respaillès	212	4	216
73	Midi-Pyrénées	32	1	09	157	L; Isle-Arné	139	2	141
73	Midi-Pyrénées	32	2	25	158	L; Isle-Bouzon	243	7	250
73	Midi-Pyrénées	32	3	20	159	L; Isle-de-Noé	549	19	568
73	Midi-Pyrénées	32	1	10	160	L; Isle-Jourdain	7336	173	7509
73	Midi-Pyrénées	32	3	23	161	Izotges	90	3	93
73	Midi-Pyrénées	32	1	11	162	Jegun	1137	67	1204
73	Midi-Pyrénées	32	3	23	163	Jû-Belloc	317	7	324
73	Midi-Pyrénées	32	3	14	164	Juillac	126	4	130
73	Midi-Pyrénées	32	1	09	165	Juilles	225	9	234
73	Midi-Pyrénées	32	2	28	166	Justian	99	1	100
73	Midi-Pyrénées	32	3	19	167	Laas	287	8	295
73	Midi-Pyrénées	32	2	21	168	Labarrère	216	4	220
73	Midi-Pyrénées	32	1	03	169	Labarthe	169	5	174
73	Midi-Pyrénées	32	3	24	170	Labarthète	147	9	156
73	Midi-Pyrénées	32	1	26	171	Labastide-Savès	134	3	137
73	Midi-Pyrénées	32	3	19	172	Labéjan	325	4	329
73	Midi-Pyrénées	32	2	16	173	Labrihe	203	7	210
73	Midi-Pyrénées	32	3	14	174	Ladevèze-Rivière	217	5	222
73	Midi-Pyrénées	32	3	14	175	Ladevèze-Ville	268	5	273
73	Midi-Pyrénées	32	2	12	176	Lagarde	115	2	117
73	Midi-Pyrénées	32	3	19	177	Lagarde-Hachan	155	2	157
73	Midi-Pyrénées	32	2	28	178	Lagardère	68	1	69
73	Midi-Pyrénées	32	2	21	180	Lagraulet-du-Gers	458	5	463
73	Midi-Pyrénées	32	3	17	181	Laguian-Mazous	278	8	286
73	Midi-Pyrénées	32	1	26	182	Lahas	166	4	170
73	Midi-Pyrénées	32	1	02	183	Lahitte	257	2	259
73	Midi-Pyrénées	32	2	08	184	Lalanne	116	1	117
73	Midi-Pyrénées	32	3	15	185	Lalanne-Arqué	136	5	141
73	Midi-Pyrénées	32	1	27	186	Lamaguère	58	4	62
73	Midi-Pyrénées	32	3	19	187	Lamazère	140	5	145
73	Midi-Pyrénées	32	2	08	188	Lamothe-Goas	67	2	69
73	Midi-Pyrénées	32	2	22	191	Lanne-Soubiran	123	3	126
73	Midi-Pyrénées	32	2	04	189	Lannemaignan	103	0	103
73	Midi-Pyrénées	32	2	07	190	Lannepax	563	12	575
73	Midi-Pyrénées	32	3	24	192	Lannux	225	11	236
73	Midi-Pyrénées	32	2	04	193	Larée	240	3	243
73	Midi-Pyrénées	32	2	06	194	Larressingle	211	5	216
73	Midi-Pyrénées	32	2	12	195	Larroque-Engalin	50	0	50
73	Midi-Pyrénées	32	2	28	196	Larroque-Saint-Sernin	165	5	170
73	Midi-Pyrénées	32	2	21	197	Larroque-sur-l;Osse	226	16	242
73	Midi-Pyrénées	32	1	27	198	Lartigue	155	8	163
73	Midi-Pyrénées	32	3	23	199	Lasserade	204	4	208
73	Midi-Pyrénées	32	1	31	200	Lasséran	355	14	369
73	Midi-Pyrénées	32	1	31	201	Lasseube-Propre	337	14	351
73	Midi-Pyrénées	32	2	22	202	Laujuzan	246	7	253
73	Midi-Pyrénées	32	2	21	203	Lauraët	250	3	253
73	Midi-Pyrénées	32	1	11	204	Lavardens	407	9	416
73	Midi-Pyrénées	32	3	14	205	Laveraët	121	7	128
73	Midi-Pyrénées	32	1	13	206	Laymont	201	1	202
73	Midi-Pyrénées	32	1	02	207	Leboulin	309	11	320
73	Midi-Pyrénées	32	2	12	208	Lectoure	3785	437	4222
73	Midi-Pyrénées	32	3	24	209	Lelin-Lapujolle	233	4	237
73	Midi-Pyrénées	32	1	10	210	Lias	512	6	518
73	Midi-Pyrénées	32	2	04	211	Lias-d;Armagnac	197	2	199
73	Midi-Pyrénées	32	2	06	212	Ligardes	227	5	232
73	Midi-Pyrénées	32	1	13	213	Lombez	1911	45	1956
73	Midi-Pyrénées	32	2	22	214	Loubédat	125	4	129
73	Midi-Pyrénées	32	3	19	215	Loubersan	179	7	186
73	Midi-Pyrénées	32	3	15	216	Lourties-Monbrun	137	5	142
73	Midi-Pyrénées	32	3	20	217	Louslitges	81	2	83
73	Midi-Pyrénées	32	3	01	218	Loussous-Débat	49	0	49
73	Midi-Pyrénées	32	3	01	219	Lupiac	308	4	312
73	Midi-Pyrénées	32	2	22	220	Luppé-Violles	146	3	149
73	Midi-Pyrénées	32	1	09	221	Lussan	244	4	248
73	Midi-Pyrénées	32	2	22	222	Magnan	231	6	237
73	Midi-Pyrénées	32	2	25	223	Magnas	74	18	92
73	Midi-Pyrénées	32	2	28	224	Maignaut-Tauzia	220	6	226
73	Midi-Pyrénées	32	3	17	225	Malabat	97	1	98
73	Midi-Pyrénées	32	3	17	226	Manas-Bastanous	89	2	91
73	Midi-Pyrénées	32	2	22	227	Manciet	812	19	831
73	Midi-Pyrénées	32	3	15	228	Manent-Montané	93	3	96
73	Midi-Pyrénées	32	2	16	229	Mansempuy	82	2	84
73	Midi-Pyrénées	32	2	06	230	Mansencôme	66	0	66
73	Midi-Pyrénées	32	1	29	231	Marambat	436	4	440
73	Midi-Pyrénées	32	2	16	232	Maravat	43	1	44
73	Midi-Pyrénées	32	3	14	233	Marciac	1239	84	1323
73	Midi-Pyrénées	32	1	10	234	Marestaing	247	7	254
73	Midi-Pyrénées	32	3	01	235	Margouët-Meymes	195	6	201
73	Midi-Pyrénées	32	2	04	236	Marguestau	71	1	72
73	Midi-Pyrénées	32	1	09	237	Marsan	438	12	450
73	Midi-Pyrénées	32	3	19	238	Marseillan	92	1	93
73	Midi-Pyrénées	32	2	12	239	Marsolan	461	5	466
73	Midi-Pyrénées	32	2	12	241	Mas-d;Auvignon	170	4	174
73	Midi-Pyrénées	32	3	20	240	Mascaras	61	0	61
73	Midi-Pyrénées	32	3	15	242	Masseube	1604	354	1958
73	Midi-Pyrénées	32	2	04	243	Mauléon-d;Armagnac	289	2	291
73	Midi-Pyrénées	32	3	24	244	Maulichères	173	7	180
73	Midi-Pyrénées	32	3	24	245	Maumusson-Laguian	153	3	156
73	Midi-Pyrénées	32	2	04	246	Maupas	192	1	193
73	Midi-Pyrénées	32	1	09	247	Maurens	301	9	310
73	Midi-Pyrénées	32	2	25	248	Mauroux	143	7	150
73	Midi-Pyrénées	32	2	16	249	Mauvezin	1947	45	1992
73	Midi-Pyrénées	32	1	13	250	Meilhan	87	2	89
73	Midi-Pyrénées	32	1	11	251	Mérens	63	1	64
73	Midi-Pyrénées	32	3	17	252	Miélan	1215	29	1244
73	Midi-Pyrénées	32	2	18	253	Miradoux	533	12	545
73	Midi-Pyrénées	32	3	19	254	Miramont-d;Astarac	361	14	375
73	Midi-Pyrénées	32	2	08	255	Miramont-Latour	153	4	157
73	Midi-Pyrénées	32	3	19	256	Mirande	3685	305	3990
73	Midi-Pyrénées	32	1	29	257	Mirannes	70	2	72
73	Midi-Pyrénées	32	1	30	258	Mirepoix	211	7	218
73	Midi-Pyrénées	32	3	15	260	Monbardon	94	1	95
73	Midi-Pyrénées	32	1	26	261	Monblanc	368	3	371
73	Midi-Pyrénées	32	1	05	262	Monbrun	341	7	348
73	Midi-Pyrénées	32	3	19	263	Moncassin	134	2	136
73	Midi-Pyrénées	32	2	04	264	Monclar	199	3	202
73	Midi-Pyrénées	32	3	20	265	Monclar-sur-Losse	115	2	117
73	Midi-Pyrénées	32	1	27	266	Moncorneil-Grazan	147	6	153
73	Midi-Pyrénées	32	1	27	267	Monferran-Plavès	128	4	132
73	Midi-Pyrénées	32	1	10	268	Monferran-Savès	705	44	749
73	Midi-Pyrénées	32	2	16	269	Monfort	480	7	487
73	Midi-Pyrénées	32	1	13	270	Mongausy	77	3	80
73	Midi-Pyrénées	32	2	22	271	Monguilhem	285	8	293
73	Midi-Pyrénées	32	3	15	272	Monlaur-Bernet	187	1	188
73	Midi-Pyrénées	32	3	14	273	Monlezun	198	4	202
73	Midi-Pyrénées	32	2	22	274	Monlezun-d;Armagnac	198	6	204
73	Midi-Pyrénées	32	3	14	275	Monpardiac	43	1	44
73	Midi-Pyrénées	32	3	15	280	Mont-d;Astarac	96	5	101
73	Midi-Pyrénées	32	3	17	281	Mont-de-Marrast	107	2	109
73	Midi-Pyrénées	32	1	13	276	Montadet	82	5	87
73	Midi-Pyrénées	32	1	13	277	Montamat	121	2	123
73	Midi-Pyrénées	32	3	17	278	Montaut	114	5	119
73	Midi-Pyrénées	32	1	30	279	Montaut-les-Créneaux	646	13	659
73	Midi-Pyrénées	32	1	02	282	Montégut	558	15	573
73	Midi-Pyrénées	32	3	17	283	Montégut-Arros	289	6	295
73	Midi-Pyrénées	32	1	13	284	Montégut-Savès	71	1	72
73	Midi-Pyrénées	32	3	20	285	Montesquiou	600	15	615
73	Midi-Pyrénées	32	2	08	286	Montestruc-sur-Gers	707	20	727
73	Midi-Pyrénées	32	3	15	287	Monties	70	0	70
73	Midi-Pyrénées	32	1	09	288	Montiron	123	7	130
73	Midi-Pyrénées	32	1	13	289	Montpézat	241	9	250
73	Midi-Pyrénées	32	2	21	290	Montréal	1231	18	1249
73	Midi-Pyrénées	32	2	22	291	Mormès	124	3	127
73	Midi-Pyrénées	32	2	06	292	Mouchan	433	17	450
73	Midi-Pyrénées	32	3	20	293	Mouchès	73	1	74
73	Midi-Pyrénées	32	2	07	294	Mourède	84	2	86
73	Midi-Pyrénées	32	1	26	295	Nizas	159	1	160
73	Midi-Pyrénées	32	2	22	296	Nogaro	1980	157	2137
73	Midi-Pyrénées	32	1	26	297	Noilhan	320	1	321
73	Midi-Pyrénées	32	1	02	298	Nougaroulet	352	8	360
73	Midi-Pyrénées	32	2	07	299	Noulens	98	4	102
73	Midi-Pyrénées	32	1	03	300	Orbessan	255	8	263
73	Midi-Pyrénées	32	1	11	301	Ordan-Larroque	932	39	971
73	Midi-Pyrénées	32	1	03	302	Ornézan	240	6	246
73	Midi-Pyrénées	32	3	14	303	Pallanne	69	0	69
73	Midi-Pyrénées	32	3	15	304	Panassac	276	3	279
73	Midi-Pyrénées	32	2	04	305	Panjas	380	8	388
73	Midi-Pyrénées	32	2	08	306	Pauilhac	613	42	655
73	Midi-Pyrénées	32	1	31	307	Pavie	2399	145	2544
73	Midi-Pyrénées	32	1	26	308	Pébées	94	3	97
73	Midi-Pyrénées	32	1	13	309	Pellefigue	125	2	127
73	Midi-Pyrénées	32	2	22	310	Perchède	86	2	88
73	Midi-Pyrénées	32	2	12	311	Pergain-Taillac	331	6	337
73	Midi-Pyrénées	32	1	03	312	Pessan	700	15	715
73	Midi-Pyrénées	32	2	25	313	Pessoulens	159	5	164
73	Midi-Pyrénées	32	2	18	314	Peyrecave	76	4	80
73	Midi-Pyrénées	32	3	20	315	Peyrusse-Grande	162	2	164
73	Midi-Pyrénées	32	1	11	316	Peyrusse-Massas	106	1	107
73	Midi-Pyrénées	32	3	20	317	Peyrusse-Vieille	70	0	70
73	Midi-Pyrénées	32	2	08	318	Pis	94	2	96
73	Midi-Pyrénées	32	3	23	319	Plaisance	1458	47	1505
73	Midi-Pyrénées	32	2	18	320	Plieux	165	4	169
73	Midi-Pyrénées	32	1	26	321	Polastron	260	6	266
73	Midi-Pyrénées	32	1	26	322	Pompiac	182	8	190
73	Midi-Pyrénées	32	3	19	323	Ponsampère	108	3	111
73	Midi-Pyrénées	32	3	15	324	Ponsan-Soubiran	123	6	129
73	Midi-Pyrénées	32	1	27	327	Pouy-Loubrin	106	0	106
73	Midi-Pyrénées	32	2	12	328	Pouy-Roquelaure	139	5	144
73	Midi-Pyrénées	32	3	01	325	Pouydraguin	145	7	152
73	Midi-Pyrénées	32	3	20	326	Pouylebon	163	0	163
73	Midi-Pyrénées	32	2	08	329	Préchac	165	4	169
73	Midi-Pyrénées	32	3	23	330	Préchac-sur-Adour	212	6	218
73	Midi-Pyrénées	32	1	30	331	Preignan	1248	43	1291
73	Midi-Pyrénées	32	1	29	332	Préneron	144	6	150
73	Midi-Pyrénées	32	3	24	333	Projan	156	4	160
73	Midi-Pyrénées	32	1	10	334	Pujaudran	1372	30	1402
73	Midi-Pyrénées	32	1	02	335	Puycasquier	444	8	452
73	Midi-Pyrénées	32	1	13	336	Puylausic	188	5	193
73	Midi-Pyrénées	32	2	08	337	Puységur	76	1	77
73	Midi-Pyrénées	32	2	07	338	Ramouzens	145	8	153
73	Midi-Pyrénées	32	1	10	339	Razengues	189	5	194
73	Midi-Pyrénées	32	2	04	340	Réans	251	7	258
73	Midi-Pyrénées	32	2	08	341	Réjaumont	208	7	215
73	Midi-Pyrénées	32	3	14	342	Ricourt	73	4	77
73	Midi-Pyrénées	32	1	29	343	Riguepeu	207	8	215
73	Midi-Pyrénées	32	3	24	344	Riscle	1727	103	1830
73	Midi-Pyrénées	32	2	06	345	La Romieu	558	11	569
73	Midi-Pyrénées	32	1	29	346	Roquebrune	196	7	203
73	Midi-Pyrénées	32	1	11	347	Roquefort	274	14	288
73	Midi-Pyrénées	32	1	30	348	Roquelaure	580	19	599
73	Midi-Pyrénées	32	1	05	349	Roquelaure-Saint-Aubin	126	2	128
73	Midi-Pyrénées	32	2	28	350	Roquepine	61	0	61
73	Midi-Pyrénées	32	2	28	351	Roques	113	8	121
73	Midi-Pyrénées	32	2	28	352	Rozès	128	5	133
73	Midi-Pyrénées	32	1	13	353	Sabaillan	156	3	159
73	Midi-Pyrénées	32	3	01	354	Sabazan	134	4	138
73	Midi-Pyrénées	32	3	17	355	Sadeillan	83	1	84
73	Midi-Pyrénées	32	1	26	356	Saint-André	99	6	105
73	Midi-Pyrénées	32	2	18	358	Saint-Antoine	204	9	213
73	Midi-Pyrénées	32	2	16	359	Saint-Antonin	145	5	150
73	Midi-Pyrénées	32	1	29	360	Saint-Arailles	144	3	147
73	Midi-Pyrénées	32	3	15	361	Saint-Arroman	135	4	139
73	Midi-Pyrénées	32	3	23	362	Saint-Aunix-Lengros	153	5	158
73	Midi-Pyrénées	32	2	12	364	Saint-Avit-Frandat	99	2	101
73	Midi-Pyrénées	32	3	15	365	Saint-Blancard	336	4	340
73	Midi-Pyrénées	32	2	16	366	Saint-Brès	85	6	91
73	Midi-Pyrénées	32	1	09	467	Saint-Caprais	135	2	137
73	Midi-Pyrénées	32	3	20	367	Saint-Christaud	75	1	76
73	Midi-Pyrénées	32	2	25	370	Saint-Clar	1003	78	1081
73	Midi-Pyrénées	32	2	25	371	Saint-Créac	102	5	107
73	Midi-Pyrénées	32	1	05	372	Saint-Cricq	262	4	266
73	Midi-Pyrénées	32	1	13	374	Saint-Élix	193	5	198
73	Midi-Pyrénées	32	3	19	375	Saint-Élix-Theux	117	3	120
73	Midi-Pyrénées	32	1	05	377	Saint-Georges	174	2	176
73	Midi-Pyrénées	32	3	24	378	Saint-Germé	499	7	506
73	Midi-Pyrénées	32	1	05	379	Saint-Germier	201	7	208
73	Midi-Pyrénées	32	2	22	380	Saint-Griède	130	7	137
73	Midi-Pyrénées	32	1	31	381	Saint-Jean-le-Comtal	387	12	399
73	Midi-Pyrénées	32	1	29	382	Saint-Jean-Poutge	316	6	322
73	Midi-Pyrénées	32	3	14	383	Saint-Justin	157	5	162
73	Midi-Pyrénées	32	1	11	384	Saint-Lary	261	10	271
73	Midi-Pyrénées	32	2	25	385	Saint-Léonard	175	1	176
73	Midi-Pyrénées	32	1	13	386	Saint-Lizier-du-Planté	121	2	123
73	Midi-Pyrénées	32	1	13	387	Saint-Loube	97	1	98
73	Midi-Pyrénées	32	3	19	389	Saint-Martin	453	20	473
73	Midi-Pyrénées	32	2	22	390	Saint-Martin-d;Armagnac	227	11	238
73	Midi-Pyrénées	32	2	12	391	Saint-Martin-de-Goyne	130	2	132
73	Midi-Pyrénées	32	1	27	392	Saint-Martin-Gimois	87	4	91
73	Midi-Pyrénées	32	3	19	393	Saint-Maur	124	2	126
73	Midi-Pyrénées	32	3	19	394	Saint-Médard	325	11	336
73	Midi-Pyrénées	32	2	12	396	Saint-Mézard	214	2	216
73	Midi-Pyrénées	32	3	19	397	Saint-Michel	266	7	273
73	Midi-Pyrénées	32	3	24	398	Saint-Mont	303	10	313
73	Midi-Pyrénées	32	2	16	399	Saint-Orens	84	1	85
73	Midi-Pyrénées	32	2	28	400	Saint-Orens-Pouy-Petit	149	4	153
73	Midi-Pyrénées	32	3	19	401	Saint-Ost	80	3	83
73	Midi-Pyrénées	32	2	28	402	Saint-Paul-de-Baïse	106	3	109
73	Midi-Pyrénées	32	3	01	403	Saint-Pierre-d;Aubézies	78	1	79
73	Midi-Pyrénées	32	2	28	404	Saint-Puy	586	10	596
73	Midi-Pyrénées	32	1	09	406	Saint-Sauvy	367	13	380
73	Midi-Pyrénées	32	1	26	407	Saint-Soulan	146	2	148
73	Midi-Pyrénées	32	1	05	357	Sainte-Anne	116	1	117
73	Midi-Pyrénées	32	3	17	363	Sainte-Aurence-Cazaux	124	3	127
73	Midi-Pyrénées	32	1	30	368	Sainte-Christie	566	13	579
73	Midi-Pyrénées	32	2	22	369	Sainte-Christie-d;Armagnac	366	9	375
73	Midi-Pyrénées	32	3	17	373	Sainte-Dode	223	12	235
73	Midi-Pyrénées	32	2	16	376	Sainte-Gemme	129	2	131
73	Midi-Pyrénées	32	1	09	388	Sainte-Marie	388	13	401
73	Midi-Pyrénées	32	2	18	395	Sainte-Mère	204	7	211
73	Midi-Pyrénées	32	2	08	405	Sainte-Radegonde	184	5	189
73	Midi-Pyrénées	32	2	22	408	Salles-d;Armagnac	118	6	124
73	Midi-Pyrénées	32	3	15	409	Samaran	87	4	91
73	Midi-Pyrénées	32	1	26	410	Samatan	2324	95	2419
73	Midi-Pyrénées	32	1	03	411	Sansan	97	3	100
73	Midi-Pyrénées	32	1	27	412	Saramon	856	16	872
73	Midi-Pyrénées	32	3	15	413	Sarcos	75	5	80
73	Midi-Pyrénées	32	3	01	414	Sarragachies	254	8	262
73	Midi-Pyrénées	32	3	17	415	Sarraguzan	97	0	97
73	Midi-Pyrénées	32	2	16	416	Sarrant	371	4	375
73	Midi-Pyrénées	32	2	08	417	La Sauvetat	356	8	364
73	Midi-Pyrénées	32	1	13	418	Sauveterre	231	69	300
73	Midi-Pyrénées	32	3	19	419	Sauviac	108	5	113
73	Midi-Pyrénées	32	1	13	420	Sauvimont	71	2	73
73	Midi-Pyrénées	32	1	26	421	Savignac-Mona	148	6	154
73	Midi-Pyrénées	32	3	14	422	Scieurac-et-Flourès	49	0	49
73	Midi-Pyrénées	32	2	07	423	Séailles	67	1	68
73	Midi-Pyrénées	32	3	24	424	Ségos	248	7	255
73	Midi-Pyrénées	32	1	10	425	Ségoufielle	990	31	1021
73	Midi-Pyrénées	32	1	03	426	Seissan	1080	25	1105
73	Midi-Pyrénées	32	3	14	427	Sembouès	66	0	66
73	Midi-Pyrénées	32	1	27	428	Sémézies-Cachan	74	2	76
73	Midi-Pyrénées	32	2	18	429	Sempesserre	305	13	318
73	Midi-Pyrénées	32	3	15	430	Sère	92	1	93
73	Midi-Pyrénées	32	2	16	431	Sérempuy	37	1	38
73	Midi-Pyrénées	32	1	26	432	Seysses-Savès	260	8	268
73	Midi-Pyrénées	32	1	13	433	Simorre	690	21	711
73	Midi-Pyrénées	32	2	22	434	Sion	120	3	123
73	Midi-Pyrénées	32	1	05	435	Sirac	142	2	144
73	Midi-Pyrénées	32	2	16	436	Solomiac	461	8	469
73	Midi-Pyrénées	32	2	22	437	Sorbets	210	0	210
73	Midi-Pyrénées	32	1	27	438	Tachoires	102	7	109
73	Midi-Pyrénées	32	3	24	439	Tarsac	169	4	173
73	Midi-Pyrénées	32	3	23	440	Tasque	266	2	268
73	Midi-Pyrénées	32	2	08	441	Taybosc	59	1	60
73	Midi-Pyrénées	32	3	01	443	Termes-d;Armagnac	188	4	192
73	Midi-Pyrénées	32	2	12	442	Terraube	393	13	406
73	Midi-Pyrénées	32	1	05	444	Thoux	229	7	236
73	Midi-Pyrénées	32	3	23	445	Tieste-Uragnoux	129	4	133
73	Midi-Pyrénées	32	3	14	446	Tillac	254	11	265
73	Midi-Pyrénées	32	1	27	447	Tirent-Pontéjac	86	1	87
73	Midi-Pyrénées	32	1	05	448	Touget	519	16	535
73	Midi-Pyrénées	32	2	22	449	Toujouse	206	4	210
73	Midi-Pyrénées	32	3	14	450	Tourdun	96	10	106
73	Midi-Pyrénées	32	1	13	451	Tournan	198	5	203
73	Midi-Pyrénées	32	2	25	452	Tournecoupe	283	6	289
73	Midi-Pyrénées	32	1	02	453	Tourrenquets	122	5	127
73	Midi-Pyrénées	32	1	27	454	Traversères	79	1	80
73	Midi-Pyrénées	32	3	14	455	Troncens	185	4	189
73	Midi-Pyrénées	32	1	29	456	Tudelle	62	1	63
73	Midi-Pyrénées	32	2	08	457	Urdens	246	8	254
73	Midi-Pyrénées	32	2	22	458	Urgosse	238	5	243
73	Midi-Pyrénées	32	2	28	459	Valence-sur-Baïse	1185	25	1210
73	Midi-Pyrénées	32	3	24	460	Vergoignan	297	4	301
73	Midi-Pyrénées	32	3	24	461	Verlus	98	6	104
73	Midi-Pyrénées	32	1	29	462	Vic-Fezensac	3645	109	3754
73	Midi-Pyrénées	32	3	24	463	Viella	532	22	554
73	Midi-Pyrénées	32	3	17	464	Villecomtal-sur-Arros	847	17	864
73	Midi-Pyrénées	32	1	13	465	Villefranche	164	1	165
73	Midi-Pyrénées	32	3	19	466	Viozan	110	5	115
72	Aquitaine	33	5	22	001	Abzac	1790	49	1839
72	Aquitaine	33	3	03	002	Aillas	761	22	783
72	Aquitaine	33	2	19	003	Ambarès-et-Lagrave	13270	241	13511
72	Aquitaine	33	2	60	004	Ambès	2894	35	2929
72	Aquitaine	33	6	02	005	Andernos-les-Bains	11127	288	11415
72	Aquitaine	33	1	40	006	Anglade	896	15	911
72	Aquitaine	33	3	36	007	Arbanats	1083	16	1099
72	Aquitaine	33	3	48	008	Arbis	285	4	289
72	Aquitaine	33	6	01	009	Arcachon	10975	303	11278
72	Aquitaine	33	4	20	010	Arcins	433	0	433
72	Aquitaine	33	6	02	011	Arès	5576	100	5676
72	Aquitaine	33	4	20	012	Arsac	3146	46	3192
72	Aquitaine	33	5	31	014	Les Artigues-de-Lussac	1051	17	1068
72	Aquitaine	33	2	55	013	Artigues-près-Bordeaux	7245	81	7326
72	Aquitaine	33	5	30	015	Arveyres	1886	44	1930
72	Aquitaine	33	5	24	016	Asques	490	11	501
72	Aquitaine	33	3	04	017	Aubiac	242	6	248
72	Aquitaine	33	1	39	018	Aubie-et-Espessas	1195	12	1207
72	Aquitaine	33	6	02	019	Audenge	6052	103	6155
72	Aquitaine	33	3	34	020	Auriolles	129	1	130
72	Aquitaine	33	3	03	021	Auros	916	19	935
72	Aquitaine	33	4	20	022	Avensan	2222	36	2258
72	Aquitaine	33	2	27	023	Ayguemorte-les-Graves	933	7	940
72	Aquitaine	33	3	38	024	Bagas	274	2	276
72	Aquitaine	33	3	48	025	Baigneaux	347	9	356
72	Aquitaine	33	3	45	026	Balizac	451	11	462
72	Aquitaine	33	3	03	027	Barie	281	6	287
72	Aquitaine	33	5	16	028	Baron	1076	21	1097
72	Aquitaine	33	6	05	029	Le Barp	4557	57	4614
72	Aquitaine	33	3	36	030	Barsac	2141	41	2182
72	Aquitaine	33	3	03	031	Bassanne	91	3	94
72	Aquitaine	33	2	60	032	Bassens	6899	49	6948
72	Aquitaine	33	2	23	033	Baurech	749	14	763
72	Aquitaine	33	5	26	034	Bayas	454	5	459
72	Aquitaine	33	1	15	035	Bayon-sur-Gironde	727	12	739
72	Aquitaine	33	3	04	036	Bazas	4715	263	4978
72	Aquitaine	33	2	27	037	Beautiran	2180	27	2207
72	Aquitaine	33	4	29	038	Bégadan	909	13	922
72	Aquitaine	33	2	52	039	Bègles	24913	292	25205
72	Aquitaine	33	3	17	040	Béguey	1128	10	1138
72	Aquitaine	33	6	05	042	Belin-Béliet	4379	69	4448
72	Aquitaine	33	3	48	043	Bellebat	241	2	243
72	Aquitaine	33	3	48	044	Bellefond	225	4	229
72	Aquitaine	33	5	21	045	Belvès-de-Castillon	326	4	330
72	Aquitaine	33	3	04	046	Bernos-Beaulac	1152	26	1178
72	Aquitaine	33	1	07	047	Berson	1766	56	1822
72	Aquitaine	33	3	03	048	Berthez	221	2	223
72	Aquitaine	33	2	55	049	Beychac-et-Caillau	1983	35	2018
72	Aquitaine	33	3	28	050	Bieujac	504	10	514
72	Aquitaine	33	6	02	051	Biganos	9672	154	9826
72	Aquitaine	33	5	30	052	Les Billaux	1097	22	1119
72	Aquitaine	33	3	04	053	Birac	229	10	239
72	Aquitaine	33	3	38	054	Blaignac	263	6	269
72	Aquitaine	33	4	29	055	Blaignan	240	0	240
72	Aquitaine	33	2	06	056	Blanquefort	14779	729	15508
72	Aquitaine	33	3	47	057	Blasimon	872	26	898
72	Aquitaine	33	1	07	058	Blaye	4802	219	5021
72	Aquitaine	33	2	23	059	Blésignac	310	3	313
72	Aquitaine	33	3	28	060	Bommes	476	71	547
72	Aquitaine	33	2	23	061	Bonnetan	806	14	820
72	Aquitaine	33	5	26	062	Bonzac	762	9	771
72	Aquitaine	33	2	99	063	Bordeaux	239157	3788	242945
72	Aquitaine	33	5	37	064	Bossugan	47	1	48
72	Aquitaine	33	2	58	065	Bouliac	3106	98	3204
72	Aquitaine	33	3	38	066	Bourdelles	115	4	119
72	Aquitaine	33	1	15	067	Bourg	2197	41	2238
72	Aquitaine	33	3	50	068	Bourideys	91	0	91
72	Aquitaine	33	2	54	069	Le Bouscat	23095	444	23539
72	Aquitaine	33	4	20	070	Brach	501	3	504
72	Aquitaine	33	5	16	071	Branne	1294	22	1316
72	Aquitaine	33	3	03	072	Brannens	224	4	228
72	Aquitaine	33	1	40	073	Braud-et-Saint-Louis	1385	30	1415
72	Aquitaine	33	2	27	213	La Brède	3825	359	4184
72	Aquitaine	33	3	03	074	Brouqueyran	207	3	210
72	Aquitaine	33	2	54	075	Bruges	14903	179	15082
72	Aquitaine	33	3	36	076	Budos	706	7	713
72	Aquitaine	33	2	27	077	Cabanac-et-Villagrains	2121	28	2149
72	Aquitaine	33	5	16	078	Cabara	396	7	403
72	Aquitaine	33	5	30	079	Cadarsac	300	7	307
72	Aquitaine	33	2	27	080	Cadaujac	4816	163	4979
72	Aquitaine	33	3	17	081	Cadillac	2520	28	2548
72	Aquitaine	33	5	24	082	Cadillac-en-Fronsadais	1156	8	1164
72	Aquitaine	33	2	23	083	Camarsac	936	12	948
72	Aquitaine	33	2	23	084	Cambes	1346	27	1373
72	Aquitaine	33	2	23	085	Camblanes-et-Meynac	2661	167	2828
72	Aquitaine	33	5	16	086	Camiac-et-Saint-Denis	378	6	384
72	Aquitaine	33	3	38	087	Camiran	435	9	444
72	Aquitaine	33	5	22	088	Camps-sur-l;Isle	541	6	547
72	Aquitaine	33	1	07	089	Campugnan	467	21	488
72	Aquitaine	33	2	59	090	Canéjan	5109	92	5201
72	Aquitaine	33	4	20	091	Cantenac	1310	12	1322
72	Aquitaine	33	3	48	092	Cantois	227	4	231
72	Aquitaine	33	3	17	093	Capian	647	12	659
72	Aquitaine	33	5	41	094	Caplong	225	6	231
72	Aquitaine	33	3	18	095	Captieux	1425	16	1441
72	Aquitaine	33	2	19	096	Carbon-Blanc	6885	68	6953
72	Aquitaine	33	4	42	097	Carcans	2190	42	2232
72	Aquitaine	33	3	17	098	Cardan	439	4	443
72	Aquitaine	33	2	23	099	Carignan-de-Bordeaux	3689	128	3817
72	Aquitaine	33	1	07	100	Cars	1160	28	1188
72	Aquitaine	33	1	07	101	Cartelègue	1104	20	1124
72	Aquitaine	33	3	38	102	Casseuil	383	3	386
72	Aquitaine	33	3	32	103	Castelmoron-d;Albret	56	1	57
72	Aquitaine	33	4	20	104	Castelnau-de-Médoc	3728	63	3791
72	Aquitaine	33	3	47	105	Castelviel	186	9	195
72	Aquitaine	33	3	28	106	Castets-en-Dorthe	1211	25	1236
72	Aquitaine	33	3	03	107	Castillon-de-Castets	302	10	312
72	Aquitaine	33	5	21	108	Castillon-la-Bataille	3045	38	3083
72	Aquitaine	33	2	27	109	Castres-Gironde	2108	42	2150
72	Aquitaine	33	3	43	111	Caudrot	1134	20	1154
72	Aquitaine	33	3	34	112	Caumont	158	3	161
72	Aquitaine	33	3	25	113	Cauvignac	151	3	154
72	Aquitaine	33	1	44	114	Cavignac	1605	23	1628
72	Aquitaine	33	3	50	115	Cazalis	231	13	244
72	Aquitaine	33	3	04	116	Cazats	294	6	300
72	Aquitaine	33	3	34	117	Cazaugitat	250	6	256
72	Aquitaine	33	2	23	118	Cénac	1843	58	1901
72	Aquitaine	33	2	55	119	Cenon	22242	346	22588
72	Aquitaine	33	3	36	120	Cérons	1855	31	1886
72	Aquitaine	33	3	48	121	Cessac	187	8	195
72	Aquitaine	33	2	59	122	Cestas	16353	449	16802
72	Aquitaine	33	1	44	123	Cézac	2337	25	2362
72	Aquitaine	33	5	22	124	Chamadelle	677	11	688
72	Aquitaine	33	4	33	125	Cissac-Médoc	1772	20	1792
72	Aquitaine	33	1	44	126	Civrac-de-Blaye	791	10	801
72	Aquitaine	33	4	29	128	Civrac-en-Médoc	584	9	593
72	Aquitaine	33	5	37	127	Civrac-sur-Dordogne	233	3	236
72	Aquitaine	33	3	47	129	Cleyrac	158	0	158
72	Aquitaine	33	3	03	130	Coimères	866	16	882
72	Aquitaine	33	3	47	131	Coirac	212	3	215
72	Aquitaine	33	1	15	132	Comps	480	11	491
72	Aquitaine	33	5	37	133	Coubeyrac	105	1	106
72	Aquitaine	33	4	29	134	Couquèques	252	7	259
72	Aquitaine	33	3	48	135	Courpiac	106	2	108
72	Aquitaine	33	3	32	136	Cours-de-Monségur	279	8	287
72	Aquitaine	33	3	25	137	Cours-les-Bains	217	5	222
72	Aquitaine	33	5	22	138	Coutras	8045	165	8210
72	Aquitaine	33	3	32	139	Coutures	92	0	92
72	Aquitaine	33	2	23	140	Créon	4246	79	4325
72	Aquitaine	33	2	23	141	Croignon	499	7	506
72	Aquitaine	33	1	44	142	Cubnezais	1324	16	1340
72	Aquitaine	33	1	39	143	Cubzac-les-Ponts	2067	24	2091
72	Aquitaine	33	3	04	144	Cudos	842	158	1000
72	Aquitaine	33	2	23	145	Cursan	504	4	508
72	Aquitaine	33	4	20	146	Cussac-Fort-Médoc	2000	27	2027
72	Aquitaine	33	5	16	147	Daignac	480	7	487
72	Aquitaine	33	5	16	148	Dardenac	93	1	94
72	Aquitaine	33	3	47	149	Daubèze	152	0	152
72	Aquitaine	33	3	32	150	Dieulivol	288	33	321
72	Aquitaine	33	1	44	151	Donnezac	849	17	866
72	Aquitaine	33	3	17	152	Donzac	148	3	151
72	Aquitaine	33	5	37	153	Doulezon	265	9	274
72	Aquitaine	33	5	22	154	Les Églisottes-et-Chalaures	2167	113	2280
72	Aquitaine	33	3	18	155	Escaudes	150	3	153
72	Aquitaine	33	3	48	156	Escoussans	295	2	297
72	Aquitaine	33	5	16	157	Espiet	716	20	736
72	Aquitaine	33	3	38	158	Les Esseintes	269	5	274
72	Aquitaine	33	1	40	159	Étauliers	1660	51	1711
72	Aquitaine	33	5	41	160	Eynesse	583	21	604
72	Aquitaine	33	1	40	161	Eyrans	705	18	723
72	Aquitaine	33	2	06	162	Eysines	19571	427	19998
72	Aquitaine	33	3	48	163	Faleyras	397	8	405
72	Aquitaine	33	3	28	164	Fargues	1604	77	1681
72	Aquitaine	33	2	23	165	Fargues-Saint-Hilaire	2711	79	2790
72	Aquitaine	33	5	22	166	Le Fieu	488	7	495
72	Aquitaine	33	5	37	168	Flaujagues	544	4	548
72	Aquitaine	33	2	58	167	Floirac	16202	255	16457
72	Aquitaine	33	3	38	169	Floudès	103	13	116
72	Aquitaine	33	3	38	170	Fontet	795	14	809
72	Aquitaine	33	3	38	171	Fossès-et-Baleyssac	183	3	186
72	Aquitaine	33	1	07	172	Fours	283	11	294
72	Aquitaine	33	5	31	173	Francs	212	6	218
72	Aquitaine	33	5	24	174	Fronsac	1077	30	1107
72	Aquitaine	33	3	48	175	Frontenac	727	26	753
72	Aquitaine	33	3	17	176	Gabarnac	322	9	331
72	Aquitaine	33	4	29	177	Gaillan-en-Médoc	2034	46	2080
72	Aquitaine	33	3	04	178	Gajac	388	4	392
72	Aquitaine	33	5	24	179	Galgon	2836	82	2918
72	Aquitaine	33	3	04	180	Gans	188	6	194
72	Aquitaine	33	5	21	181	Gardegan-et-Tourtirac	306	11	317
72	Aquitaine	33	1	15	182	Gauriac	853	16	869
72	Aquitaine	33	1	39	183	Gauriaguet	1166	10	1176
72	Aquitaine	33	1	44	184	Générac	575	5	580
72	Aquitaine	33	5	16	185	Génissac	1835	57	1892
72	Aquitaine	33	5	37	186	Gensac	860	24	884
72	Aquitaine	33	3	38	187	Gironde-sur-Dropt	1141	18	1159
72	Aquitaine	33	3	18	188	Giscos	202	3	205
72	Aquitaine	33	3	47	189	Gornac	385	7	392
72	Aquitaine	33	3	18	190	Goualade	87	2	89
72	Aquitaine	33	5	31	191	Gours	437	5	442
72	Aquitaine	33	2	59	192	Gradignan	23063	483	23546
72	Aquitaine	33	4	46	193	Grayan-et-l;Hôpital	1258	21	1279
72	Aquitaine	33	5	16	194	Grézillac	715	20	735
72	Aquitaine	33	3	25	195	Grignols	1124	26	1150
72	Aquitaine	33	5	16	196	Guillac	183	7	190
72	Aquitaine	33	3	36	197	Guillos	412	5	417
72	Aquitaine	33	5	26	198	Guîtres	1667	37	1704
72	Aquitaine	33	6	49	199	Gujan-Mestras	19305	572	19877
72	Aquitaine	33	2	63	200	Le Haillan	8933	356	9289
72	Aquitaine	33	2	23	201	Haux	795	17	812
72	Aquitaine	33	3	45	202	Hostens	1337	18	1355
72	Aquitaine	33	4	42	203	Hourtin	3235	54	3289
72	Aquitaine	33	3	38	204	Hure	497	15	512
72	Aquitaine	33	3	36	205	Illats	1280	17	1297
72	Aquitaine	33	2	27	206	Isle-Saint-Georges	536	46	582
72	Aquitaine	33	5	30	207	Izon	5370	89	5459
72	Aquitaine	33	4	46	208	Jau-Dignac-et-Loirac	1051	15	1066
72	Aquitaine	33	5	16	209	Jugazan	282	7	289
72	Aquitaine	33	5	37	210	Juillac	261	5	266
72	Aquitaine	33	4	20	211	Labarde	628	5	633
72	Aquitaine	33	3	25	212	Labescau	105	0	105
72	Aquitaine	33	4	20	214	Lacanau	4428	81	4509
72	Aquitaine	33	3	48	215	Ladaux	204	3	207
72	Aquitaine	33	3	03	216	Lados	148	3	151
72	Aquitaine	33	5	26	218	Lagorce	1660	16	1676
72	Aquitaine	33	5	30	222	Lalande-de-Pomerol	672	13	685
72	Aquitaine	33	4	20	220	Lamarque	1188	6	1194
72	Aquitaine	33	3	38	221	Lamothe-Landerron	1122	38	1160
72	Aquitaine	33	5	24	219	La Lande-de-Fronsac	2393	79	2472
72	Aquitaine	33	3	34	223	Landerrouat	182	2	184
72	Aquitaine	33	3	32	224	Landerrouet-sur-Ségur	115	3	118
72	Aquitaine	33	3	36	225	Landiras	2096	52	2148
72	Aquitaine	33	3	17	226	Langoiran	2230	25	2255
72	Aquitaine	33	3	28	227	Langon	7391	463	7854
72	Aquitaine	33	1	15	228	Lansac	689	7	696
72	Aquitaine	33	6	02	229	Lanton	6196	113	6309
72	Aquitaine	33	5	26	230	Lapouyade	469	7	476
72	Aquitaine	33	3	17	231	Laroque	272	2	274
72	Aquitaine	33	3	18	232	Lartigue	51	1	52
72	Aquitaine	33	1	44	233	Laruscade	2358	34	2392
72	Aquitaine	33	2	23	234	Latresne	3277	62	3339
72	Aquitaine	33	3	25	235	Lavazan	228	3	231
72	Aquitaine	33	6	02	236	Lège-Cap-Ferret	7714	209	7923
72	Aquitaine	33	3	28	237	Léogeats	720	15	735
72	Aquitaine	33	2	27	238	Léognan	9309	158	9467
72	Aquitaine	33	3	25	239	Lerm-et-Musset	469	17	486
72	Aquitaine	33	4	29	240	Lesparre-Médoc	5581	198	5779
72	Aquitaine	33	3	17	241	Lestiac-sur-Garonne	620	19	639
72	Aquitaine	33	5	41	242	Les Lèves-et-Thoumeyragues	548	17	565
72	Aquitaine	33	5	30	243	Libourne	23624	678	24302
72	Aquitaine	33	3	04	244	Lignan-de-Bazas	307	6	313
72	Aquitaine	33	2	23	245	Lignan-de-Bordeaux	704	13	717
72	Aquitaine	33	5	41	246	Ligueux	168	4	172
72	Aquitaine	33	3	34	247	Listrac-de-Durèze	176	4	180
72	Aquitaine	33	4	20	248	Listrac-Médoc	2404	21	2425
72	Aquitaine	33	2	60	249	Lormont	19799	472	20271
72	Aquitaine	33	3	38	250	Loubens	309	10	319
72	Aquitaine	33	3	45	251	Louchats	709	5	714
72	Aquitaine	33	2	23	252	Loupes	655	4	659
72	Aquitaine	33	3	17	253	Loupiac	1099	16	1115
72	Aquitaine	33	3	38	254	Loupiac-de-la-Réole	471	3	474
72	Aquitaine	33	3	50	255	Lucmau	215	8	223
72	Aquitaine	33	2	06	256	Ludon-Médoc	4160	38	4198
72	Aquitaine	33	5	16	257	Lugaignac	394	9	403
72	Aquitaine	33	3	48	258	Lugasson	269	17	286
72	Aquitaine	33	5	24	259	Lugon-et-l;Île-du-Carnay	1128	26	1154
72	Aquitaine	33	6	05	260	Lugos	840	20	860
72	Aquitaine	33	5	31	261	Lussac	1308	60	1368
72	Aquitaine	33	2	06	262	Macau	3486	29	3515
72	Aquitaine	33	2	23	263	Madirac	184	1	185
72	Aquitaine	33	5	26	264	Maransin	1055	15	1070
72	Aquitaine	33	1	44	266	Marcenais	709	27	736
72	Aquitaine	33	6	02	555	Marcheprime	4301	124	4425
72	Aquitaine	33	1	40	267	Marcillac	1168	12	1180
72	Aquitaine	33	4	20	268	Margaux	1506	19	1525
72	Aquitaine	33	5	41	269	Margueron	385	8	393
72	Aquitaine	33	3	04	270	Marimbault	163	1	164
72	Aquitaine	33	3	25	271	Marions	187	2	189
72	Aquitaine	33	1	44	272	Marsas	1092	10	1102
72	Aquitaine	33	2	61	273	Martignas-sur-Jalle	7227	119	7346
72	Aquitaine	33	2	27	274	Martillac	2487	85	2572
72	Aquitaine	33	3	48	275	Martres	132	2	134
72	Aquitaine	33	3	25	276	Masseilles	127	1	128
72	Aquitaine	33	3	34	277	Massugas	279	8	287
72	Aquitaine	33	3	47	278	Mauriac	270	5	275
72	Aquitaine	33	3	28	279	Mazères	669	41	710
72	Aquitaine	33	1	07	280	Mazion	515	16	531
72	Aquitaine	33	2	98	281	Mérignac	66142	994	67136
72	Aquitaine	33	3	47	282	Mérignas	290	12	302
72	Aquitaine	33	3	32	283	Mesterrieux	202	6	208
72	Aquitaine	33	6	02	284	Mios	7219	103	7322
72	Aquitaine	33	1	15	285	Mombrier	362	10	372
72	Aquitaine	33	3	38	287	Mongauzy	582	11	593
72	Aquitaine	33	3	17	288	Monprimblanc	278	5	283
72	Aquitaine	33	3	32	289	Monségur	1525	44	1569
72	Aquitaine	33	5	31	290	Montagne	1619	120	1739
72	Aquitaine	33	3	38	291	Montagoudin	164	3	167
72	Aquitaine	33	3	48	292	Montignac	141	1	142
72	Aquitaine	33	2	55	293	Montussan	2778	22	2800
72	Aquitaine	33	3	38	294	Morizès	532	10	542
72	Aquitaine	33	5	24	295	Mouillac	99	1	100
72	Aquitaine	33	5	37	296	Mouliets-et-Villemartin	1094	24	1118
72	Aquitaine	33	4	20	297	Moulis-en-Médoc	1810	18	1828
72	Aquitaine	33	5	16	298	Moulon	968	20	988
72	Aquitaine	33	3	47	299	Mourens	387	5	392
72	Aquitaine	33	4	29	300	Naujac-sur-Mer	844	15	859
72	Aquitaine	33	5	16	301	Naujan-et-Postiac	494	5	499
72	Aquitaine	33	5	31	302	Néac	389	8	397
72	Aquitaine	33	5	16	303	Nérigean	859	23	882
72	Aquitaine	33	3	32	304	Neuffons	169	4	173
72	Aquitaine	33	3	04	305	Le Nizan	411	9	420
72	Aquitaine	33	3	38	306	Noaillac	390	6	396
72	Aquitaine	33	3	50	307	Noaillan	1564	28	1592
72	Aquitaine	33	3	17	308	Omet	262	6	268
72	Aquitaine	33	4	29	309	Ordonnac	461	10	471
72	Aquitaine	33	3	45	310	Origne	176	0	176
72	Aquitaine	33	3	17	311	Paillet	1193	27	1220
72	Aquitaine	33	2	06	312	Parempuyre	7978	77	8055
72	Aquitaine	33	4	33	314	Pauillac	5075	131	5206
72	Aquitaine	33	5	22	315	Les Peintures	1587	21	1608
72	Aquitaine	33	3	34	316	Pellegrue	991	23	1014
72	Aquitaine	33	5	24	317	Périssac	1079	20	1099
72	Aquitaine	33	2	97	318	Pessac	58025	952	58977
72	Aquitaine	33	5	37	319	Pessac-sur-Dordogne	476	7	483
72	Aquitaine	33	5	31	320	Petit-Palais-et-Cornemps	706	10	716
72	Aquitaine	33	1	39	321	Peujard	1760	19	1779
72	Aquitaine	33	2	06	322	Le Pian-Médoc	5570	131	5701
72	Aquitaine	33	3	43	323	Le Pian-sur-Garonne	745	24	769
72	Aquitaine	33	5	41	324	Pineuilh	4417	141	4558
72	Aquitaine	33	1	07	325	Plassac	868	31	899
72	Aquitaine	33	1	40	326	Pleine-Selve	220	3	223
72	Aquitaine	33	3	36	327	Podensac	2645	31	2676
72	Aquitaine	33	5	30	328	Pomerol	715	20	735
72	Aquitaine	33	3	50	329	Pompéjac	240	12	252
72	Aquitaine	33	2	23	330	Pompignac	2649	39	2688
72	Aquitaine	33	3	03	331	Pondaurat	430	14	444
72	Aquitaine	33	5	22	332	Porchères	902	19	921
72	Aquitaine	33	4	20	333	Le Porge	2488	34	2522
72	Aquitaine	33	3	36	334	Portets	2407	28	2435
72	Aquitaine	33	2	23	335	Le Pout	464	5	469
72	Aquitaine	33	3	50	336	Préchac	1038	13	1051
72	Aquitaine	33	3	36	337	Preignac	2166	62	2228
72	Aquitaine	33	4	29	338	Prignac-en-Médoc	232	4	236
72	Aquitaine	33	1	15	339	Prignac-et-Marcamps	1368	25	1393
72	Aquitaine	33	1	15	341	Pugnac	2034	30	2064
72	Aquitaine	33	5	31	342	Puisseguin	861	24	885
72	Aquitaine	33	5	37	344	Pujols	574	10	584
72	Aquitaine	33	3	36	343	Pujols-sur-Ciron	755	18	773
72	Aquitaine	33	3	32	345	Le Puy	378	8	386
72	Aquitaine	33	3	03	346	Puybarban	413	11	424
72	Aquitaine	33	5	31	347	Puynormand	312	10	322
72	Aquitaine	33	4	29	348	Queyrac	1388	27	1415
72	Aquitaine	33	2	23	349	Quinsac	2048	35	2083
72	Aquitaine	33	5	37	350	Rauzan	1161	27	1188
72	Aquitaine	33	1	40	351	Reignac	1441	53	1494
72	Aquitaine	33	3	38	352	La Réole	4230	106	4336
72	Aquitaine	33	3	32	353	Rimons	203	2	205
72	Aquitaine	33	5	41	354	Riocaud	197	4	201
72	Aquitaine	33	3	17	355	Rions	1581	30	1611
72	Aquitaine	33	5	24	356	La Rivière	343	5	348
72	Aquitaine	33	3	28	357	Roaillan	1318	31	1349
72	Aquitaine	33	3	48	358	Romagne	427	8	435
72	Aquitaine	33	3	32	359	Roquebrune	242	5	247
72	Aquitaine	33	5	41	360	La Roquille	309	6	315
72	Aquitaine	33	3	47	361	Ruch	563	7	570
72	Aquitaine	33	5	26	362	Sablons	1295	35	1330
72	Aquitaine	33	2	23	363	Sadirac	3501	51	3552
72	Aquitaine	33	5	24	364	Saillans	375	5	380
72	Aquitaine	33	5	24	365	Saint-Aignan	230	16	246
72	Aquitaine	33	1	39	366	Saint-André-de-Cubzac	9594	215	9809
72	Aquitaine	33	3	43	367	Saint-André-du-Bois	403	9	412
72	Aquitaine	33	5	41	369	Saint-André-et-Appelles	689	24	713
72	Aquitaine	33	1	07	370	Saint-Androny	572	16	588
72	Aquitaine	33	1	39	371	Saint-Antoine	409	4	413
72	Aquitaine	33	3	34	372	Saint-Antoine-du-Queyret	85	2	87
72	Aquitaine	33	5	22	373	Saint-Antoine-sur-l;Isle	535	7	542
72	Aquitaine	33	1	40	374	Saint-Aubin-de-Blaye	783	25	808
72	Aquitaine	33	5	16	375	Saint-Aubin-de-Branne	360	6	366
72	Aquitaine	33	2	63	376	Saint-Aubin-de-Médoc	6186	166	6352
72	Aquitaine	33	5	41	377	Saint-Avit-de-Soulège	75	4	79
72	Aquitaine	33	5	41	378	Saint-Avit-Saint-Nazaire	1514	65	1579
72	Aquitaine	33	3	47	379	Saint-Brice	303	8	311
72	Aquitaine	33	1	40	380	Saint-Caprais-de-Blaye	536	14	550
72	Aquitaine	33	2	23	381	Saint-Caprais-de-Bordeaux	2717	26	2743
72	Aquitaine	33	1	44	382	Saint-Christoly-de-Blaye	1947	53	2000
72	Aquitaine	33	4	29	383	Saint-Christoly-Médoc	284	7	291
72	Aquitaine	33	5	22	385	Saint-Christophe-de-Double	663	9	672
72	Aquitaine	33	5	31	384	Saint-Christophe-des-Bardes	500	7	507
72	Aquitaine	33	5	31	386	Saint-Cibard	220	0	220
72	Aquitaine	33	5	26	387	Saint-Ciers-d;Abzac	1385	18	1403
72	Aquitaine	33	1	15	388	Saint-Ciers-de-Canesse	789	17	806
72	Aquitaine	33	1	40	389	Saint-Ciers-sur-Gironde	3085	88	3173
72	Aquitaine	33	3	04	391	Saint-Côme	296	6	302
72	Aquitaine	33	5	26	393	Saint-Denis-de-Pile	5170	136	5306
72	Aquitaine	33	5	30	394	Saint-Émilion	1984	69	2053
72	Aquitaine	33	4	33	395	Saint-Estèphe	1660	38	1698
72	Aquitaine	33	5	21	396	Saint-Étienne-de-Lisse	279	9	288
72	Aquitaine	33	3	38	398	Saint-Exupéry	159	5	164
72	Aquitaine	33	3	47	399	Saint-Félix-de-Foncaude	293	3	296
72	Aquitaine	33	3	34	400	Saint-Ferme	364	10	374
72	Aquitaine	33	1	07	405	Saint-Genès-de-Blaye	469	18	487
72	Aquitaine	33	5	21	406	Saint-Genès-de-Castillon	395	6	401
72	Aquitaine	33	5	24	407	Saint-Genès-de-Fronsac	717	9	726
72	Aquitaine	33	2	23	408	Saint-Genès-de-Lombaud	308	9	317
72	Aquitaine	33	3	48	409	Saint-Genis-du-Bois	99	6	105
72	Aquitaine	33	4	29	412	Saint-Germain-d;Esteuil	1187	8	1195
72	Aquitaine	33	3	43	411	Saint-Germain-de-Grave	144	1	145
72	Aquitaine	33	5	24	414	Saint-Germain-de-la-Rivière	367	7	374
72	Aquitaine	33	5	16	413	Saint-Germain-du-Puch	2105	39	2144
72	Aquitaine	33	1	39	415	Saint-Gervais	1568	38	1606
72	Aquitaine	33	1	44	416	Saint-Girons-d;Aiguevives	956	21	977
72	Aquitaine	33	3	38	418	Saint-Hilaire-de-la-Noaille	377	3	380
72	Aquitaine	33	3	47	419	Saint-Hilaire-du-Bois	85	3	88
72	Aquitaine	33	5	21	420	Saint-Hippolyte	162	4	166
72	Aquitaine	33	2	61	422	Saint-Jean-d;Illac	6966	128	7094
72	Aquitaine	33	5	37	421	Saint-Jean-de-Blaignac	404	13	417
72	Aquitaine	33	4	33	423	Saint-Julien-Beychevelle	679	6	685
72	Aquitaine	33	1	39	425	Saint-Laurent-d;Arce	1362	24	1386
72	Aquitaine	33	5	21	426	Saint-Laurent-des-Combes	279	4	283
72	Aquitaine	33	3	43	427	Saint-Laurent-du-Bois	239	5	244
72	Aquitaine	33	3	43	428	Saint-Laurent-du-Plan	86	2	88
72	Aquitaine	33	4	42	424	Saint-Laurent-Médoc	4221	65	4286
72	Aquitaine	33	3	45	429	Saint-Léger-de-Balson	317	4	321
72	Aquitaine	33	2	23	431	Saint-Léon	330	7	337
72	Aquitaine	33	3	28	432	Saint-Loubert	185	3	188
72	Aquitaine	33	2	19	433	Saint-Loubès	8004	185	8189
72	Aquitaine	33	2	60	434	Saint-Louis-de-Montferrand	2034	52	2086
72	Aquitaine	33	3	43	435	Saint-Macaire	1995	145	2140
72	Aquitaine	33	6	05	436	Saint-Magne	990	12	1002
72	Aquitaine	33	5	21	437	Saint-Magne-de-Castillon	1864	31	1895
72	Aquitaine	33	3	43	438	Saint-Maixant	1566	53	1619
72	Aquitaine	33	1	44	439	Saint-Mariens	1510	17	1527
72	Aquitaine	33	3	43	440	Saint-Martial	208	3	211
72	Aquitaine	33	5	26	442	Saint-Martin-de-Laye	501	7	508
72	Aquitaine	33	3	47	443	Saint-Martin-de-Lerm	140	2	142
72	Aquitaine	33	3	43	444	Saint-Martin-de-Sescas	524	7	531
72	Aquitaine	33	5	26	445	Saint-Martin-du-Bois	821	16	837
72	Aquitaine	33	3	47	446	Saint-Martin-du-Puy	200	4	204
72	Aquitaine	33	1	07	441	Saint-Martin-Lacaussade	1018	110	1128
72	Aquitaine	33	2	27	448	Saint-Médard-d;Eyrans	2802	111	2913
72	Aquitaine	33	5	22	447	Saint-Médard-de-Guizières	2390	26	2416
72	Aquitaine	33	2	63	449	Saint-Médard-en-Jalles	27719	677	28396
72	Aquitaine	33	3	18	450	Saint-Michel-de-Castelnau	241	7	248
72	Aquitaine	33	5	24	451	Saint-Michel-de-Fronsac	538	15	553
72	Aquitaine	33	3	38	453	Saint-Michel-de-Lapujade	193	3	196
72	Aquitaine	33	3	36	452	Saint-Michel-de-Rieufret	547	11	558
72	Aquitaine	33	2	27	454	Saint-Morillon	1493	26	1519
72	Aquitaine	33	1	40	456	Saint-Palais	486	18	504
72	Aquitaine	33	3	28	457	Saint-Pardon-de-Conques	540	14	554
72	Aquitaine	33	1	07	458	Saint-Paul	956	19	975
72	Aquitaine	33	5	21	459	Saint-Pey-d;Armens	261	1	262
72	Aquitaine	33	5	37	460	Saint-Pey-de-Castets	634	15	649
72	Aquitaine	33	5	21	461	Saint-Philippe-d;Aiguille	415	15	430
72	Aquitaine	33	5	41	462	Saint-Philippe-du-Seignal	461	11	472
72	Aquitaine	33	3	43	463	Saint-Pierre-d;Aurillac	1313	45	1358
72	Aquitaine	33	3	48	464	Saint-Pierre-de-Bat	314	12	326
72	Aquitaine	33	3	28	465	Saint-Pierre-de-Mons	1077	38	1115
72	Aquitaine	33	5	16	466	Saint-Quentin-de-Baron	1934	22	1956
72	Aquitaine	33	5	41	467	Saint-Quentin-de-Caplong	248	11	259
72	Aquitaine	33	5	24	470	Saint-Romain-la-Virvée	787	19	806
72	Aquitaine	33	4	33	471	Saint-Sauveur	1262	27	1289
72	Aquitaine	33	5	31	472	Saint-Sauveur-de-Puynormand	407	4	411
72	Aquitaine	33	1	44	473	Saint-Savin	2834	37	2871
72	Aquitaine	33	2	27	474	Saint-Selve	2095	31	2126
72	Aquitaine	33	1	15	475	Saint-Seurin-de-Bourg	331	10	341
72	Aquitaine	33	4	33	476	Saint-Seurin-de-Cadourne	714	15	729
72	Aquitaine	33	1	07	477	Saint-Seurin-de-Cursac	707	20	727
72	Aquitaine	33	5	22	478	Saint-Seurin-sur-l;Isle	3053	61	3114
72	Aquitaine	33	3	38	479	Saint-Sève	213	6	219
72	Aquitaine	33	5	30	480	Saint-Sulpice-de-Faleyrens	1485	118	1603
72	Aquitaine	33	3	32	481	Saint-Sulpice-de-Guilleragues	217	2	219
72	Aquitaine	33	3	47	482	Saint-Sulpice-de-Pommiers	226	1	227
72	Aquitaine	33	2	19	483	Saint-Sulpice-et-Cameyrac	4339	74	4413
72	Aquitaine	33	3	45	484	Saint-Symphorien	1742	36	1778
72	Aquitaine	33	1	15	486	Saint-Trojan	323	6	329
72	Aquitaine	33	2	19	487	Saint-Vincent-de-Paul	1050	24	1074
72	Aquitaine	33	5	37	488	Saint-Vincent-de-Pertignas	364	8	372
72	Aquitaine	33	1	44	489	Saint-Vivien-de-Blaye	350	3	353
72	Aquitaine	33	4	46	490	Saint-Vivien-de-Médoc	1615	24	1639
72	Aquitaine	33	3	32	491	Saint-Vivien-de-Monségur	385	7	392
72	Aquitaine	33	1	44	492	Saint-Yzan-de-Soudiac	2186	17	2203
72	Aquitaine	33	4	29	493	Saint-Yzans-de-Médoc	397	54	451
72	Aquitaine	33	5	21	390	Sainte-Colombe	467	3	470
72	Aquitaine	33	3	17	392	Sainte-Croix-du-Mont	899	25	924
72	Aquitaine	33	2	19	397	Sainte-Eulalie	4632	62	4694
72	Aquitaine	33	5	37	401	Sainte-Florence	126	2	128
72	Aquitaine	33	5	41	402	Sainte-Foy-la-Grande	2474	42	2516
72	Aquitaine	33	3	43	403	Sainte-Foy-la-Longue	135	4	139
72	Aquitaine	33	3	32	404	Sainte-Gemme	243	1	244
72	Aquitaine	33	4	20	417	Sainte-Hélène	2648	27	2675
72	Aquitaine	33	5	37	468	Sainte-Radegonde	459	14	473
72	Aquitaine	33	5	21	485	Sainte-Terre	1834	34	1868
72	Aquitaine	33	4	20	494	Salaunes	779	9	788
72	Aquitaine	33	1	39	495	Salignac	1443	26	1469
72	Aquitaine	33	2	23	496	Salleboeuf	2223	18	2241
72	Aquitaine	33	6	05	498	Salles	6158	86	6244
72	Aquitaine	33	5	21	499	Les Salles-de-Castillon	390	3	393
72	Aquitaine	33	1	15	500	Samonac	426	6	432
72	Aquitaine	33	2	27	501	Saucats	2136	30	2166
72	Aquitaine	33	1	44	502	Saugon	405	3	408
72	Aquitaine	33	4	20	503	Saumos	556	2	558
72	Aquitaine	33	3	28	504	Sauternes	732	10	742
72	Aquitaine	33	2	23	505	La Sauve	1417	59	1476
72	Aquitaine	33	3	47	506	Sauveterre-de-Guyenne	1811	37	1848
72	Aquitaine	33	3	04	507	Sauviac	334	6	340
72	Aquitaine	33	3	03	508	Savignac	600	11	611
72	Aquitaine	33	5	26	509	Savignac-de-l;Isle	510	5	515
72	Aquitaine	33	3	43	510	Semens	207	7	214
72	Aquitaine	33	3	25	511	Sendets	328	8	336
72	Aquitaine	33	3	03	512	Sigalens	356	14	370
72	Aquitaine	33	3	25	513	Sillas	113	4	117
72	Aquitaine	33	4	46	514	Soulac-sur-Mer	2645	48	2693
72	Aquitaine	33	3	48	515	Soulignac	450	11	461
72	Aquitaine	33	3	34	516	Soussac	179	2	181
72	Aquitaine	33	4	20	517	Soussans	1544	20	1564
72	Aquitaine	33	2	23	518	Tabanac	1056	14	1070
72	Aquitaine	33	2	63	519	Le Taillan-Médoc	9099	116	9215
72	Aquitaine	33	3	32	520	Taillecavat	308	9	317
72	Aquitaine	33	4	46	521	Talais	662	7	669
72	Aquitaine	33	2	56	522	Talence	40600	1371	41971
72	Aquitaine	33	3	48	523	Targon	1851	23	1874
72	Aquitaine	33	5	24	524	Tarnès	266	4	270
72	Aquitaine	33	1	15	525	Tauriac	1301	20	1321
72	Aquitaine	33	5	31	526	Tayac	144	5	149
72	Aquitaine	33	6	49	527	Le Teich	6586	122	6708
72	Aquitaine	33	4	20	528	Le Temple	524	8	532
72	Aquitaine	33	6	49	529	La Teste-de-Buch	24591	427	25018
72	Aquitaine	33	1	15	530	Teuillac	778	15	793
72	Aquitaine	33	5	16	531	Tizac-de-Curton	287	7	294
72	Aquitaine	33	5	26	532	Tizac-de-Lapouyade	490	5	495
72	Aquitaine	33	3	28	533	Toulenne	2582	70	2652
72	Aquitaine	33	2	23	534	Le Tourne	763	11	774
72	Aquitaine	33	2	58	535	Tresses	4155	65	4220
72	Aquitaine	33	3	45	536	Le Tuzan	225	0	225
72	Aquitaine	33	3	50	537	Uzeste	449	15	464
72	Aquitaine	33	4	29	538	Valeyrac	525	2	527
72	Aquitaine	33	5	30	539	Vayres	3429	45	3474
72	Aquitaine	33	4	29	540	Vendays-Montalivet	2384	41	2425
72	Aquitaine	33	4	46	541	Vensac	880	11	891
72	Aquitaine	33	5	24	542	Vérac	820	15	835
72	Aquitaine	33	3	43	543	Verdelais	919	24	943
72	Aquitaine	33	4	46	544	Le Verdon-sur-Mer	1356	29	1385
72	Aquitaine	33	4	33	545	Vertheuil	1226	21	1247
72	Aquitaine	33	5	21	546	Vignonet	541	26	567
72	Aquitaine	33	3	50	547	Villandraut	969	19	988
72	Aquitaine	33	5	24	548	Villegouge	1237	22	1259
72	Aquitaine	33	2	57	550	Villenave-d;Ornon	28420	485	28905
72	Aquitaine	33	3	17	549	Villenave-de-Rions	315	8	323
72	Aquitaine	33	1	15	551	Villeneuve	391	10	401
72	Aquitaine	33	3	36	552	Virelade	922	13	935
72	Aquitaine	33	1	39	553	Virsac	992	26	1018
72	Aquitaine	33	2	55	554	Yvrac	2534	26	2560
91	Languedoc-Roussillon	34	1	35	001	Abeilhan	1355	27	1382
91	Languedoc-Roussillon	34	1	21	002	Adissan	966	17	983
91	Languedoc-Roussillon	34	1	01	003	Agde	24567	405	24972
91	Languedoc-Roussillon	34	1	30	004	Agel	219	7	226
91	Languedoc-Roussillon	34	2	13	005	Agonès	241	9	250
91	Languedoc-Roussillon	34	1	27	006	Aigne	265	4	269
91	Languedoc-Roussillon	34	1	30	007	Aigues-Vives	429	2	431
91	Languedoc-Roussillon	34	1	31	008	Les Aires	572	16	588
91	Languedoc-Roussillon	34	1	35	009	Alignan-du-Vent	1575	21	1596
91	Languedoc-Roussillon	34	2	02	010	Aniane	2773	64	2837
91	Languedoc-Roussillon	34	2	14	011	Arboras	99	2	101
91	Languedoc-Roussillon	34	2	02	012	Argelliers	890	14	904
91	Languedoc-Roussillon	34	2	10	013	Aspiran	1446	34	1480
91	Languedoc-Roussillon	34	3	07	014	Assas	1529	43	1572
91	Languedoc-Roussillon	34	1	30	015	Assignan	180	5	185
91	Languedoc-Roussillon	34	2	14	016	Aumelas	489	7	496
91	Languedoc-Roussillon	34	1	21	017	Aumes	440	14	454
91	Languedoc-Roussillon	34	1	25	018	Autignac	852	12	864
91	Languedoc-Roussillon	34	2	16	019	Avène	305	5	310
91	Languedoc-Roussillon	34	1	27	020	Azillanet	420	15	435
91	Languedoc-Roussillon	34	1	30	021	Babeau-Bouldoux	293	10	303
91	Languedoc-Roussillon	34	3	07	022	Baillargues	6206	115	6321
91	Languedoc-Roussillon	34	3	12	024	Balaruc-le-Vieux	2069	44	2113
91	Languedoc-Roussillon	34	3	12	023	Balaruc-les-Bains	6868	82	6950
91	Languedoc-Roussillon	34	1	05	025	Bassan	1667	33	1700
91	Languedoc-Roussillon	34	1	27	026	Beaufort	189	2	191
91	Languedoc-Roussillon	34	3	07	027	Beaulieu	1698	17	1715
91	Languedoc-Roussillon	34	1	03	028	Bédarieux	6453	262	6715
91	Languedoc-Roussillon	34	2	14	029	Bélarga	445	6	451
91	Languedoc-Roussillon	34	1	26	030	Berlou	191	2	193
91	Languedoc-Roussillon	34	1	01	031	Bessan	4585	64	4649
91	Languedoc-Roussillon	34	1	98	032	Béziers	70955	1511	72466
91	Languedoc-Roussillon	34	3	17	033	Boisseron	1719	36	1755
91	Languedoc-Roussillon	34	1	33	034	Boisset	26	0	26
91	Languedoc-Roussillon	34	2	02	035	La Boissière	917	12	929
91	Languedoc-Roussillon	34	2	15	036	Le Bosc	1210	27	1237
91	Languedoc-Roussillon	34	1	05	037	Boujan-sur-Libron	3121	66	3187
91	Languedoc-Roussillon	34	2	16	038	Le Bousquet-d;Orb	1604	29	1633
91	Languedoc-Roussillon	34	3	20	039	Bouzigues	1626	35	1661
91	Languedoc-Roussillon	34	2	16	040	Brenas	47	2	49
91	Languedoc-Roussillon	34	2	10	041	Brignac	714	13	727
91	Languedoc-Roussillon	34	2	13	042	Brissac	618	19	637
91	Languedoc-Roussillon	34	3	07	043	Buzignargues	261	5	266
91	Languedoc-Roussillon	34	1	25	044	Cabrerolles	363	4	367
91	Languedoc-Roussillon	34	1	21	045	Cabrières	478	18	496
91	Languedoc-Roussillon	34	1	26	046	Cambon-et-Salvergues	61	2	63
91	Languedoc-Roussillon	34	2	14	047	Campagnan	550	10	560
91	Languedoc-Roussillon	34	3	09	048	Campagne	271	3	274
91	Languedoc-Roussillon	34	1	03	049	Camplong	241	8	249
91	Languedoc-Roussillon	34	3	19	050	Candillargues	1401	17	1418
91	Languedoc-Roussillon	34	2	10	051	Canet	3315	47	3362
91	Languedoc-Roussillon	34	1	06	052	Capestang	3033	51	3084
91	Languedoc-Roussillon	34	1	03	053	Carlencas-et-Levas	124	0	124
91	Languedoc-Roussillon	34	1	27	054	Cassagnoles	92	4	96
91	Languedoc-Roussillon	34	1	31	055	Castanet-le-Haut	187	2	189
91	Languedoc-Roussillon	34	1	11	056	Castelnau-de-Guers	1123	28	1151
91	Languedoc-Roussillon	34	3	47	057	Castelnau-le-Lez	14948	378	15326
91	Languedoc-Roussillon	34	3	07	058	Castries	5752	80	5832
91	Languedoc-Roussillon	34	1	27	059	La Caunette	328	5	333
91	Languedoc-Roussillon	34	2	32	060	Causse-de-la-Selle	337	13	350
91	Languedoc-Roussillon	34	1	25	061	Causses-et-Veyran	633	8	641
91	Languedoc-Roussillon	34	1	25	062	Caussiniojouls	128	4	132
91	Languedoc-Roussillon	34	1	28	063	Caux	2509	58	2567
91	Languedoc-Roussillon	34	2	08	064	Le Caylar	442	5	447
91	Languedoc-Roussillon	34	1	30	065	Cazedarnes	534	8	542
91	Languedoc-Roussillon	34	3	18	066	Cazevieille	184	6	190
91	Languedoc-Roussillon	34	2	13	067	Cazilhac	1310	36	1346
91	Languedoc-Roussillon	34	1	21	068	Cazouls-d;Hérault	329	8	337
91	Languedoc-Roussillon	34	1	38	069	Cazouls-lès-Béziers	4461	75	4536
91	Languedoc-Roussillon	34	1	30	070	Cébazan	548	9	557
91	Languedoc-Roussillon	34	2	16	071	Ceilhes-et-Rocozels	307	7	314
91	Languedoc-Roussillon	34	2	10	072	Celles	23	1	24
91	Languedoc-Roussillon	34	1	05	073	Cers	2191	26	2217
91	Languedoc-Roussillon	34	1	30	074	Cessenon-sur-Orb	2066	24	2090
91	Languedoc-Roussillon	34	1	27	075	Cesseras	372	13	385
91	Languedoc-Roussillon	34	2	10	076	Ceyras	1100	26	1126
91	Languedoc-Roussillon	34	3	23	077	Clapiers	5200	131	5331
91	Languedoc-Roussillon	34	3	09	078	Claret	1389	28	1417
91	Languedoc-Roussillon	34	2	10	079	Clermont-l;Hérault	8018	136	8154
91	Languedoc-Roussillon	34	1	26	080	Colombières-sur-Orb	471	19	490
91	Languedoc-Roussillon	34	1	38	081	Colombiers	2335	50	2385
91	Languedoc-Roussillon	34	3	18	082	Combaillaux	1430	36	1466
91	Languedoc-Roussillon	34	1	31	083	Combes	329	6	335
91	Languedoc-Roussillon	34	1	38	084	Corneilhan	1596	37	1633
91	Languedoc-Roussillon	34	1	35	085	Coulobres	354	11	365
91	Languedoc-Roussillon	34	1	33	086	Courniou	607	17	624
91	Languedoc-Roussillon	34	3	49	087	Cournonsec	2389	32	2421
91	Languedoc-Roussillon	34	3	49	088	Cournonterral	5939	61	6000
91	Languedoc-Roussillon	34	1	06	089	Creissan	1295	28	1323
91	Languedoc-Roussillon	34	3	47	090	Le Crès	8005	114	8119
91	Languedoc-Roussillon	34	2	08	091	Le Cros	48	2	50
91	Languedoc-Roussillon	34	1	30	092	Cruzy	971	13	984
91	Languedoc-Roussillon	34	2	16	093	Dio-et-Valquières	152	7	159
91	Languedoc-Roussillon	34	1	35	094	Espondeilhan	970	27	997
91	Languedoc-Roussillon	34	3	49	095	Fabrègues	6236	118	6354
91	Languedoc-Roussillon	34	1	03	096	Faugères	551	13	564
91	Languedoc-Roussillon	34	1	27	097	Félines-Minervois	428	9	437
91	Languedoc-Roussillon	34	1	27	098	Ferrals-les-Montagnes	144	8	152
91	Languedoc-Roussillon	34	3	09	099	Ferrières-les-Verreries	63	2	65
91	Languedoc-Roussillon	34	1	26	100	Ferrières-Poussarou	66	0	66
91	Languedoc-Roussillon	34	1	11	101	Florensac	4882	109	4991
91	Languedoc-Roussillon	34	3	09	102	Fontanès	282	11	293
91	Languedoc-Roussillon	34	1	21	103	Fontès	955	26	981
91	Languedoc-Roussillon	34	1	29	104	Fos	120	0	120
91	Languedoc-Roussillon	34	1	29	105	Fouzilhon	219	6	225
91	Languedoc-Roussillon	34	2	15	106	Fozières	182	5	187
91	Languedoc-Roussillon	34	1	34	107	Fraisse-sur-Agout	346	6	352
91	Languedoc-Roussillon	34	3	12	108	Frontignan	22526	217	22743
91	Languedoc-Roussillon	34	1	29	109	Gabian	820	18	838
91	Languedoc-Roussillon	34	3	07	110	Galargues	651	13	664
91	Languedoc-Roussillon	34	2	13	111	Ganges	4083	101	4184
91	Languedoc-Roussillon	34	3	09	112	Garrigues	167	7	174
91	Languedoc-Roussillon	34	3	20	113	Gigean	5687	60	5747
91	Languedoc-Roussillon	34	2	14	114	Gignac	5447	88	5535
91	Languedoc-Roussillon	34	2	13	115	Gorniès	112	3	115
91	Languedoc-Roussillon	34	3	46	116	Grabels	6393	128	6521
91	Languedoc-Roussillon	34	1	03	117	Graissessac	708	2	710
91	Languedoc-Roussillon	34	3	19	344	La Grande-Motte	8440	128	8568
91	Languedoc-Roussillon	34	3	07	118	Guzargues	477	8	485
91	Languedoc-Roussillon	34	1	31	119	Hérépian	1474	19	1493
91	Languedoc-Roussillon	34	3	07	120	Jacou	4902	113	5015
91	Languedoc-Roussillon	34	2	16	121	Joncels	294	5	299
91	Languedoc-Roussillon	34	2	14	122	Jonquières	391	8	399
91	Languedoc-Roussillon	34	3	46	123	Juvignac	7466	124	7590
91	Languedoc-Roussillon	34	2	10	124	Lacoste	295	6	301
91	Languedoc-Roussillon	34	2	14	125	Lagamas	114	6	120
91	Languedoc-Roussillon	34	1	31	126	Lamalou-les-Bains	2438	30	2468
91	Languedoc-Roussillon	34	3	19	127	Lansargues	2744	29	2773
91	Languedoc-Roussillon	34	2	13	128	Laroque	1479	41	1520
91	Languedoc-Roussillon	34	3	48	129	Lattes	15927	239	16166
91	Languedoc-Roussillon	34	1	25	130	Laurens	1436	14	1450
91	Languedoc-Roussillon	34	3	09	131	Lauret	563	15	578
91	Languedoc-Roussillon	34	2	15	132	Lauroux	203	4	207
91	Languedoc-Roussillon	34	2	16	133	Lavalette	57	0	57
91	Languedoc-Roussillon	34	3	44	134	Lavérune	2735	54	2789
91	Languedoc-Roussillon	34	1	38	135	Lespignan	3120	52	3172
91	Languedoc-Roussillon	34	1	21	136	Lézignan-la-Cèbe	1429	15	1444
91	Languedoc-Roussillon	34	2	10	137	Liausson	156	5	161
91	Languedoc-Roussillon	34	1	21	138	Lieuran-Cabrières	279	12	291
91	Languedoc-Roussillon	34	1	05	139	Lieuran-lès-Béziers	1362	28	1390
91	Languedoc-Roussillon	34	1	38	140	Lignan-sur-Orb	2897	81	2978
91	Languedoc-Roussillon	34	1	27	141	La Livinière	546	11	557
91	Languedoc-Roussillon	34	2	15	142	Lodève	7512	232	7744
91	Languedoc-Roussillon	34	3	20	143	Loupian	2092	39	2131
91	Languedoc-Roussillon	34	2	16	144	Lunas	651	6	657
91	Languedoc-Roussillon	34	3	17	145	Lunel	25277	232	25509
91	Languedoc-Roussillon	34	3	17	146	Lunel-Viel	3706	66	3772
91	Languedoc-Roussillon	34	1	29	147	Magalas	2977	41	3018
91	Languedoc-Roussillon	34	1	38	148	Maraussan	3757	84	3841
91	Languedoc-Roussillon	34	1	29	149	Margon	550	5	555
91	Languedoc-Roussillon	34	1	01	150	Marseillan	7883	113	7996
91	Languedoc-Roussillon	34	3	17	151	Marsillargues	6088	81	6169
91	Languedoc-Roussillon	34	2	32	152	Mas-de-Londres	482	5	487
91	Languedoc-Roussillon	34	3	18	153	Les Matelles	1677	38	1715
91	Languedoc-Roussillon	34	3	19	154	Mauguio	16307	197	16504
91	Languedoc-Roussillon	34	1	06	155	Maureilhan	1893	40	1933
91	Languedoc-Roussillon	34	2	16	156	Mérifons	48	4	52
91	Languedoc-Roussillon	34	3	20	157	Mèze	10523	145	10668
91	Languedoc-Roussillon	34	1	27	158	Minerve	130	1	131
91	Languedoc-Roussillon	34	3	12	159	Mireval	3275	38	3313
91	Languedoc-Roussillon	34	1	26	160	Mons	581	4	585
91	Languedoc-Roussillon	34	1	06	161	Montady	3959	62	4021
91	Languedoc-Roussillon	34	1	21	162	Montagnac	3593	52	3645
91	Languedoc-Roussillon	34	2	02	163	Montarnaud	2524	55	2579
91	Languedoc-Roussillon	34	3	07	164	Montaud	906	14	920
91	Languedoc-Roussillon	34	3	20	165	Montbazin	2968	33	3001
91	Languedoc-Roussillon	34	1	35	166	Montblanc	2594	43	2637
91	Languedoc-Roussillon	34	1	06	167	Montels	246	3	249
91	Languedoc-Roussillon	34	1	29	168	Montesquieu	65	0	65
91	Languedoc-Roussillon	34	3	23	169	Montferrier-sur-Lez	3385	124	3509
91	Languedoc-Roussillon	34	1	30	170	Montouliers	238	5	243
91	Languedoc-Roussillon	34	2	13	171	Montoulieu	153	2	155
91	Languedoc-Roussillon	34	3	99	172	Montpellier	257351	3221	260572
91	Languedoc-Roussillon	34	2	14	173	Montpeyroux	1227	43	1270
91	Languedoc-Roussillon	34	2	13	174	Moulès-et-Baucels	850	18	868
91	Languedoc-Roussillon	34	2	10	175	Mourèze	175	2	177
91	Languedoc-Roussillon	34	3	19	176	Mudaison	2498	24	2522
91	Languedoc-Roussillon	34	3	18	177	Murles	294	8	302
91	Languedoc-Roussillon	34	1	25	178	Murviel-lès-Béziers	2840	47	2887
91	Languedoc-Roussillon	34	3	49	179	Murviel-lès-Montpellier	1911	38	1949
91	Languedoc-Roussillon	34	2	10	180	Nébian	1233	36	1269
91	Languedoc-Roussillon	34	1	29	181	Neffiès	993	22	1015
91	Languedoc-Roussillon	34	1	28	182	Nézignan-l;Évêque	1520	23	1543
91	Languedoc-Roussillon	34	1	06	183	Nissan-lez-Enserune	3652	68	3720
91	Languedoc-Roussillon	34	1	21	184	Nizas	582	15	597
91	Languedoc-Roussillon	34	2	32	185	Notre-Dame-de-Londres	479	12	491
91	Languedoc-Roussillon	34	2	16	186	Octon	453	6	459
91	Languedoc-Roussillon	34	1	26	187	Olargues	627	6	633
91	Languedoc-Roussillon	34	2	15	188	Olmet-et-Villecun	146	2	148
91	Languedoc-Roussillon	34	1	27	189	Olonzac	1683	25	1708
91	Languedoc-Roussillon	34	1	27	190	Oupia	285	3	288
91	Languedoc-Roussillon	34	1	25	191	Pailhès	470	8	478
91	Languedoc-Roussillon	34	3	48	192	Palavas-les-Flots	5995	65	6060
91	Languedoc-Roussillon	34	1	33	193	Pardailhan	184	7	191
91	Languedoc-Roussillon	34	2	10	194	Paulhan	3648	53	3701
91	Languedoc-Roussillon	34	2	32	195	Pégairolles-de-Buèges	49	0	49
91	Languedoc-Roussillon	34	2	08	196	Pégairolles-de-l;Escalette	145	1	146
91	Languedoc-Roussillon	34	1	21	197	Péret	887	14	901
91	Languedoc-Roussillon	34	3	48	198	Pérols	8509	135	8644
91	Languedoc-Roussillon	34	1	28	199	Pézenas	8251	366	8617
91	Languedoc-Roussillon	34	1	03	200	Pézènes-les-Mines	244	4	248
91	Languedoc-Roussillon	34	1	30	201	Pierrerue	287	1	288
91	Languedoc-Roussillon	34	3	49	202	Pignan	6366	108	6474
91	Languedoc-Roussillon	34	1	11	203	Pinet	1402	13	1415
91	Languedoc-Roussillon	34	2	14	204	Plaissan	899	13	912
91	Languedoc-Roussillon	34	2	15	205	Les Plans	292	10	302
91	Languedoc-Roussillon	34	1	06	206	Poilhes	554	12	566
91	Languedoc-Roussillon	34	1	11	207	Pomérols	2177	29	2206
91	Languedoc-Roussillon	34	2	14	208	Popian	360	13	373
91	Languedoc-Roussillon	34	1	05	209	Portiragnes	3160	66	3226
91	Languedoc-Roussillon	34	2	14	210	Le Pouget	1819	44	1863
91	Languedoc-Roussillon	34	1	31	211	Le Poujol-sur-Orb	1024	27	1051
91	Languedoc-Roussillon	34	2	15	212	Poujols	152	2	154
91	Languedoc-Roussillon	34	3	20	213	Poussan	5224	48	5272
91	Languedoc-Roussillon	34	1	29	214	Pouzolles	1060	15	1075
91	Languedoc-Roussillon	34	2	14	215	Pouzols	842	20	862
91	Languedoc-Roussillon	34	1	03	216	Le Pradal	280	13	293
91	Languedoc-Roussillon	34	3	18	217	Prades-le-Lez	4534	109	4643
91	Languedoc-Roussillon	34	1	30	218	Prades-sur-Vernazobre	279	8	287
91	Languedoc-Roussillon	34	1	26	219	Prémian	544	23	567
91	Languedoc-Roussillon	34	2	15	220	Le Puech	225	7	232
91	Languedoc-Roussillon	34	2	02	221	Puéchabon	458	16	474
91	Languedoc-Roussillon	34	2	14	222	Puilacher	364	14	378
91	Languedoc-Roussillon	34	1	25	223	Puimisson	1003	20	1023
91	Languedoc-Roussillon	34	1	35	224	Puissalicon	1117	12	1129
91	Languedoc-Roussillon	34	1	06	225	Puisserguier	2853	44	2897
91	Languedoc-Roussillon	34	1	06	226	Quarante	1609	22	1631
91	Languedoc-Roussillon	34	3	07	227	Restinclières	1554	13	1567
91	Languedoc-Roussillon	34	1	33	228	Rieussec	91	1	92
91	Languedoc-Roussillon	34	1	33	229	Riols	750	23	773
91	Languedoc-Roussillon	34	2	08	230	Les Rives	121	0	121
91	Languedoc-Roussillon	34	2	16	231	Romiguières	27	0	27
91	Languedoc-Roussillon	34	1	26	232	Roquebrun	554	13	567
91	Languedoc-Roussillon	34	2	16	233	Roqueredonde	245	0	245
91	Languedoc-Roussillon	34	1	29	234	Roquessels	123	1	124
91	Languedoc-Roussillon	34	1	31	235	Rosis	304	2	306
91	Languedoc-Roussillon	34	2	32	236	Rouet	58	2	60
91	Languedoc-Roussillon	34	1	29	237	Roujan	1931	22	1953
91	Languedoc-Roussillon	34	2	32	238	Saint-André-de-Buèges	55	2	57
91	Languedoc-Roussillon	34	2	14	239	Saint-André-de-Sangonis	5319	83	5402
91	Languedoc-Roussillon	34	3	19	240	Saint-Aunès	3041	66	3107
91	Languedoc-Roussillon	34	2	14	241	Saint-Bauzille-de-la-Sylve	830	21	851
91	Languedoc-Roussillon	34	3	18	242	Saint-Bauzille-de-Montmel	940	23	963
91	Languedoc-Roussillon	34	2	13	243	Saint-Bauzille-de-Putois	1593	47	1640
91	Languedoc-Roussillon	34	3	07	244	Saint-Brès	2659	32	2691
91	Languedoc-Roussillon	34	1	30	245	Saint-Chinian	1829	33	1862
91	Languedoc-Roussillon	34	3	17	246	Saint-Christol	1441	21	1462
91	Languedoc-Roussillon	34	3	18	247	Saint-Clément-de-Rivière	4987	269	5256
91	Languedoc-Roussillon	34	3	07	249	Saint-Drézéry	2156	48	2204
91	Languedoc-Roussillon	34	1	26	250	Saint-Étienne-d;Albagnan	301	5	306
91	Languedoc-Roussillon	34	2	15	251	Saint-Étienne-de-Gourgas	450	3	453
91	Languedoc-Roussillon	34	1	03	252	Saint-Étienne-Estréchoux	244	8	252
91	Languedoc-Roussillon	34	2	08	253	Saint-Félix-de-l;Héras	35	0	35
91	Languedoc-Roussillon	34	2	10	254	Saint-Félix-de-Lodez	1142	28	1170
91	Languedoc-Roussillon	34	3	18	255	Saint-Gély-du-Fesc	8821	286	9107
91	Languedoc-Roussillon	34	1	25	258	Saint-Geniès-de-Fontedit	1389	17	1406
91	Languedoc-Roussillon	34	1	31	257	Saint-Geniès-de-Varensal	190	4	194
91	Languedoc-Roussillon	34	3	07	256	Saint-Geniès-des-Mourgues	1692	41	1733
91	Languedoc-Roussillon	34	3	49	259	Saint-Georges-d;Orques	5343	90	5433
91	Languedoc-Roussillon	34	1	31	260	Saint-Gervais-sur-Mare	861	20	881
91	Languedoc-Roussillon	34	2	02	261	Saint-Guilhem-le-Désert	269	2	271
91	Languedoc-Roussillon	34	2	14	262	Saint-Guiraud	211	3	214
91	Languedoc-Roussillon	34	3	07	263	Saint-Hilaire-de-Beauvoir	365	13	378
91	Languedoc-Roussillon	34	2	32	264	Saint-Jean-de-Buèges	206	1	207
91	Languedoc-Roussillon	34	3	07	265	Saint-Jean-de-Cornies	673	12	685
91	Languedoc-Roussillon	34	3	18	266	Saint-Jean-de-Cuculles	468	6	474
91	Languedoc-Roussillon	34	2	14	267	Saint-Jean-de-Fos	1533	23	1556
91	Languedoc-Roussillon	34	2	15	268	Saint-Jean-de-la-Blaquière	569	9	578
91	Languedoc-Roussillon	34	1	33	269	Saint-Jean-de-Minervois	143	0	143
91	Languedoc-Roussillon	34	3	44	270	Saint-Jean-de-Védas	8716	244	8960
91	Languedoc-Roussillon	34	1	26	271	Saint-Julien	207	6	213
91	Languedoc-Roussillon	34	3	17	272	Saint-Just	2851	40	2891
91	Languedoc-Roussillon	34	1	26	273	Saint-Martin-de-l;Arçon	125	3	128
91	Languedoc-Roussillon	34	2	32	274	Saint-Martin-de-Londres	2370	43	2413
91	Languedoc-Roussillon	34	3	18	276	Saint-Mathieu-de-Tréviers	4686	102	4788
91	Languedoc-Roussillon	34	2	08	277	Saint-Maurice-Navacelles	156	5	161
91	Languedoc-Roussillon	34	2	08	278	Saint-Michel	57	3	60
91	Languedoc-Roussillon	34	1	25	279	Saint-Nazaire-de-Ladarez	343	6	349
91	Languedoc-Roussillon	34	3	17	280	Saint-Nazaire-de-Pézan	576	10	586
91	Languedoc-Roussillon	34	2	14	281	Saint-Pargoire	2053	31	2084
91	Languedoc-Roussillon	34	2	02	282	Saint-Paul-et-Valmalle	1020	18	1038
91	Languedoc-Roussillon	34	2	15	283	Saint-Pierre-de-la-Fage	113	4	117
91	Languedoc-Roussillon	34	1	21	285	Saint-Pons-de-Mauchiens	656	6	662
91	Languedoc-Roussillon	34	1	33	284	Saint-Pons-de-Thomières	2062	179	2241
91	Languedoc-Roussillon	34	2	15	286	Saint-Privat	405	10	415
91	Languedoc-Roussillon	34	2	14	287	Saint-Saturnin-de-Lucian	308	3	311
91	Languedoc-Roussillon	34	3	17	288	Saint-Sériès	887	26	913
91	Languedoc-Roussillon	34	1	28	289	Saint-Thibéry	2344	51	2395
91	Languedoc-Roussillon	34	1	26	291	Saint-Vincent-d;Olargues	325	11	336
91	Languedoc-Roussillon	34	3	18	290	Saint-Vincent-de-Barbeyrargues	689	24	713
91	Languedoc-Roussillon	34	3	18	248	Sainte-Croix-de-Quintillargues	606	19	625
91	Languedoc-Roussillon	34	2	10	292	Salasc	276	9	285
91	Languedoc-Roussillon	34	1	34	293	La Salvetat-sur-Agout	1178	29	1207
91	Languedoc-Roussillon	34	3	17	294	Saturargues	891	11	902
91	Languedoc-Roussillon	34	3	49	295	Saussan	1482	41	1523
91	Languedoc-Roussillon	34	3	17	296	Saussines	951	15	966
91	Languedoc-Roussillon	34	3	09	297	Sauteyrargues	354	7	361
91	Languedoc-Roussillon	34	1	39	298	Sauvian	4153	64	4217
91	Languedoc-Roussillon	34	1	39	299	Sérignan	6685	148	6833
91	Languedoc-Roussillon	34	1	35	300	Servian	4193	72	4265
91	Languedoc-Roussillon	34	3	97	301	Sète	42774	662	43436
91	Languedoc-Roussillon	34	1	27	302	Siran	683	8	691
91	Languedoc-Roussillon	34	2	08	303	Sorbs	38	0	38
91	Languedoc-Roussillon	34	2	15	304	Soubès	889	15	904
91	Languedoc-Roussillon	34	1	34	305	Le Soulié	114	1	115
91	Languedoc-Roussillon	34	2	15	306	Soumont	160	0	160
91	Languedoc-Roussillon	34	3	07	307	Sussargues	2567	66	2633
91	Languedoc-Roussillon	34	1	31	308	Taussac-la-Billière	474	17	491
91	Languedoc-Roussillon	34	3	07	309	Teyran	4427	120	4547
91	Languedoc-Roussillon	34	1	25	310	Thézan-lès-Béziers	2667	41	2708
91	Languedoc-Roussillon	34	1	03	312	La Tour-sur-Orb	1229	31	1260
91	Languedoc-Roussillon	34	1	28	311	Tourbes	1521	172	1693
91	Languedoc-Roussillon	34	2	14	313	Tressan	539	9	548
91	Languedoc-Roussillon	34	3	18	314	Le Triadou	403	9	412
91	Languedoc-Roussillon	34	1	21	315	Usclas-d;Hérault	296	7	303
91	Languedoc-Roussillon	34	2	15	316	Usclas-du-Bosc	126	5	131
91	Languedoc-Roussillon	34	2	15	317	La Vacquerie-et-Saint-Martin-de-Castries	152	0	152
91	Languedoc-Roussillon	34	3	09	318	Vacquières	427	5	432
91	Languedoc-Roussillon	34	1	29	319	Vailhan	169	3	172
91	Languedoc-Roussillon	34	3	18	320	Vailhauquès	2366	40	2406
91	Languedoc-Roussillon	34	3	17	321	Valergues	2017	31	2048
91	Languedoc-Roussillon	34	3	09	322	Valflaunès	709	16	725
91	Languedoc-Roussillon	34	2	10	323	Valmascle	46	0	46
91	Languedoc-Roussillon	34	1	39	324	Valras-Plage	4592	65	4657
91	Languedoc-Roussillon	34	1	35	325	Valros	1330	19	1349
91	Languedoc-Roussillon	34	1	33	326	Vélieux	62	1	63
91	Languedoc-Roussillon	34	3	07	327	Vendargues	5579	78	5657
91	Languedoc-Roussillon	34	2	14	328	Vendémian	1065	16	1081
91	Languedoc-Roussillon	34	1	39	329	Vendres	2199	62	2261
91	Languedoc-Roussillon	34	3	17	330	Vérargues	709	8	717
91	Languedoc-Roussillon	34	1	33	331	Verreries-de-Moussans	94	1	95
91	Languedoc-Roussillon	34	1	01	332	Vias	5354	108	5462
91	Languedoc-Roussillon	34	3	12	333	Vic-la-Gardiole	2855	43	2898
91	Languedoc-Roussillon	34	1	26	334	Vieussan	274	4	278
91	Languedoc-Roussillon	34	1	31	335	Villemagne-l;Argentière	424	13	437
91	Languedoc-Roussillon	34	1	05	336	Villeneuve-lès-Béziers	3986	63	4049
91	Languedoc-Roussillon	34	3	12	337	Villeneuve-lès-Maguelone	9141	89	9230
91	Languedoc-Roussillon	34	2	10	338	Villeneuvette	63	5	68
91	Languedoc-Roussillon	34	1	30	339	Villespassans	147	4	151
91	Languedoc-Roussillon	34	3	17	340	Villetelle	1399	16	1415
91	Languedoc-Roussillon	34	3	20	341	Villeveyrac	3164	55	3219
91	Languedoc-Roussillon	34	2	32	342	Viols-en-Laval	210	3	213
91	Languedoc-Roussillon	34	2	32	343	Viols-le-Fort	1157	19	1176
53	Bretagne	35	3	53	001	Acigné	6166	200	6366
53	Bretagne	35	3	18	002	Amanlis	1602	38	1640
53	Bretagne	35	3	34	003	Andouillé-Neuville	807	13	820
53	Bretagne	35	1	01	004	Antrain	1393	35	1428
53	Bretagne	35	1	33	005	Arbrissel	279	9	288
53	Bretagne	35	1	02	006	Argentré-du-Plessis	4212	116	4328
53	Bretagne	35	3	34	007	Aubigné	428	8	436
53	Bretagne	35	1	15	008	Availles-sur-Seiche	702	22	724
53	Bretagne	35	4	11	009	Baguer-Morvan	1564	24	1588
53	Bretagne	35	4	11	010	Baguer-Pican	1380	26	1406
53	Bretagne	35	1	36	011	Baillé	312	12	324
53	Bretagne	35	2	03	012	Bain-de-Bretagne	7339	166	7505
53	Bretagne	35	2	28	013	Bains-sur-Oust	3406	129	3535
53	Bretagne	35	1	15	014	Bais	2114	42	2156
53	Bretagne	35	1	42	015	Balazé	2165	78	2243
53	Bretagne	35	2	16	016	Baulon	1951	42	1993
53	Bretagne	35	4	41	017	La Baussaine	623	9	632
53	Bretagne	35	1	20	018	La Bazouge-du-Désert	1093	22	1115
53	Bretagne	35	1	01	019	Bazouges-la-Pérouse	1877	38	1915
53	Bretagne	35	1	12	021	Beaucé	1214	45	1259
53	Bretagne	35	3	04	022	Bécherel	758	20	778
53	Bretagne	35	3	23	023	Bédée	3997	64	4061
53	Bretagne	35	3	52	024	Betton	10111	336	10447
53	Bretagne	35	1	13	025	Billé	1030	18	1048
53	Bretagne	35	3	38	026	Bléruais	98	6	104
53	Bretagne	35	3	22	027	Boisgervilly	1513	39	1552
53	Bretagne	35	3	18	028	Boistrudan	670	9	679
53	Bretagne	35	4	09	029	Bonnemain	1377	29	1406
53	Bretagne	35	2	40	030	La Bosse-de-Bretagne	607	6	613
53	Bretagne	35	3	19	031	La Bouëxière	3834	79	3913
53	Bretagne	35	2	16	033	Bourg-des-Comptes	2848	45	2893
53	Bretagne	35	3	47	032	Bourgbarré	3458	54	3512
53	Bretagne	35	4	26	034	La Boussac	1169	24	1193
53	Bretagne	35	2	21	035	Bovel	579	3	582
53	Bretagne	35	3	27	037	Bréal-sous-Montfort	5055	96	5151
53	Bretagne	35	1	42	038	Bréal-sous-Vitré	645	9	654
53	Bretagne	35	3	07	039	Brécé	1929	36	1965
53	Bretagne	35	3	23	040	Breteil	3377	69	3446
53	Bretagne	35	3	18	041	Brie	812	23	835
53	Bretagne	35	1	02	042	Brielles	670	5	675
53	Bretagne	35	4	26	044	Broualan	351	8	359
53	Bretagne	35	2	25	045	Bruc-sur-Aff	845	19	864
53	Bretagne	35	2	21	046	Les Brulais	465	6	471
53	Bretagne	35	3	47	047	Bruz	16465	410	16875
53	Bretagne	35	2	21	048	Campel	513	5	518
53	Bretagne	35	4	05	049	Cancale	5324	160	5484
53	Bretagne	35	3	04	050	Cardroc	525	11	536
53	Bretagne	35	3	53	051	Cesson-Sévigné	15219	756	15975
53	Bretagne	35	1	43	052	Champeaux	473	23	496
53	Bretagne	35	3	07	053	Chancé	304	4	308
53	Bretagne	35	2	40	054	Chanteloup	1623	17	1640
53	Bretagne	35	3	46	055	Chantepie	9823	322	10145
53	Bretagne	35	4	41	056	La Chapelle-aux-Filtzméens	764	9	773
53	Bretagne	35	2	21	057	La Chapelle-Bouëxic	1299	16	1315
53	Bretagne	35	3	04	058	La Chapelle-Chaussée	1146	30	1176
53	Bretagne	35	2	28	064	La Chapelle-de-Brain	952	18	970
53	Bretagne	35	3	52	059	La Chapelle-des-Fougeretz	3944	95	4039
53	Bretagne	35	3	22	060	La Chapelle-du-Lou	723	16	739
53	Bretagne	35	1	42	061	La Chapelle-Erbrée	630	13	643
53	Bretagne	35	1	12	062	La Chapelle-Janson	1343	26	1369
53	Bretagne	35	1	35	063	La Chapelle-Saint-Aubert	421	6	427
53	Bretagne	35	3	23	065	La Chapelle-Thouarault	1926	34	1960
53	Bretagne	35	3	47	066	Chartres-de-Bretagne	7260	156	7416
53	Bretagne	35	3	19	067	Chasné-sur-Illet	1466	25	1491
53	Bretagne	35	1	06	068	Châteaubourg	6081	177	6258
53	Bretagne	35	3	07	069	Châteaugiron	6545	162	6707
53	Bretagne	35	4	08	070	Châteauneuf-d;Ille-et-Vilaine	1249	10	1259
53	Bretagne	35	1	36	071	Le Châtellier	377	9	386
53	Bretagne	35	1	42	072	Châtillon-en-Vendelais	1694	42	1736
53	Bretagne	35	1	01	075	Chauvigné	788	16	804
53	Bretagne	35	3	24	076	Chavagne	3725	70	3795
53	Bretagne	35	1	15	077	Chelun	341	9	350
53	Bretagne	35	4	11	078	Cherrueix	1150	15	1165
53	Bretagne	35	3	34	079	Chevaigné	1838	48	1886
53	Bretagne	35	3	24	080	Cintré	2054	46	2100
53	Bretagne	35	3	23	081	Clayes	678	11	689
53	Bretagne	35	1	33	082	Coësmes	1391	9	1400
53	Bretagne	35	1	36	083	Coglès	650	10	660
53	Bretagne	35	2	21	084	Comblessac	660	11	671
53	Bretagne	35	4	09	085	Combourg	5637	155	5792
53	Bretagne	35	1	13	086	Combourtillé	578	13	591
53	Bretagne	35	1	43	087	Cornillé	860	9	869
53	Bretagne	35	3	18	088	Corps-Nuds	2941	64	3005
53	Bretagne	35	2	40	089	La Couyère	501	6	507
53	Bretagne	35	2	03	090	Crevin	2594	26	2620
53	Bretagne	35	3	38	091	Le Crouais	487	14	501
53	Bretagne	35	4	09	092	Cuguen	784	7	791
53	Bretagne	35	4	10	093	Dinard	10579	590	11169
53	Bretagne	35	3	17	094	Dingé	1580	38	1618
53	Bretagne	35	4	11	095	Dol-de-Bretagne	5335	251	5586
53	Bretagne	35	1	06	096	Domagné	2217	43	2260
53	Bretagne	35	1	02	097	Domalain	1958	33	1991
53	Bretagne	35	2	14	098	La Dominelais	1253	26	1279
53	Bretagne	35	3	07	099	Domloup	2989	83	3072
53	Bretagne	35	1	13	100	Dompierre-du-Chemin	548	7	555
53	Bretagne	35	3	19	101	Dourdain	1046	18	1064
53	Bretagne	35	1	15	102	Drouges	520	12	532
53	Bretagne	35	1	15	103	Eancé	400	16	416
53	Bretagne	35	4	11	104	Epiniac	1364	22	1386
53	Bretagne	35	1	42	105	Erbrée	1664	36	1700
53	Bretagne	35	2	03	106	Ercé-en-Lamée	1437	17	1454
53	Bretagne	35	3	19	107	Ercé-près-Liffré	1801	39	1840
53	Bretagne	35	1	33	108	Essé	1122	17	1139
53	Bretagne	35	1	02	109	Étrelles	2559	79	2638
53	Bretagne	35	3	34	110	Feins	809	19	828
53	Bretagne	35	1	20	111	Le Ferré	682	10	692
53	Bretagne	35	1	12	112	Fleurigné	1043	29	1072
53	Bretagne	35	1	01	113	La Fontenelle	541	13	554
53	Bretagne	35	1	33	114	Forges-la-Forêt	280	6	286
53	Bretagne	35	1	97	115	Fougères	19779	858	20637
53	Bretagne	35	4	05	116	La Fresnais	2199	51	2250
53	Bretagne	35	3	38	117	Gaël	1584	22	1606
53	Bretagne	35	3	34	118	Gahard	1268	16	1284
53	Bretagne	35	1	02	119	Gennes-sur-Seiche	814	19	833
53	Bretagne	35	3	31	120	Gévezé	3984	79	4063
53	Bretagne	35	1	35	121	Gosné	1728	27	1755
53	Bretagne	35	4	39	122	La Gouesnière	1646	47	1693
53	Bretagne	35	2	16	123	Goven	4132	107	4239
53	Bretagne	35	2	14	124	Grand-Fougeray	2352	40	2392
53	Bretagne	35	1	15	125	La Guerche-de-Bretagne	4255	177	4432
53	Bretagne	35	2	16	126	Guichen	7500	154	7654
53	Bretagne	35	2	16	127	Guignen	3511	61	3572
53	Bretagne	35	3	17	128	Guipel	1579	33	1612
53	Bretagne	35	2	25	129	Guipry	3646	67	3713
53	Bretagne	35	3	17	130	Hédé-Bazouges	1940	34	1974
53	Bretagne	35	3	24	131	L; Hermitage	3835	83	3918
53	Bretagne	35	4	05	132	Hirel	1373	29	1402
53	Bretagne	35	3	23	133	Iffendic	4291	88	4379
53	Bretagne	35	3	04	134	Les Iffs	264	10	274
53	Bretagne	35	3	04	135	Irodouër	2015	42	2057
53	Bretagne	35	3	18	136	Janzé	8142	174	8316
53	Bretagne	35	1	13	137	Javené	1914	51	1965
53	Bretagne	35	1	12	138	Laignelet	979	52	1031
53	Bretagne	35	2	16	139	Laillé	4348	96	4444
53	Bretagne	35	2	40	140	Lalleu	581	13	594
53	Bretagne	35	1	43	141	Landavran	626	12	638
53	Bretagne	35	1	12	142	Landéan	1256	38	1294
53	Bretagne	35	3	22	143	Landujan	936	29	965
53	Bretagne	35	3	04	144	Langan	894	17	911
53	Bretagne	35	2	28	145	Langon	1443	21	1464
53	Bretagne	35	3	17	146	Langouet	546	13	559
53	Bretagne	35	4	09	147	Lanhélin	957	16	973
53	Bretagne	35	3	17	148	Lanrigan	138	1	139
53	Bretagne	35	2	16	149	Lassy	1380	32	1412
53	Bretagne	35	1	13	150	Lécousse	2931	138	3069
53	Bretagne	35	2	25	151	Lieuron	737	15	752
53	Bretagne	35	3	19	152	Liffré	6829	150	6979
53	Bretagne	35	4	08	153	Lillemer	282	5	287
53	Bretagne	35	3	19	154	Livré-sur-Changeon	1646	26	1672
53	Bretagne	35	2	25	155	Lohéac	664	12	676
53	Bretagne	35	4	41	156	Longaulnay	614	2	616
53	Bretagne	35	1	12	157	Le Loroux	614	20	634
53	Bretagne	35	3	22	158	Le Lou-du-Lac	96	2	98
53	Bretagne	35	4	09	159	Lourmais	322	13	335
53	Bretagne	35	2	21	160	Loutehel	215	5	220
53	Bretagne	35	1	06	161	Louvigné-de-Bais	1709	41	1750
53	Bretagne	35	1	20	162	Louvigné-du-Désert	3758	108	3866
53	Bretagne	35	1	12	163	Luitré	1301	39	1340
53	Bretagne	35	1	01	164	Marcillé-Raoul	833	17	850
53	Bretagne	35	1	33	165	Marcillé-Robert	941	28	969
53	Bretagne	35	1	43	166	Marpiré	1064	6	1070
53	Bretagne	35	1	33	167	Martigné-Ferchaud	2663	83	2746
53	Bretagne	35	2	21	168	Maure-de-Bretagne	3203	55	3258
53	Bretagne	35	3	27	169	Maxent	1305	18	1323
53	Bretagne	35	1	43	170	Mecé	570	10	580
53	Bretagne	35	3	22	171	Médréac	1876	45	1921
53	Bretagne	35	4	09	172	Meillac	1730	28	1758
53	Bretagne	35	3	34	173	Melesse	5577	181	5758
53	Bretagne	35	1	20	174	Mellé	671	10	681
53	Bretagne	35	2	21	175	Mernel	986	15	1001
53	Bretagne	35	2	03	176	Messac	2778	133	2911
53	Bretagne	35	3	17	177	La Mézière	4320	73	4393
53	Bretagne	35	1	35	178	Mézières-sur-Couesnon	1378	28	1406
53	Bretagne	35	4	08	179	Miniac-Morvan	3705	66	3771
53	Bretagne	35	3	04	180	Miniac-sous-Bécherel	708	13	721
53	Bretagne	35	4	10	181	Le Minihic-sur-Rance	1427	54	1481
53	Bretagne	35	1	42	183	Mondevert	771	9	780
53	Bretagne	35	4	11	186	Mont-Dol	1248	34	1282
53	Bretagne	35	3	22	184	Montauban-de-Bretagne	4739	198	4937
53	Bretagne	35	1	42	185	Montautour	249	9	258
53	Bretagne	35	3	27	187	Monterfil	1273	20	1293
53	Bretagne	35	3	23	188	Montfort-sur-Meu	6458	142	6600
53	Bretagne	35	3	52	189	Montgermont	3056	76	3132
53	Bretagne	35	1	20	190	Monthault	251	7	258
53	Bretagne	35	1	36	191	Montours	1016	19	1035
53	Bretagne	35	1	43	192	Montreuil-des-Landes	236	2	238
53	Bretagne	35	3	34	193	Montreuil-le-Gast	1912	28	1940
53	Bretagne	35	1	43	194	Montreuil-sous-Pérouse	1061	43	1104
53	Bretagne	35	3	34	195	Montreuil-sur-Ille	2114	41	2155
53	Bretagne	35	3	24	196	Mordelles	7180	209	7389
53	Bretagne	35	3	34	197	Mouazé	1053	11	1064
53	Bretagne	35	1	15	198	Moulins	651	15	666
53	Bretagne	35	1	15	199	Moussé	326	9	335
53	Bretagne	35	1	15	200	Moutiers	900	17	917
53	Bretagne	35	3	38	201	Muel	816	16	832
53	Bretagne	35	2	03	202	La Noë-Blanche	976	20	996
53	Bretagne	35	3	23	203	La Nouaye	294	6	300
53	Bretagne	35	3	07	204	Nouvoitou	2895	52	2947
53	Bretagne	35	3	47	206	Noyal-Châtillon-sur-Seiche	6250	145	6395
53	Bretagne	35	1	01	205	Noyal-sous-Bazouges	372	8	380
53	Bretagne	35	3	07	207	Noyal-sur-Vilaine	5441	124	5565
53	Bretagne	35	3	47	208	Orgères	3905	76	3981
53	Bretagne	35	1	06	209	Ossé	1179	11	1190
53	Bretagne	35	3	31	210	Pacé	9961	279	10240
53	Bretagne	35	3	27	211	Paimpont	1631	38	1669
53	Bretagne	35	2	03	212	Pancé	1132	32	1164
53	Bretagne	35	1	13	214	Parcé	640	4	644
53	Bretagne	35	1	12	215	Parigné	1317	41	1358
53	Bretagne	35	3	31	216	Parthenay-de-Bretagne	1378	25	1403
53	Bretagne	35	1	02	217	Le Pertre	1439	26	1465
53	Bretagne	35	2	40	218	Le Petit-Fougeray	870	14	884
53	Bretagne	35	2	25	219	Pipriac	3559	60	3619
53	Bretagne	35	3	18	220	Piré-sur-Seiche	2283	41	2324
53	Bretagne	35	2	03	221	Pléchâtel	2735	64	2799
53	Bretagne	35	4	26	222	Pleine-Fougères	1963	49	2012
53	Bretagne	35	3	27	223	Plélan-le-Grand	3566	81	3647
53	Bretagne	35	4	08	224	Plerguer	2284	41	2325
53	Bretagne	35	4	41	225	Plesder	708	14	722
53	Bretagne	35	4	41	226	Pleugueneuc	1659	24	1683
53	Bretagne	35	3	23	227	Pleumeleuc	2941	53	2994
53	Bretagne	35	4	10	228	Pleurtuit	5962	146	6108
53	Bretagne	35	1	43	229	Pocé-les-Bois	1078	22	1100
53	Bretagne	35	1	20	230	Poilley	397	2	399
53	Bretagne	35	2	03	231	Poligné	1136	22	1158
53	Bretagne	35	3	47	363	Pont-Péan	3697	96	3793
53	Bretagne	35	1	42	232	Princé	375	1	376
53	Bretagne	35	3	17	233	Québriac	1469	20	1489
53	Bretagne	35	3	38	234	Quédillac	1132	25	1157
53	Bretagne	35	1	15	235	Rannée	1156	36	1192
53	Bretagne	35	2	28	236	Redon	9592	821	10413
53	Bretagne	35	2	28	237	Renac	944	37	981
53	Bretagne	35	3	98	238	Rennes	207178	5761	212939
53	Bretagne	35	1	33	239	Retiers	3775	99	3874
53	Bretagne	35	3	24	240	Le Rheu	7669	304	7973
53	Bretagne	35	4	10	241	La Richardais	2393	84	2477
53	Bretagne	35	1	01	242	Rimou	358	11	369
53	Bretagne	35	1	13	243	Romagné	2154	70	2224
53	Bretagne	35	3	34	244	Romazy	276	4	280
53	Bretagne	35	3	04	245	Romillé	3632	76	3708
53	Bretagne	35	4	11	246	Roz-Landrieux	1265	20	1285
53	Bretagne	35	4	26	247	Roz-sur-Couesnon	1034	18	1052
53	Bretagne	35	4	26	248	Sains	482	7	489
53	Bretagne	35	3	07	250	Saint-Armel	1830	20	1850
53	Bretagne	35	3	34	251	Saint-Aubin-d;Aubigné	3310	96	3406
53	Bretagne	35	1	43	252	Saint-Aubin-des-Landes	912	17	929
53	Bretagne	35	1	35	253	Saint-Aubin-du-Cormier	3578	143	3721
53	Bretagne	35	3	07	254	Saint-Aubin-du-Pavail	729	15	744
53	Bretagne	35	4	05	255	Saint-Benoît-des-Ondes	1077	30	1107
53	Bretagne	35	4	10	256	Saint-Briac-sur-Mer	1968	81	2049
53	Bretagne	35	1	36	257	Saint-Brice-en-Coglès	2752	51	2803
53	Bretagne	35	3	04	258	Saint-Brieuc-des-Iffs	363	9	372
53	Bretagne	35	4	26	259	Saint-Broladre	1140	18	1158
53	Bretagne	35	1	35	261	Saint-Christophe-de-Valains	218	6	224
53	Bretagne	35	1	43	260	Saint-Christophe-des-Bois	528	10	538
53	Bretagne	35	4	05	263	Saint-Coulomb	2482	100	2582
53	Bretagne	35	1	06	264	Saint-Didier	1792	35	1827
53	Bretagne	35	4	41	265	Saint-Domineuc	2242	23	2265
53	Bretagne	35	3	47	266	Saint-Erblon	2482	57	2539
53	Bretagne	35	1	36	267	Saint-Étienne-en-Coglès	1684	28	1712
53	Bretagne	35	2	25	268	Saint-Ganton	418	7	425
53	Bretagne	35	1	35	269	Saint-Georges-de-Chesné	602	14	616
53	Bretagne	35	4	26	270	Saint-Georges-de-Gréhaigne	342	6	348
53	Bretagne	35	1	20	271	Saint-Georges-de-Reintembault	1638	32	1670
53	Bretagne	35	1	02	272	Saint-Germain-du-Pinel	877	12	889
53	Bretagne	35	1	36	273	Saint-Germain-en-Coglès	2053	62	2115
53	Bretagne	35	3	34	274	Saint-Germain-sur-Ille	892	19	911
53	Bretagne	35	3	24	275	Saint-Gilles	3783	100	3883
53	Bretagne	35	3	17	276	Saint-Gondran	520	8	528
53	Bretagne	35	3	23	277	Saint-Gonlay	349	6	355
53	Bretagne	35	3	52	278	Saint-Grégoire	8549	482	9031
53	Bretagne	35	4	08	279	Saint-Guinoux	907	14	921
53	Bretagne	35	1	36	280	Saint-Hilaire-des-Landes	993	17	1010
53	Bretagne	35	3	49	281	Saint-Jacques-de-la-Lande	10497	150	10647
53	Bretagne	35	1	35	282	Saint-Jean-sur-Couesnon	1072	17	1089
53	Bretagne	35	1	06	283	Saint-Jean-sur-Vilaine	1043	33	1076
53	Bretagne	35	4	39	284	Saint-Jouan-des-Guérets	2672	104	2776
53	Bretagne	35	2	25	285	Saint-Just	1058	16	1074
53	Bretagne	35	4	09	286	Saint-Léger-des-Prés	232	5	237
53	Bretagne	35	4	10	287	Saint-Lunaire	2329	93	2422
53	Bretagne	35	1	42	300	Saint-M;Hervé	1370	31	1401
53	Bretagne	35	3	22	301	Saint-M;Hervon	433	8	441
53	Bretagne	35	4	96	288	Saint-Malo	46342	1791	48133
53	Bretagne	35	2	25	289	Saint-Malo-de-Phily	907	8	915
53	Bretagne	35	3	38	290	Saint-Malon-sur-Mel	589	4	593
53	Bretagne	35	1	36	292	Saint-Marc-le-Blanc	1288	23	1311
53	Bretagne	35	1	35	293	Saint-Marc-sur-Couesnon	517	8	525
53	Bretagne	35	4	26	291	Saint-Marcan	467	9	476
53	Bretagne	35	3	38	295	Saint-Maugan	587	12	599
53	Bretagne	35	3	34	296	Saint-Médard-sur-Ille	1319	32	1351
53	Bretagne	35	3	38	297	Saint-Méen-le-Grand	4426	184	4610
53	Bretagne	35	4	05	299	Saint-Méloir-des-Ondes	3732	89	3821
53	Bretagne	35	3	38	302	Saint-Onen-la-Chapelle	1097	18	1115
53	Bretagne	35	1	35	304	Saint-Ouen-des-Alleux	1312	16	1328
53	Bretagne	35	1	01	303	Saint-Ouen-la-Rouërie	792	15	807
53	Bretagne	35	3	27	305	Saint-Péran	351	9	360
53	Bretagne	35	4	08	306	Saint-Père	2300	129	2429
53	Bretagne	35	3	04	307	Saint-Pern	973	13	986
53	Bretagne	35	4	09	308	Saint-Pierre-de-Plesguen	2650	54	2704
53	Bretagne	35	1	01	309	Saint-Rémy-du-Plain	789	12	801
53	Bretagne	35	1	13	310	Saint-Sauveur-des-Landes	1442	29	1471
53	Bretagne	35	2	21	311	Saint-Séglin	478	9	487
53	Bretagne	35	2	16	312	Saint-Senoux	1695	30	1725
53	Bretagne	35	4	08	314	Saint-Suliac	940	37	977
53	Bretagne	35	2	14	316	Saint-Sulpice-des-Landes	806	23	829
53	Bretagne	35	3	19	315	Saint-Sulpice-la-Forêt	1423	52	1475
53	Bretagne	35	3	17	317	Saint-Symphorien	560	73	633
53	Bretagne	35	4	41	318	Saint-Thual	749	7	756
53	Bretagne	35	3	27	319	Saint-Thurial	1886	29	1915
53	Bretagne	35	3	22	320	Saint-Uniac	509	8	517
53	Bretagne	35	2	14	249	Sainte-Anne-sur-Vilaine	1014	19	1033
53	Bretagne	35	1	33	262	Sainte-Colombe	307	5	312
53	Bretagne	35	2	28	294	Sainte-Marie	2275	61	2336
53	Bretagne	35	2	40	321	Saulnières	700	12	712
53	Bretagne	35	2	40	322	Le Sel-de-Bretagne	915	11	926
53	Bretagne	35	1	36	323	La Selle-en-Coglès	597	8	605
53	Bretagne	35	1	12	324	La Selle-en-Luitré	553	19	572
53	Bretagne	35	1	15	325	La Selle-Guerchaise	150	5	155
53	Bretagne	35	3	34	326	Sens-de-Bretagne	2547	17	2564
53	Bretagne	35	3	07	327	Servon-sur-Vilaine	3542	73	3615
53	Bretagne	35	2	25	328	Sixt-sur-Aff	2152	41	2193
53	Bretagne	35	4	26	329	Sougéal	642	6	648
53	Bretagne	35	1	43	330	Taillis	1002	23	1025
53	Bretagne	35	3	23	331	Talensac	2353	52	2405
53	Bretagne	35	2	03	332	Teillay	997	14	1011
53	Bretagne	35	1	33	333	Le Theil-de-Bretagne	1556	28	1584
53	Bretagne	35	3	19	334	Thorigné-Fouillard	7140	259	7399
53	Bretagne	35	1	33	335	Thourie	707	14	721
53	Bretagne	35	1	36	336	Le Tiercent	177	8	185
53	Bretagne	35	4	41	337	Tinténiac	3373	164	3537
53	Bretagne	35	1	02	338	Torcé	1147	19	1166
53	Bretagne	35	4	26	339	Trans-la-Forêt	550	8	558
53	Bretagne	35	3	27	340	Treffendel	1246	20	1266
53	Bretagne	35	1	01	341	Tremblay	1508	48	1556
53	Bretagne	35	4	09	342	Trémeheuc	366	4	370
53	Bretagne	35	2	40	343	Tresboeuf	1198	11	1209
53	Bretagne	35	4	09	344	Tressé	340	9	349
53	Bretagne	35	4	41	345	Trévérien	840	8	848
53	Bretagne	35	4	41	346	Trimer	177	1	178
53	Bretagne	35	4	08	362	Le Tronchet	1053	20	1073
53	Bretagne	35	1	43	347	Val-d;Izé	2493	66	2559
53	Bretagne	35	1	35	348	Vendel	437	4	441
53	Bretagne	35	1	02	350	Vergéal	738	8	746
53	Bretagne	35	3	23	351	Le Verger	1514	47	1561
53	Bretagne	35	3	46	352	Vern-sur-Seiche	8146	198	8344
53	Bretagne	35	3	49	353	Vezin-le-Coquet	4382	95	4477
53	Bretagne	35	4	26	354	Vieux-Viel	288	2	290
53	Bretagne	35	3	34	355	Vieux-Vy-sur-Couesnon	1104	12	1116
53	Bretagne	35	3	17	356	Vignoc	1798	34	1832
53	Bretagne	35	1	20	357	Villamée	335	3	338
53	Bretagne	35	4	08	358	La Ville-ès-Nonais	1036	35	1071
53	Bretagne	35	1	15	359	Visseiche	827	19	846
53	Bretagne	35	1	99	360	Vitré	16834	559	17393
53	Bretagne	35	4	11	361	Le Vivier-sur-Mer	1014	28	1042
24	Centre	36	3	01	001	Aigurande	1567	24	1591
24	Centre	36	4	23	002	Aize	128	3	131
24	Centre	36	4	13	003	Ambrault	917	10	927
24	Centre	36	4	18	004	Anjouin	344	5	349
24	Centre	36	2	02	005	Ardentes	3774	84	3858
24	Centre	36	2	03	006	Argenton-sur-Creuse	5120	215	5335
24	Centre	36	2	06	007	Argy	617	14	631
24	Centre	36	2	08	008	Arpheuilles	242	8	250
24	Centre	36	2	02	009	Arthon	1183	54	1237
24	Centre	36	1	15	010	Azay-le-Ferron	912	31	943
24	Centre	36	3	11	158	Badecon-le-Pin	762	5	767
24	Centre	36	4	18	011	Bagneux	195	2	197
24	Centre	36	3	11	012	Baraize	319	3	322
24	Centre	36	2	14	013	Baudres	486	5	491
24	Centre	36	3	11	014	Bazaiges	230	5	235
24	Centre	36	1	17	015	Beaulieu	80	3	83
24	Centre	36	1	04	016	Bélâbre	1020	24	1044
24	Centre	36	3	09	017	La Berthenoux	452	10	462
24	Centre	36	1	05	018	Le Blanc	6968	373	7341
24	Centre	36	4	13	019	Bommiers	293	5	298
24	Centre	36	1	17	020	Bonneuil	100	0	100
24	Centre	36	4	12	021	Les Bordes	925	16	941
24	Centre	36	2	03	022	Bouesse	370	9	379
24	Centre	36	2	14	023	Bouges-le-Château	283	4	287
24	Centre	36	2	14	024	Bretagne	143	1	144
24	Centre	36	3	09	025	Briantes	608	14	622
24	Centre	36	2	14	026	Brion	501	7	508
24	Centre	36	4	13	027	Brives	276	5	281
24	Centre	36	3	01	028	La Buxerette	109	1	110
24	Centre	36	4	23	029	Buxeuil	220	4	224
24	Centre	36	2	02	030	Buxières-d;Aillac	225	4	229
24	Centre	36	2	06	031	Buzançais	4494	52	4546
24	Centre	36	3	11	032	Ceaulmont	719	13	732
24	Centre	36	2	03	033	Celon	403	6	409
24	Centre	36	4	18	034	Chabris	2790	40	2830
24	Centre	36	1	17	035	Chaillac	1118	19	1137
24	Centre	36	1	04	036	Chalais	169	6	175
24	Centre	36	4	12	037	La Champenoise	315	7	322
24	Centre	36	3	09	038	Champillet	154	3	157
24	Centre	36	2	06	040	La Chapelle-Orthemale	126	3	129
24	Centre	36	4	23	041	La Chapelle-Saint-Laurian	134	4	138
24	Centre	36	2	03	042	Chasseneuil	666	15	681
24	Centre	36	3	09	043	Chassignolles	589	10	599
24	Centre	36	2	98	044	Châteauroux	46140	2047	48187
24	Centre	36	2	08	045	Châtillon-sur-Indre	2828	56	2884
24	Centre	36	3	09	046	La Châtre	4482	141	4623
24	Centre	36	1	17	047	La Châtre-Langlin	567	2	569
24	Centre	36	2	03	048	Chavin	283	8	291
24	Centre	36	1	17	049	Chazelet	118	7	125
24	Centre	36	2	06	050	Chezelles	442	5	447
24	Centre	36	1	19	051	Chitray	165	7	172
24	Centre	36	4	13	052	Chouday	162	3	165
24	Centre	36	1	05	053	Ciron	528	21	549
24	Centre	36	2	08	054	Cléré-du-Bois	282	3	285
24	Centre	36	2	08	055	Clion	1118	17	1135
24	Centre	36	3	16	056	Cluis	1020	23	1043
24	Centre	36	2	14	057	Coings	852	37	889
24	Centre	36	1	05	058	Concremiers	644	20	664
24	Centre	36	4	13	059	Condé	229	8	237
24	Centre	36	3	01	060	Crevant	739	6	745
24	Centre	36	3	01	061	Crozon-sur-Vauvre	379	12	391
24	Centre	36	3	11	062	Cuzion	446	8	454
24	Centre	36	2	24	063	Déols	7916	209	8125
24	Centre	36	2	02	064	Diors	712	22	734
24	Centre	36	4	12	065	Diou	279	4	283
24	Centre	36	1	05	066	Douadic	458	18	476
24	Centre	36	4	18	068	Dun-le-Poëlier	471	8	479
24	Centre	36	1	17	067	Dunet	111	1	112
24	Centre	36	2	10	069	Écueillé	1313	22	1335
24	Centre	36	3	11	070	Éguzon-Chantôme	1337	32	1369
24	Centre	36	2	02	071	Étrechet	887	26	913
24	Centre	36	2	22	072	Faverolles	352	6	358
24	Centre	36	3	20	073	Feusines	203	1	204
24	Centre	36	2	08	074	Fléré-la-Rivière	608	12	620
24	Centre	36	4	23	075	Fontenay	84	2	86
24	Centre	36	1	21	076	Fontgombault	267	7	274
24	Centre	36	2	22	077	Fontguenand	238	6	244
24	Centre	36	3	16	078	Fougerolles	332	5	337
24	Centre	36	2	14	079	Francillon	71	0	71
24	Centre	36	2	10	080	Frédille	66	1	67
24	Centre	36	3	11	081	Gargilesse-Dampierre	319	21	340
24	Centre	36	2	10	082	Gehée	270	8	278
24	Centre	36	4	23	083	Giroux	126	3	129
24	Centre	36	3	16	084	Gournay	330	9	339
24	Centre	36	4	23	085	Guilly	247	0	247
24	Centre	36	2	10	086	Heugnes	388	11	399
24	Centre	36	1	05	087	Ingrandes	336	11	347
24	Centre	36	4	99	088	Issoudun	13090	362	13452
24	Centre	36	2	02	089	Jeu-les-Bois	394	5	399
24	Centre	36	2	10	090	Jeu-Maloches	131	5	136
24	Centre	36	3	09	091	Lacs	652	16	668
24	Centre	36	2	22	092	Langé	297	3	300
24	Centre	36	2	14	093	Levroux	2834	45	2879
24	Centre	36	1	04	094	Lignac	558	27	585
24	Centre	36	3	20	095	Lignerolles	118	2	120
24	Centre	36	1	21	096	Lingé	252	4	256
24	Centre	36	4	23	097	Liniez	338	4	342
24	Centre	36	4	12	098	Lizeray	101	3	104
24	Centre	36	3	01	099	Lourdoueix-Saint-Michel	350	7	357
24	Centre	36	3	09	100	Lourouer-Saint-Laurent	254	5	259
24	Centre	36	2	02	101	Luant	1394	46	1440
24	Centre	36	1	21	104	Lurais	231	8	239
24	Centre	36	1	21	105	Lureuil	268	7	275
24	Centre	36	1	19	106	Luzeret	147	3	150
24	Centre	36	4	23	102	Luçay-le-Libre	119	0	119
24	Centre	36	2	22	103	Luçay-le-Mâle	1480	36	1516
24	Centre	36	2	22	107	Lye	823	28	851
24	Centre	36	3	16	108	Lys-Saint-Georges	246	13	259
24	Centre	36	3	09	109	Le Magny	1034	30	1064
24	Centre	36	3	16	110	Maillet	265	5	270
24	Centre	36	3	16	111	Malicornay	175	3	178
24	Centre	36	2	02	112	Mâron	734	24	758
24	Centre	36	1	21	113	Martizay	1045	26	1071
24	Centre	36	1	04	114	Mauvières	338	6	344
24	Centre	36	4	18	115	Menetou-sur-Nahon	121	1	122
24	Centre	36	4	23	116	Ménétréols-sous-Vatan	124	2	126
24	Centre	36	2	03	117	Le Menoux	461	18	479
24	Centre	36	2	06	118	Méobecq	366	13	379
24	Centre	36	1	21	119	Mérigny	563	8	571
24	Centre	36	3	16	120	Mers-sur-Indre	622	32	654
24	Centre	36	4	13	121	Meunet-Planches	194	4	198
24	Centre	36	4	23	122	Meunet-sur-Vatan	197	8	205
24	Centre	36	1	15	123	Mézières-en-Brenne	1076	25	1101
24	Centre	36	1	19	124	Migné	277	9	286
24	Centre	36	4	12	125	Migny	119	3	122
24	Centre	36	3	01	126	Montchevrier	496	3	499
24	Centre	36	3	09	127	Montgivray	1705	36	1741
24	Centre	36	2	24	128	Montierchaume	1688	55	1743
24	Centre	36	3	16	129	Montipouret	569	7	576
24	Centre	36	3	09	130	Montlevicq	102	2	104
24	Centre	36	2	03	131	Mosnay	477	10	487
24	Centre	36	3	09	132	La Motte-Feuilly	36	4	40
24	Centre	36	3	16	133	Mouhers	249	5	254
24	Centre	36	1	17	134	Mouhet	512	9	521
24	Centre	36	2	14	135	Moulins-sur-Céphons	326	9	335
24	Centre	36	2	08	136	Murs	125	6	131
24	Centre	36	1	21	137	Néons-sur-Creuse	399	14	413
24	Centre	36	3	09	138	Néret	217	6	223
24	Centre	36	2	06	139	Neuillay-les-Bois	685	8	693
24	Centre	36	4	13	140	Neuvy-Pailloux	1309	6	1315
24	Centre	36	3	16	141	Neuvy-Saint-Sépulchre	1695	33	1728
24	Centre	36	2	25	142	Niherne	1551	189	1740
24	Centre	36	3	09	143	Nohant-Vic	477	5	482
24	Centre	36	1	19	144	Nuret-le-Ferron	327	10	337
24	Centre	36	1	15	145	Obterre	247	6	253
24	Centre	36	3	01	146	Orsennes	793	4	797
24	Centre	36	4	18	147	Orville	128	2	130
24	Centre	36	1	19	148	Oulches	417	6	423
24	Centre	36	2	08	149	Palluau-sur-Indre	770	19	789
24	Centre	36	1	17	150	Parnac	519	14	533
24	Centre	36	4	18	151	Parpeçay	248	3	251
24	Centre	36	4	12	152	Paudy	466	6	472
24	Centre	36	1	15	153	Paulnay	356	4	360
24	Centre	36	2	03	154	Le Pêchereau	1968	58	2026
24	Centre	36	2	10	155	Pellevoisin	833	50	883
24	Centre	36	3	20	156	Pérassay	387	2	389
24	Centre	36	2	02	157	La Pérouille	432	5	437
24	Centre	36	2	02	159	Le Poinçonnet	5829	188	6017
24	Centre	36	3	11	160	Pommiers	273	2	275
24	Centre	36	2	03	161	Le Pont-Chrétien-Chabenet	966	34	1000
24	Centre	36	4	18	162	Poulaines	878	17	895
24	Centre	36	3	20	163	Pouligny-Notre-Dame	615	16	631
24	Centre	36	3	20	164	Pouligny-Saint-Martin	237	9	246
24	Centre	36	1	05	165	Pouligny-Saint-Pierre	1056	40	1096
24	Centre	36	2	10	166	Préaux	162	1	163
24	Centre	36	1	21	167	Preuilly-la-Ville	168	5	173
24	Centre	36	1	04	168	Prissac	670	16	686
24	Centre	36	4	13	169	Pruniers	543	5	548
24	Centre	36	4	23	170	Reboursin	121	1	122
24	Centre	36	4	12	171	Reuilly	2078	23	2101
24	Centre	36	1	19	172	Rivarennes	604	11	615
24	Centre	36	1	05	173	Rosnay	578	20	598
24	Centre	36	1	17	174	Roussines	354	13	367
24	Centre	36	2	14	175	Rouvres-les-Bois	330	7	337
24	Centre	36	1	05	176	Ruffec	636	29	665
24	Centre	36	1	17	177	Sacierges-Saint-Martin	312	10	322
24	Centre	36	1	05	178	Saint-Aigny	296	2	298
24	Centre	36	4	12	179	Saint-Aoustrille	177	3	180
24	Centre	36	3	09	180	Saint-Août	881	12	893
24	Centre	36	4	13	181	Saint-Aubin	198	2	200
24	Centre	36	1	17	182	Saint-Benoît-du-Sault	652	19	671
24	Centre	36	3	09	184	Saint-Chartier	584	14	598
24	Centre	36	4	18	185	Saint-Christophe-en-Bazelle	381	10	391
24	Centre	36	3	09	186	Saint-Christophe-en-Boucherie	247	2	249
24	Centre	36	1	17	187	Saint-Civran	177	0	177
24	Centre	36	2	08	188	Saint-Cyran-du-Jambot	205	170	375
24	Centre	36	3	01	189	Saint-Denis-de-Jouhet	954	10	964
24	Centre	36	4	23	191	Saint-Florentin	503	13	516
24	Centre	36	1	19	192	Saint-Gaultier	1883	75	1958
24	Centre	36	2	06	194	Saint-Genou	1016	11	1027
24	Centre	36	4	12	195	Saint-Georges-sur-Arnon	548	12	560
24	Centre	36	1	17	196	Saint-Gilles	114	5	119
24	Centre	36	1	04	197	Saint-Hilaire-sur-Benaize	358	8	366
24	Centre	36	2	06	198	Saint-Lactencin	406	10	416
24	Centre	36	2	03	200	Saint-Marcel	1552	94	1646
24	Centre	36	2	14	201	Saint-Martin-de-Lamps	170	4	174
24	Centre	36	2	25	202	Saint-Maur	3268	97	3365
24	Centre	36	2	08	203	Saint-Médard	45	0	45
24	Centre	36	1	15	204	Saint-Michel-en-Brenne	325	6	331
24	Centre	36	4	23	205	Saint-Pierre-de-Jards	117	6	123
24	Centre	36	2	14	206	Saint-Pierre-de-Lamps	43	1	44
24	Centre	36	3	01	207	Saint-Plantaire	549	7	556
24	Centre	36	4	12	209	Saint-Valentin	278	7	285
24	Centre	36	4	18	183	Sainte-Cécile	99	1	100
24	Centre	36	4	13	190	Sainte-Fauste	299	7	306
24	Centre	36	1	15	193	Sainte-Gemme	262	12	274
24	Centre	36	4	12	199	Sainte-Lizaigne	1240	36	1276
24	Centre	36	3	20	208	Sainte-Sévère-sur-Indre	840	22	862
24	Centre	36	3	16	210	Sarzay	328	8	336
24	Centre	36	2	02	211	Sassierges-Saint-Germain	469	7	476
24	Centre	36	1	15	212	Saulnay	183	3	186
24	Centre	36	1	21	213	Sauzelles	234	9	243
24	Centre	36	3	20	214	Sazeray	331	11	342
24	Centre	36	4	13	215	Ségry	519	9	528
24	Centre	36	2	10	216	Selles-sur-Nahon	70	1	71
24	Centre	36	4	18	217	Sembleçay	104	2	106
24	Centre	36	2	06	218	Sougé	153	6	159
24	Centre	36	2	03	219	Tendu	592	9	601
24	Centre	36	1	19	220	Thenay	888	43	931
24	Centre	36	3	09	221	Thevet-Saint-Julien	460	6	466
24	Centre	36	4	13	222	Thizay	257	4	261
24	Centre	36	1	04	223	Tilly	168	6	174
24	Centre	36	1	21	224	Tournon-Saint-Martin	1214	19	1233
24	Centre	36	2	08	225	Le Tranger	175	2	177
24	Centre	36	3	16	226	Tranzault	326	4	330
24	Centre	36	3	20	227	Urciers	257	4	261
24	Centre	36	2	22	228	Valençay	2594	102	2696
24	Centre	36	4	18	229	Varennes-sur-Fouzon	723	8	731
24	Centre	36	4	23	230	Vatan	2063	29	2092
24	Centre	36	2	02	231	Velles	919	10	929
24	Centre	36	2	06	232	Vendoeuvres	1125	27	1152
24	Centre	36	2	22	233	La Vernelle	778	14	792
24	Centre	36	3	09	234	Verneuil-sur-Igneraie	345	8	353
24	Centre	36	2	22	235	Veuil	383	8	391
24	Centre	36	3	09	236	Vicq-Exemplet	327	9	336
24	Centre	36	2	22	237	Vicq-sur-Nahon	768	10	778
24	Centre	36	3	20	238	Vigoulant	129	2	131
24	Centre	36	1	17	239	Vigoux	466	5	471
24	Centre	36	3	20	240	Vijon	308	9	317
24	Centre	36	2	06	241	Villedieu-sur-Indre	2744	50	2794
24	Centre	36	2	14	242	Villegongis	136	1	137
24	Centre	36	2	10	243	Villegouin	402	7	409
24	Centre	36	2	22	244	Villentrois	614	13	627
24	Centre	36	2	25	245	Villers-les-Ormes	423	15	438
24	Centre	36	1	15	246	Villiers	192	4	196
24	Centre	36	2	14	247	Vineuil	1184	23	1207
24	Centre	36	4	13	248	Vouillon	260	9	269
24	Centre	37	3	09	001	Abilly	1121	32	1153
24	Centre	37	2	05	002	Ambillou	1774	29	1803
24	Centre	37	2	01	003	Amboise	12846	396	13242
24	Centre	37	1	10	004	Anché	431	7	438
24	Centre	37	1	20	005	Antogny-le-Tillac	532	7	539
24	Centre	37	2	14	006	Artannes-sur-Indre	2480	45	2525
24	Centre	37	1	19	007	Assay	173	3	176
24	Centre	37	2	03	008	Athée-sur-Cher	2501	31	2532
24	Centre	37	2	06	009	Autrèche	394	8	402
24	Centre	37	2	06	010	Auzouer-en-Touraine	2064	83	2147
24	Centre	37	1	07	011	Avoine	1834	52	1886
24	Centre	37	1	10	012	Avon-les-Roches	549	8	557
24	Centre	37	1	11	013	Avrillé-les-Ponceaux	449	5	454
24	Centre	37	1	02	014	Azay-le-Rideau	3435	131	3566
24	Centre	37	2	03	015	Azay-sur-Cher	2993	75	3068
24	Centre	37	3	13	016	Azay-sur-Indre	382	7	389
24	Centre	37	2	31	018	Ballan-Miré	8106	225	8331
24	Centre	37	3	08	019	Barrou	501	12	513
24	Centre	37	3	13	020	Beaulieu-lès-Loches	1759	54	1813
24	Centre	37	1	07	022	Beaumont-en-Véron	2793	129	2922
24	Centre	37	2	16	021	Beaumont-la-Ronce	1167	11	1178
24	Centre	37	3	15	023	Beaumont-Village	258	3	261
24	Centre	37	1	04	024	Benais	937	21	958
24	Centre	37	2	31	025	Berthenay	742	17	759
24	Centre	37	3	08	026	Betz-le-Château	582	23	605
24	Centre	37	2	03	027	Bléré	5213	99	5312
24	Centre	37	3	18	028	Bossay-sur-Claise	826	22	848
24	Centre	37	3	12	029	Bossée	340	2	342
24	Centre	37	2	06	030	Le Boulay	694	10	704
24	Centre	37	1	04	031	Bourgueil	3898	137	4035
24	Centre	37	3	12	032	Bournan	265	6	271
24	Centre	37	3	18	033	Boussay	248	6	254
24	Centre	37	1	19	034	Braslou	320	3	323
24	Centre	37	1	19	035	Braye-sous-Faye	325	6	331
24	Centre	37	2	05	036	Braye-sur-Maulne	216	6	222
24	Centre	37	2	05	037	Brèches	284	6	290
24	Centre	37	1	02	038	Bréhémont	793	11	804
24	Centre	37	3	13	039	Bridoré	552	13	565
24	Centre	37	1	10	040	Brizay	339	2	341
24	Centre	37	2	17	041	Bueil-en-Touraine	323	13	336
24	Centre	37	1	07	042	Candes-Saint-Martin	221	4	225
24	Centre	37	2	01	043	Cangey	1083	13	1096
24	Centre	37	3	08	044	La Celle-Guenand	395	5	400
24	Centre	37	3	09	045	La Celle-Saint-Avant	1038	19	1057
24	Centre	37	2	03	046	Céré-la-Ronde	446	10	456
24	Centre	37	2	16	047	Cerelles	1231	26	1257
24	Centre	37	3	18	048	Chambon	301	10	311
24	Centre	37	3	13	049	Chambourg-sur-Indre	1281	37	1318
24	Centre	37	2	34	050	Chambray-lès-Tours	10733	253	10986
24	Centre	37	1	19	051	Champigny-sur-Veude	865	27	892
24	Centre	37	3	13	053	Chanceaux-près-Loches	148	3	151
24	Centre	37	2	24	054	Chanceaux-sur-Choisille	3586	72	3658
24	Centre	37	2	05	055	Channay-sur-Lathan	817	14	831
24	Centre	37	2	24	052	Chançay	1091	19	1110
24	Centre	37	1	02	056	La Chapelle-aux-Naux	534	8	542
24	Centre	37	3	12	057	La Chapelle-Blanche-Saint-Martin	667	19	686
24	Centre	37	1	04	058	La Chapelle-sur-Loire	1528	32	1560
24	Centre	37	2	16	059	Charentilly	1094	25	1119
24	Centre	37	2	01	060	Chargé	1159	13	1172
24	Centre	37	3	18	061	Charnizay	496	14	510
24	Centre	37	2	05	062	Château-la-Vallière	1650	24	1674
24	Centre	37	2	06	063	Château-Renault	5181	110	5291
24	Centre	37	3	18	064	Chaumussay	249	8	257
24	Centre	37	1	19	065	Chaveignes	572	12	584
24	Centre	37	3	13	066	Chédigny	546	30	576
24	Centre	37	1	02	067	Cheillé	1657	27	1684
24	Centre	37	2	17	068	Chemillé-sur-Dême	679	9	688
24	Centre	37	3	15	069	Chemillé-sur-Indrois	226	18	244
24	Centre	37	2	03	070	Chenonceaux	356	10	366
24	Centre	37	1	10	071	Chezelles	137	1	138
24	Centre	37	1	07	072	Chinon	7894	468	8362
24	Centre	37	2	03	073	Chisseaux	637	10	647
24	Centre	37	1	04	074	Chouzé-sur-Loire	2071	37	2108
24	Centre	37	2	03	075	Cigogné	336	5	341
24	Centre	37	1	07	076	Cinais	446	18	464
24	Centre	37	1	11	077	Cinq-Mars-la-Pile	3369	40	3409
24	Centre	37	3	12	078	Ciran	440	11	451
24	Centre	37	2	03	079	Civray-de-Touraine	1815	57	1872
24	Centre	37	3	09	080	Civray-sur-Esves	221	12	233
24	Centre	37	1	11	081	Cléré-les-Pins	1304	15	1319
24	Centre	37	1	04	082	Continvoir	467	9	476
24	Centre	37	2	34	083	Cormery	1653	23	1676
24	Centre	37	2	05	084	Couesmes	531	6	537
24	Centre	37	2	05	086	Courcelles-de-Touraine	482	10	492
24	Centre	37	1	19	087	Courcoué	264	3	267
24	Centre	37	2	03	085	Courçay	834	17	851
24	Centre	37	1	07	088	Couziers	113	1	114
24	Centre	37	1	10	089	Cravant-les-Côteaux	723	19	742
24	Centre	37	1	10	090	Crissay-sur-Manse	118	6	124
24	Centre	37	2	03	091	La Croix-en-Touraine	2224	84	2308
24	Centre	37	2	06	092	Crotelles	640	8	648
24	Centre	37	1	10	093	Crouzilles	567	6	573
24	Centre	37	3	09	094	Cussay	586	25	611
24	Centre	37	2	06	095	Dame-Marie-les-Bois	313	8	321
24	Centre	37	3	09	115	Descartes	3815	65	3880
24	Centre	37	2	03	096	Dierre	572	10	582
24	Centre	37	3	13	097	Dolus-le-Sec	685	23	708
24	Centre	37	3	09	098	Draché	706	16	722
24	Centre	37	2	31	099	Druye	895	24	919
24	Centre	37	2	03	100	Épeigné-les-Bois	436	6	442
24	Centre	37	2	17	101	Épeigné-sur-Dême	159	2	161
24	Centre	37	1	11	102	Les Essards	155	2	157
24	Centre	37	3	12	103	Esves-le-Moutier	145	2	147
24	Centre	37	2	34	104	Esvres	4523	108	4631
24	Centre	37	1	19	105	Faye-la-Vineuse	295	7	302
24	Centre	37	2	06	106	La Ferrière	292	4	296
24	Centre	37	3	08	107	Ferrière-Larçon	273	12	285
24	Centre	37	3	13	108	Ferrière-sur-Beaulieu	735	9	744
24	Centre	37	2	36	109	Fondettes	10377	466	10843
24	Centre	37	2	03	110	Francueil	1297	27	1324
24	Centre	37	3	15	111	Genillé	1582	46	1628
24	Centre	37	1	04	112	Gizeux	449	40	489
24	Centre	37	3	08	113	Le Grand-Pressigny	997	25	1022
24	Centre	37	3	08	114	La Guerche	199	8	207
24	Centre	37	2	06	116	Les Hermites	568	10	578
24	Centre	37	2	05	117	Hommes	900	9	909
24	Centre	37	1	07	118	Huismes	1536	38	1574
24	Centre	37	1	10	119	L; Île-Bouchard	1721	38	1759
24	Centre	37	1	11	120	Ingrandes-de-Touraine	501	12	513
24	Centre	37	1	19	121	Jaulnay	253	6	259
24	Centre	37	2	98	122	Joué-lès-Tours	35976	549	36525
24	Centre	37	1	11	123	Langeais	4029	63	4092
24	Centre	37	2	37	124	Larçay	2391	46	2437
24	Centre	37	1	19	125	Lémeré	442	16	458
24	Centre	37	1	07	126	Lerné	319	21	340
24	Centre	37	3	15	127	Le Liège	345	5	350
24	Centre	37	1	02	128	Lignières-de-Touraine	1130	11	1141
24	Centre	37	1	19	129	Ligré	1029	32	1061
24	Centre	37	3	12	130	Ligueil	2222	33	2255
24	Centre	37	2	01	131	Limeray	1173	22	1195
24	Centre	37	3	15	133	Loché-sur-Indrois	505	41	546
24	Centre	37	3	13	132	Loches	6507	753	7260
24	Centre	37	3	12	134	Louans	601	9	610
24	Centre	37	2	17	135	Louestault	366	4	370
24	Centre	37	3	12	136	Le Louroux	473	16	489
24	Centre	37	2	05	137	Lublé	139	2	141
24	Centre	37	2	01	138	Lussault-sur-Loire	717	15	732
24	Centre	37	2	36	139	Luynes	5078	113	5191
24	Centre	37	1	19	140	Luzé	264	3	267
24	Centre	37	2	03	141	Luzillé	894	8	902
24	Centre	37	1	20	142	Maillé	604	13	617
24	Centre	37	3	12	143	Manthelan	1371	40	1411
24	Centre	37	3	09	145	Marcé-sur-Esves	236	3	239
24	Centre	37	2	05	146	Marcilly-sur-Maulne	225	4	229
24	Centre	37	1	20	147	Marcilly-sur-Vienne	561	9	570
24	Centre	37	1	19	148	Marigny-Marmande	605	1	606
24	Centre	37	2	17	149	Marray	410	13	423
24	Centre	37	1	07	144	Marçay	463	16	479
24	Centre	37	1	11	150	Mazières-de-Touraine	1303	5	1308
24	Centre	37	2	36	151	La Membrolle-sur-Choisille	3009	59	3068
24	Centre	37	2	36	152	Mettray	2104	95	2199
24	Centre	37	2	24	153	Monnaie	4011	64	4075
24	Centre	37	2	14	154	Montbazon	3933	81	4014
24	Centre	37	2	06	155	Monthodon	623	15	638
24	Centre	37	2	37	156	Montlouis-sur-Loire	10487	346	10833
24	Centre	37	3	15	157	Montrésor	338	17	355
24	Centre	37	2	01	158	Montreuil-en-Touraine	768	10	778
24	Centre	37	2	14	159	Monts	6962	118	7080
24	Centre	37	2	06	160	Morand	328	7	335
24	Centre	37	2	01	161	Mosnes	742	15	757
24	Centre	37	3	12	162	Mouzay	486	22	508
24	Centre	37	2	01	163	Nazelles-Négron	3522	62	3584
24	Centre	37	1	20	165	Neuil	439	13	452
24	Centre	37	2	24	166	Neuillé-le-Lierre	765	16	781
24	Centre	37	2	16	167	Neuillé-Pont-Pierre	1951	34	1985
24	Centre	37	3	09	168	Neuilly-le-Brignon	311	14	325
24	Centre	37	2	06	169	Neuville-sur-Brenne	802	7	809
24	Centre	37	2	17	170	Neuvy-le-Roi	1156	89	1245
24	Centre	37	2	24	171	Noizay	1155	20	1175
24	Centre	37	2	24	172	Notre-Dame-d;Oé	3998	80	4078
24	Centre	37	3	15	173	Nouans-les-Fontaines	791	20	811
24	Centre	37	1	20	174	Nouâtre	881	9	890
24	Centre	37	2	06	175	Nouzilly	1239	76	1315
24	Centre	37	1	20	176	Noyant-de-Touraine	991	17	1008
24	Centre	37	3	15	177	Orbigny	756	23	779
24	Centre	37	1	10	178	Panzoult	568	9	577
24	Centre	37	2	24	179	Parçay-Meslay	2304	46	2350
24	Centre	37	1	10	180	Parçay-sur-Vienne	655	10	665
24	Centre	37	3	08	181	Paulmy	243	7	250
24	Centre	37	2	16	182	Pernay	1055	23	1078
24	Centre	37	3	13	183	Perrusson	1538	68	1606
24	Centre	37	3	08	184	Le Petit-Pressigny	322	11	333
24	Centre	37	2	01	185	Pocé-sur-Cisse	1628	93	1721
24	Centre	37	2	14	186	Pont-de-Ruan	871	11	882
24	Centre	37	1	20	187	Ports	358	5	363
24	Centre	37	1	20	188	Pouzay	828	8	836
24	Centre	37	3	18	189	Preuilly-sur-Claise	1072	16	1088
24	Centre	37	1	20	190	Pussigny	190	1	191
24	Centre	37	1	19	191	Razines	240	1	241
24	Centre	37	3	13	192	Reignac-sur-Indre	1231	26	1257
24	Centre	37	1	04	193	Restigné	1198	37	1235
24	Centre	37	2	24	194	Reugny	1582	37	1619
24	Centre	37	2	31	195	La Riche	10080	199	10279
24	Centre	37	1	19	196	Richelieu	1941	43	1984
24	Centre	37	1	02	197	Rigny-Ussé	532	5	537
24	Centre	37	2	05	198	Rillé	307	7	314
24	Centre	37	1	10	199	Rilly-sur-Vienne	465	6	471
24	Centre	37	1	02	200	Rivarennes	1010	6	1016
24	Centre	37	1	07	201	Rivière	702	10	712
24	Centre	37	1	07	202	La Roche-Clermault	487	10	497
24	Centre	37	2	24	203	Rochecorbon	3311	72	3383
24	Centre	37	2	16	204	Rouziers-de-Touraine	1223	34	1257
24	Centre	37	1	02	205	Saché	1277	18	1295
24	Centre	37	2	16	206	Saint-Antoine-du-Rocher	1483	26	1509
24	Centre	37	2	17	207	Saint-Aubin-le-Dépeint	325	5	330
24	Centre	37	2	32	208	Saint-Avertin	13947	428	14375
24	Centre	37	3	13	209	Saint-Bauld	204	1	205
24	Centre	37	1	02	210	Saint-Benoît-la-Forêt	882	11	893
24	Centre	37	2	34	211	Saint-Branchs	2444	52	2496
24	Centre	37	2	17	213	Saint-Christophe-sur-le-Nais	1087	15	1102
24	Centre	37	2	29	214	Saint-Cyr-sur-Loire	16072	431	16503
24	Centre	37	1	20	216	Saint-Épain	1544	29	1573
24	Centre	37	2	36	217	Saint-Étienne-de-Chigny	1426	34	1460
24	Centre	37	3	08	218	Saint-Flovier	603	35	638
24	Centre	37	2	31	219	Saint-Genouph	1028	11	1039
24	Centre	37	1	07	220	Saint-Germain-sur-Vienne	376	7	383
24	Centre	37	3	13	221	Saint-Hippolyte	598	46	644
24	Centre	37	3	13	222	Saint-Jean-Saint-Germain	723	29	752
24	Centre	37	2	05	223	Saint-Laurent-de-Lin	300	2	302
24	Centre	37	2	06	224	Saint-Laurent-en-Gâtines	933	22	955
24	Centre	37	2	03	225	Saint-Martin-le-Beau	2902	47	2949
24	Centre	37	1	11	227	Saint-Michel-sur-Loire	629	9	638
24	Centre	37	1	04	228	Saint-Nicolas-de-Bourgueil	1177	29	1206
24	Centre	37	2	06	229	Saint-Nicolas-des-Motets	265	2	267
24	Centre	37	2	01	230	Saint-Ouen-les-Vignes	1031	29	1060
24	Centre	37	2	17	231	Saint-Paterne-Racan	1676	41	1717
24	Centre	37	1	11	232	Saint-Patrice	677	12	689
24	Centre	37	2	30	233	Saint-Pierre-des-Corps	15227	424	15651
24	Centre	37	3	13	234	Saint-Quentin-sur-Indrois	492	15	507
24	Centre	37	2	01	236	Saint-Règle	482	10	492
24	Centre	37	2	16	237	Saint-Roch	1243	23	1266
24	Centre	37	3	12	238	Saint-Senoch	500	17	517
24	Centre	37	1	20	212	Sainte-Catherine-de-Fierbois	652	4	656
24	Centre	37	1	20	226	Sainte-Maure-de-Touraine	4096	48	4144
24	Centre	37	2	06	240	Saunay	658	13	671
24	Centre	37	2	05	241	Savigné-sur-Lathan	1367	10	1377
24	Centre	37	1	07	242	Savigny-en-Véron	1453	49	1502
24	Centre	37	2	31	243	Savonnières	3118	70	3188
24	Centre	37	1	10	244	Sazilly	254	5	259
24	Centre	37	2	16	245	Semblançay	2082	38	2120
24	Centre	37	3	13	246	Sennevières	223	9	232
24	Centre	37	3	09	247	Sepmes	663	60	723
24	Centre	37	1	07	248	Seuilly	368	54	422
24	Centre	37	2	16	249	Sonzay	1294	25	1319
24	Centre	37	2	14	250	Sorigny	2203	99	2302
24	Centre	37	2	05	251	Souvigné	779	8	787
24	Centre	37	2	01	252	Souvigny-de-Touraine	372	4	376
24	Centre	37	2	03	253	Sublaines	178	2	180
24	Centre	37	3	13	254	Tauxigny	1242	38	1280
24	Centre	37	1	10	255	Tavant	262	3	265
24	Centre	37	1	10	256	Theneuil	314	4	318
24	Centre	37	1	02	257	Thilouze	1602	12	1614
24	Centre	37	1	07	258	Thizay	272	5	277
24	Centre	37	1	19	260	La Tour-Saint-Gelin	548	6	554
24	Centre	37	3	18	259	Tournon-Saint-Pierre	477	11	488
24	Centre	37	2	99	261	Tours	134817	3451	138268
24	Centre	37	1	10	262	Trogues	335	7	342
24	Centre	37	2	34	263	Truyes	2094	33	2127
24	Centre	37	1	02	264	Vallères	1128	20	1148
24	Centre	37	3	12	265	Varennes	238	4	242
24	Centre	37	2	14	266	Veigné	6091	136	6227
24	Centre	37	2	37	267	Véretz	4123	168	4291
24	Centre	37	1	19	268	Verneuil-le-Château	151	2	153
24	Centre	37	3	13	269	Verneuil-sur-Indre	512	34	546
24	Centre	37	2	24	270	Vernou-sur-Brenne	2678	32	2710
24	Centre	37	1	02	271	Villaines-les-Rochers	981	14	995
24	Centre	37	2	31	272	Villandry	1071	10	1081
24	Centre	37	2	37	273	La Ville-aux-Dames	4966	158	5124
24	Centre	37	2	17	274	Villebourg	281	1	282
24	Centre	37	3	15	275	Villedômain	131	2	133
24	Centre	37	2	06	276	Villedômer	1339	67	1406
24	Centre	37	3	15	277	Villeloin-Coulangé	649	25	674
24	Centre	37	2	14	278	Villeperdue	978	9	987
24	Centre	37	2	05	279	Villiers-au-Bouin	797	9	806
24	Centre	37	3	12	280	Vou	224	7	231
24	Centre	37	2	24	281	Vouvray	3069	103	3172
24	Centre	37	3	18	282	Yzeures-sur-Creuse	1445	38	1483
82	Rhône-Alpes	38	2	21	001	Les Abrets	3455	82	3537
82	Rhône-Alpes	38	1	10	002	Les Adrets	903	22	925
82	Rhône-Alpes	38	3	24	003	Agnin	969	19	988
82	Rhône-Alpes	38	1	42	004	L; Albenc	1091	22	1113
82	Rhône-Alpes	38	1	03	005	Allemond	871	34	905
82	Rhône-Alpes	38	1	01	006	Allevard	3783	80	3863
82	Rhône-Alpes	38	1	06	008	Ambel	23	0	23
82	Rhône-Alpes	38	3	24	009	Anjou	992	12	1004
82	Rhône-Alpes	38	2	08	010	Annoisin-Chatelans	634	14	648
82	Rhône-Alpes	38	3	46	011	Anthon	969	13	982
82	Rhône-Alpes	38	2	21	012	Aoste	2682	41	2723
82	Rhône-Alpes	38	2	11	013	Apprieu	3108	63	3171
82	Rhône-Alpes	38	2	19	014	Arandon	564	8	572
82	Rhône-Alpes	38	3	28	015	Artas	1620	23	1643
82	Rhône-Alpes	38	3	07	016	Arzay	216	14	230
82	Rhône-Alpes	38	3	24	017	Assieu	1316	28	1344
82	Rhône-Alpes	38	1	22	018	Auberives-en-Royans	359	12	371
82	Rhône-Alpes	38	3	24	019	Auberives-sur-Varèze	1487	17	1504
82	Rhône-Alpes	38	1	03	020	Auris	207	3	210
82	Rhône-Alpes	38	1	41	021	Autrans	1702	76	1778
82	Rhône-Alpes	38	2	19	022	Les Avenières	5430	122	5552
82	Rhône-Alpes	38	1	18	023	Avignonet	214	1	215
82	Rhône-Alpes	38	2	04	024	Badinières	606	20	626
82	Rhône-Alpes	38	3	07	025	Balbins	386	22	408
82	Rhône-Alpes	38	2	08	026	La Balme-les-Grottes	915	8	923
82	Rhône-Alpes	38	1	34	027	Barraux	1862	53	1915
82	Rhône-Alpes	38	2	27	028	La Bâtie-Divisin	897	17	914
82	Rhône-Alpes	38	2	21	029	La Bâtie-Montgascon	1771	42	1813
82	Rhône-Alpes	38	1	23	030	Beaucroissant	1477	23	1500
82	Rhône-Alpes	38	1	06	031	Beaufin	22	1	23
82	Rhône-Alpes	38	1	25	032	Beaufort	563	18	581
82	Rhône-Alpes	38	1	30	033	Beaulieu	626	9	635
82	Rhône-Alpes	38	3	02	034	Beaurepaire	4620	123	4743
82	Rhône-Alpes	38	3	28	035	Beauvoir-de-Marc	1028	19	1047
82	Rhône-Alpes	38	1	22	036	Beauvoir-en-Royans	74	5	79
82	Rhône-Alpes	38	3	02	037	Bellegarde-Poussieu	928	16	944
82	Rhône-Alpes	38	2	11	038	Belmont	463	7	470
82	Rhône-Alpes	38	1	60	039	Bernin	2991	118	3109
82	Rhône-Alpes	38	1	03	040	Besse	142	1	143
82	Rhône-Alpes	38	1	30	041	Bessins	129	2	131
82	Rhône-Alpes	38	2	11	042	Bévenais	928	27	955
82	Rhône-Alpes	38	2	43	043	Bilieu	1274	29	1303
82	Rhône-Alpes	38	2	11	044	Biol	1373	42	1415
82	Rhône-Alpes	38	1	60	045	Biviers	2360	150	2510
82	Rhône-Alpes	38	2	11	046	Bizonnes	835	11	846
82	Rhône-Alpes	38	2	43	047	Blandin	140	1	141
82	Rhône-Alpes	38	2	37	048	Bonnefamille	1015	24	1039
82	Rhône-Alpes	38	3	07	049	Bossieu	271	9	280
82	Rhône-Alpes	38	2	19	050	Le Bouchage	582	8	590
82	Rhône-Alpes	38	3	24	051	Bougé-Chambalud	1252	20	1272
82	Rhône-Alpes	38	1	03	052	Le Bourg-d;Oisans	3327	121	3448
82	Rhône-Alpes	38	2	94	053	Bourgoin-Jallieu	26173	668	26841
82	Rhône-Alpes	38	2	19	054	Bouvesse-Quirieu	1418	35	1453
82	Rhône-Alpes	38	2	19	055	Brangues	585	10	595
82	Rhône-Alpes	38	1	26	056	Bressieux	90	24	114
82	Rhône-Alpes	38	1	47	057	Bresson	692	31	723
82	Rhône-Alpes	38	1	26	058	Brézins	1759	36	1795
82	Rhône-Alpes	38	1	44	059	Brié-et-Angonnes	2416	44	2460
82	Rhône-Alpes	38	1	26	060	Brion	130	2	132
82	Rhône-Alpes	38	1	45	061	La Buisse	2814	71	2885
82	Rhône-Alpes	38	1	34	062	La Buissière	663	22	685
82	Rhône-Alpes	38	2	11	063	Burcin	451	9	460
82	Rhône-Alpes	38	2	33	064	Cessieu	2652	47	2699
82	Rhône-Alpes	38	2	11	065	Châbons	1844	59	1903
82	Rhône-Alpes	38	3	02	066	Châlons	165	8	173
82	Rhône-Alpes	38	2	08	067	Chamagnieu	1487	44	1531
82	Rhône-Alpes	38	1	10	070	Le Champ-près-Froges	1250	13	1263
82	Rhône-Alpes	38	1	44	071	Champ-sur-Drac	3136	36	3172
82	Rhône-Alpes	38	1	44	068	Champagnier	1256	25	1281
82	Rhône-Alpes	38	3	07	069	Champier	1242	9	1251
82	Rhône-Alpes	38	1	93	567	Chamrousse	453	5	458
82	Rhône-Alpes	38	3	24	072	Chanas	2339	38	2377
82	Rhône-Alpes	38	1	36	073	Chantelouve	76	0	76
82	Rhône-Alpes	38	1	42	074	Chantesse	315	5	320
82	Rhône-Alpes	38	1	34	075	Chapareillan	2747	53	2800
82	Rhône-Alpes	38	2	33	076	La Chapelle-de-la-Tour	1664	40	1704
82	Rhône-Alpes	38	3	24	077	La Chapelle-de-Surieu	686	13	699
82	Rhône-Alpes	38	1	01	078	La Chapelle-du-Bard	504	14	518
82	Rhône-Alpes	38	2	27	080	Charancieu	714	22	736
82	Rhône-Alpes	38	3	15	081	Charantonnay	1880	42	1922
82	Rhône-Alpes	38	2	43	082	Charavines	1784	25	1809
82	Rhône-Alpes	38	2	19	083	Charette	461	5	466
82	Rhône-Alpes	38	1	23	084	Charnècles	1481	40	1521
82	Rhône-Alpes	38	3	46	085	Charvieu-Chavagneux	7722	96	7818
82	Rhône-Alpes	38	3	38	087	Chasse-sur-Rhône	5267	53	5320
82	Rhône-Alpes	38	1	42	086	Chasselay	431	6	437
82	Rhône-Alpes	38	2	43	089	Chassignieu	206	6	212
82	Rhône-Alpes	38	1	18	090	Château-Bernard	280	14	294
82	Rhône-Alpes	38	2	04	091	Châteauvilain	630	9	639
82	Rhône-Alpes	38	1	22	092	Châtelus	87	1	88
82	Rhône-Alpes	38	1	25	093	Châtenay	428	8	436
82	Rhône-Alpes	38	3	28	094	Châtonnay	1861	30	1891
82	Rhône-Alpes	38	1	30	095	Chatte	2406	223	2629
82	Rhône-Alpes	38	3	46	097	Chavanoz	4288	65	4353
82	Rhône-Alpes	38	2	43	098	Chélieu	661	14	675
82	Rhône-Alpes	38	1	30	099	Chevrières	693	17	710
82	Rhône-Alpes	38	1	10	100	Le Cheylas	2673	49	2722
82	Rhône-Alpes	38	3	24	101	Cheyssieu	1047	19	1066
82	Rhône-Alpes	38	2	37	102	Chèzeneuve	499	8	507
82	Rhône-Alpes	38	1	05	103	Chichilianne	274	8	282
82	Rhône-Alpes	38	2	21	104	Chimilin	1359	28	1387
82	Rhône-Alpes	38	1	45	105	Chirens	2197	42	2239
82	Rhône-Alpes	38	1	20	106	Cholonge	322	4	326
82	Rhône-Alpes	38	3	39	107	Chonas-l;Amballan	1545	42	1587
82	Rhône-Alpes	38	1	22	108	Choranche	131	4	135
82	Rhône-Alpes	38	2	08	109	Chozeau	1040	27	1067
82	Rhône-Alpes	38	3	38	110	Chuzelles	2052	32	2084
82	Rhône-Alpes	38	1	40	111	Claix	7538	216	7754
82	Rhône-Alpes	38	1	03	112	Clavans-en-Haut-Oisans	113	3	116
82	Rhône-Alpes	38	1	05	113	Clelles	510	11	521
82	Rhône-Alpes	38	3	24	114	Clonas-sur-Varèze	1495	36	1531
82	Rhône-Alpes	38	1	20	116	Cognet	50	1	51
82	Rhône-Alpes	38	1	42	117	Cognin-les-Gorges	656	18	674
82	Rhône-Alpes	38	2	11	118	Colombe	1439	47	1486
82	Rhône-Alpes	38	1	09	120	La Combe-de-Lancey	705	14	719
82	Rhône-Alpes	38	3	07	121	Commelle	794	16	810
82	Rhône-Alpes	38	2	21	124	Corbelin	2124	47	2171
82	Rhône-Alpes	38	1	16	125	Cordéac	205	3	208
82	Rhône-Alpes	38	1	50	126	Corenc	3851	183	4034
82	Rhône-Alpes	38	1	16	127	Cornillon-en-Trièves	173	4	177
82	Rhône-Alpes	38	1	06	128	Corps	511	8	519
82	Rhône-Alpes	38	1	41	129	Corrençon-en-Vercors	359	17	376
82	Rhône-Alpes	38	3	07	130	La Côte-Saint-André	4833	320	5153
82	Rhône-Alpes	38	3	39	131	Les Côtes-d;Arey	1937	53	1990
82	Rhône-Alpes	38	1	06	132	Les Côtes-de-Corps	66	1	67
82	Rhône-Alpes	38	1	45	133	Coublevie	4296	246	4542
82	Rhône-Alpes	38	3	02	134	Cour-et-Buis	851	7	858
82	Rhône-Alpes	38	2	19	135	Courtenay	1201	20	1221
82	Rhône-Alpes	38	2	04	136	Crachier	471	13	484
82	Rhône-Alpes	38	1	35	137	Cras	467	9	476
82	Rhône-Alpes	38	2	08	138	Crémieu	3347	65	3412
82	Rhône-Alpes	38	2	19	139	Creys-Mépieu	1405	27	1432
82	Rhône-Alpes	38	1	34	140	Crolles	8451	324	8775
82	Rhône-Alpes	38	3	28	141	Culin	662	15	677
82	Rhône-Alpes	38	3	15	144	Diémoz	2626	61	2687
82	Rhône-Alpes	38	1	30	145	Dionay	121	1	122
82	Rhône-Alpes	38	2	08	146	Dizimieu	651	29	680
82	Rhône-Alpes	38	2	43	147	Doissin	851	13	864
82	Rhône-Alpes	38	2	33	148	Dolomieu	2956	72	3028
82	Rhône-Alpes	38	2	04	149	Domarin	1415	41	1456
82	Rhône-Alpes	38	1	09	150	Domène	6626	78	6704
82	Rhône-Alpes	38	1	95	151	Échirolles	35748	306	36054
82	Rhône-Alpes	38	3	28	152	Eclose	713	13	726
82	Rhône-Alpes	38	1	41	153	Engins	496	9	505
82	Rhône-Alpes	38	1	36	154	Entraigues	240	8	248
82	Rhône-Alpes	38	1	29	155	Entre-deux-Guiers	1766	31	1797
82	Rhône-Alpes	38	2	04	156	Les Éparres	901	27	928
82	Rhône-Alpes	38	3	39	157	Estrablin	3264	84	3348
82	Rhône-Alpes	38	1	55	158	Eybens	9582	158	9740
82	Rhône-Alpes	38	2	11	159	Eydoche	477	13	490
82	Rhône-Alpes	38	3	39	160	Eyzin-Pinet	2150	124	2274
82	Rhône-Alpes	38	3	07	161	Faramans	935	18	953
82	Rhône-Alpes	38	2	33	162	Faverges-de-la-Tour	1285	38	1323
82	Rhône-Alpes	38	1	01	163	La Ferrière	228	6	234
82	Rhône-Alpes	38	2	21	165	Fitilieu	1709	45	1754
82	Rhône-Alpes	38	1	34	166	La Flachère	446	6	452
82	Rhône-Alpes	38	2	11	167	Flachères	496	12	508
82	Rhône-Alpes	38	1	96	169	Fontaine	22243	242	22485
82	Rhône-Alpes	38	1	51	170	Fontanil-Cornillon	2818	43	2861
82	Rhône-Alpes	38	1	26	171	La Forteresse	297	7	304
82	Rhône-Alpes	38	2	37	172	Four	1120	26	1146
82	Rhône-Alpes	38	1	03	173	Le Freney-d;Oisans	265	10	275
82	Rhône-Alpes	38	1	26	174	La Frette	1085	15	1100
82	Rhône-Alpes	38	1	10	175	Froges	3435	39	3474
82	Rhône-Alpes	38	2	08	176	Frontonas	1931	62	1993
82	Rhône-Alpes	38	1	03	177	La Garde	114	3	117
82	Rhône-Alpes	38	1	55	179	Gières	6118	91	6209
82	Rhône-Alpes	38	3	07	180	Gillonnay	975	36	1011
82	Rhône-Alpes	38	1	10	181	Goncelin	2173	49	2222
82	Rhône-Alpes	38	2	11	182	Le Grand-Lemps	2940	71	3011
82	Rhône-Alpes	38	2	21	183	Granieu	447	5	452
82	Rhône-Alpes	38	3	15	184	Grenay	1453	28	1481
82	Rhône-Alpes	38	1	98	185	Grenoble	155637	2612	158249
82	Rhône-Alpes	38	1	18	186	Gresse-en-Vercors	406	7	413
82	Rhône-Alpes	38	1	40	187	Le Gua	1887	37	1924
82	Rhône-Alpes	38	1	55	188	Herbeys	1343	28	1371
82	Rhône-Alpes	38	3	15	189	Heyrieux	4756	60	4816
82	Rhône-Alpes	38	2	08	190	Hières-sur-Amby	1149	20	1169
82	Rhône-Alpes	38	1	03	191	Huez	1368	32	1400
82	Rhône-Alpes	38	1	10	192	Hurtières	176	6	182
82	Rhône-Alpes	38	2	58	193	L; Isle-d;Abeau	15586	394	15980
82	Rhône-Alpes	38	1	23	194	Izeaux	2111	37	2148
82	Rhône-Alpes	38	1	22	195	Izeron	776	19	795
82	Rhône-Alpes	38	3	46	197	Janneyrias	1485	32	1517
82	Rhône-Alpes	38	3	02	198	Jarcieu	1036	21	1057
82	Rhône-Alpes	38	3	39	199	Jardin	2241	101	2342
82	Rhône-Alpes	38	1	44	200	Jarrie	3853	67	3920
82	Rhône-Alpes	38	1	44	203	Laffrey	382	7	389
82	Rhône-Alpes	38	1	05	204	Lalley	210	2	212
82	Rhône-Alpes	38	1	41	205	Lans-en-Vercors	2557	120	2677
82	Rhône-Alpes	38	1	09	206	Laval	962	22	984
82	Rhône-Alpes	38	1	36	207	Lavaldens	157	6	163
82	Rhône-Alpes	38	1	16	208	Lavars	138	5	143
82	Rhône-Alpes	38	1	25	209	Lentiol	215	4	219
82	Rhône-Alpes	38	2	08	210	Leyrieu	724	9	733
82	Rhône-Alpes	38	3	28	211	Lieudieu	292	9	301
82	Rhône-Alpes	38	1	03	212	Livet-et-Gavet	1226	11	1237
82	Rhône-Alpes	38	2	11	213	Longechenal	570	15	585
82	Rhône-Alpes	38	1	34	214	Lumbin	1969	48	2017
82	Rhône-Alpes	38	3	38	215	Luzinay	2206	49	2255
82	Rhône-Alpes	38	1	42	216	Malleval-en-Vercors	51	1	52
82	Rhône-Alpes	38	1	20	217	Marcieu	70	4	74
82	Rhône-Alpes	38	1	25	218	Marcilloles	998	15	1013
82	Rhône-Alpes	38	1	25	219	Marcollin	629	12	641
82	Rhône-Alpes	38	1	25	221	Marnans	147	5	152
82	Rhône-Alpes	38	2	27	222	Massieu	762	18	780
82	Rhône-Alpes	38	2	04	223	Maubec	1608	43	1651
82	Rhône-Alpes	38	1	20	224	Mayres-Savel	106	0	106
82	Rhône-Alpes	38	1	41	225	Méaudre	1350	124	1474
82	Rhône-Alpes	38	1	16	226	Mens	1387	54	1441
82	Rhône-Alpes	38	2	27	228	Merlas	496	15	511
82	Rhône-Alpes	38	1	50	229	Meylan	17487	578	18065
82	Rhône-Alpes	38	2	04	230	Meyrié	1001	45	1046
82	Rhône-Alpes	38	3	28	231	Meyrieu-les-Étangs	868	44	912
82	Rhône-Alpes	38	3	28	232	Meyssiès	602	1	603
82	Rhône-Alpes	38	1	18	235	Miribel-Lanchâtre	375	6	381
82	Rhône-Alpes	38	1	29	236	Miribel-les-Échelles	1743	52	1795
82	Rhône-Alpes	38	1	03	237	Mizoën	193	1	194
82	Rhône-Alpes	38	3	39	238	Moidieu-Détourbe	1790	43	1833
82	Rhône-Alpes	38	1	23	239	Moirans	7780	129	7909
82	Rhône-Alpes	38	3	02	240	Moissieu-sur-Dolon	701	13	714
82	Rhône-Alpes	38	1	06	241	Monestier-d;Ambel	23	0	23
82	Rhône-Alpes	38	1	18	242	Monestier-de-Clermont	1273	10	1283
82	Rhône-Alpes	38	1	05	243	Le Monestier-du-Percy	239	2	241
82	Rhône-Alpes	38	3	02	244	Monsteroux-Milieu	741	11	752
82	Rhône-Alpes	38	1	03	253	Mont-de-Lans	1255	17	1272
82	Rhône-Alpes	38	1	51	258	Mont-Saint-Martin	88	5	93
82	Rhône-Alpes	38	1	30	245	Montagne	265	14	279
82	Rhône-Alpes	38	2	33	246	Montagnieu	896	24	920
82	Rhône-Alpes	38	2	19	247	Montalieu-Vercieu	3189	39	3228
82	Rhône-Alpes	38	1	35	248	Montaud	526	10	536
82	Rhône-Alpes	38	1	60	249	Montbonnot-Saint-Martin	4651	532	5183
82	Rhône-Alpes	38	2	33	250	Montcarra	475	10	485
82	Rhône-Alpes	38	1	44	252	Montchaboud	369	7	376
82	Rhône-Alpes	38	1	20	254	Monteynard	478	11	489
82	Rhône-Alpes	38	1	25	255	Montfalcon	126	1	127
82	Rhône-Alpes	38	2	27	256	Montferrat	1588	33	1621
82	Rhône-Alpes	38	2	43	257	Montrevel	473	7	480
82	Rhône-Alpes	38	3	02	259	Montseveroux	884	20	904
82	Rhône-Alpes	38	2	08	260	Moras	470	5	475
82	Rhône-Alpes	38	2	19	261	Morestel	4201	101	4302
82	Rhône-Alpes	38	1	10	262	Morêtel-de-Mailles	400	6	406
82	Rhône-Alpes	38	1	35	263	Morette	386	14	400
82	Rhône-Alpes	38	1	36	264	La Morte	156	3	159
82	Rhône-Alpes	38	1	20	265	La Motte-d;Aveillans	1794	35	1829
82	Rhône-Alpes	38	1	20	266	La Motte-Saint-Martin	413	7	420
82	Rhône-Alpes	38	3	07	267	Mottier	687	10	697
82	Rhône-Alpes	38	1	01	268	Le Moutaret	222	5	227
82	Rhône-Alpes	38	1	20	269	La Mure	5091	252	5343
82	Rhône-Alpes	38	1	23	270	La Murette	1795	47	1842
82	Rhône-Alpes	38	1	09	271	Murianette	874	15	889
82	Rhône-Alpes	38	1	30	272	Murinais	381	9	390
82	Rhône-Alpes	38	1	20	273	Nantes-en-Ratier	479	26	505
82	Rhône-Alpes	38	3	07	274	Nantoin	439	12	451
82	Rhône-Alpes	38	2	04	276	Nivolas-Vermelle	2339	42	2381
82	Rhône-Alpes	38	1	44	277	Notre-Dame-de-Commiers	475	13	488
82	Rhône-Alpes	38	1	42	278	Notre-Dame-de-l;Osier	499	12	511
82	Rhône-Alpes	38	1	44	279	Notre-Dame-de-Mésage	1198	21	1219
82	Rhône-Alpes	38	1	20	280	Notre-Dame-de-Vaulx	542	17	559
82	Rhône-Alpes	38	1	32	281	Noyarey	2243	101	2344
82	Rhône-Alpes	38	2	08	282	Optevoz	760	5	765
82	Rhône-Alpes	38	1	36	283	Oris-en-Rattier	111	2	113
82	Rhône-Alpes	38	3	07	284	Ornacieux	403	11	414
82	Rhône-Alpes	38	1	03	285	Ornon	131	11	142
82	Rhône-Alpes	38	1	03	286	Oulles	12	0	12
82	Rhône-Alpes	38	2	43	287	Oyeu	919	11	930
82	Rhône-Alpes	38	3	15	288	Oytier-Saint-Oblas	1581	20	1601
82	Rhône-Alpes	38	1	03	289	Oz	221	8	229
82	Rhône-Alpes	38	3	02	290	Pact	829	17	846
82	Rhône-Alpes	38	3	07	291	Pajay	1050	26	1076
82	Rhône-Alpes	38	2	27	292	Paladru	1087	21	1108
82	Rhône-Alpes	38	2	43	293	Panissage	451	6	457
82	Rhône-Alpes	38	2	08	294	Panossas	605	8	613
82	Rhône-Alpes	38	2	08	295	Parmilieu	651	11	662
82	Rhône-Alpes	38	2	43	296	Le Passage	766	23	789
82	Rhône-Alpes	38	2	19	297	Passins	1120	14	1134
82	Rhône-Alpes	38	3	24	298	Le Péage-de-Roussillon	6751	84	6835
82	Rhône-Alpes	38	1	06	299	Pellafol	137	7	144
82	Rhône-Alpes	38	3	07	300	Penol	322	10	332
82	Rhône-Alpes	38	1	05	301	Percy	138	2	140
82	Rhône-Alpes	38	1	36	302	Le Périer	141	4	145
82	Rhône-Alpes	38	1	10	303	La Pierre	428	4	432
82	Rhône-Alpes	38	1	20	304	Pierre-Châtel	1333	31	1364
82	Rhône-Alpes	38	2	43	305	Le Pin	1231	34	1265
82	Rhône-Alpes	38	1	01	306	Pinsot	200	5	205
82	Rhône-Alpes	38	3	02	307	Pisieu	528	8	536
82	Rhône-Alpes	38	1	26	308	Plan	246	3	249
82	Rhône-Alpes	38	1	55	309	Poisat	2078	33	2111
82	Rhône-Alpes	38	1	35	310	Poliénas	1098	15	1113
82	Rhône-Alpes	38	3	02	311	Pommier-de-Beaurepaire	694	16	710
82	Rhône-Alpes	38	1	45	312	Pommiers-la-Placette	568	26	594
82	Rhône-Alpes	38	1	20	313	Ponsonnas	272	16	288
82	Rhône-Alpes	38	2	21	315	Le Pont-de-Beauvoisin	3453	137	3590
82	Rhône-Alpes	38	3	46	316	Pont-de-Chéruy	5143	53	5196
82	Rhône-Alpes	38	1	40	317	Le Pont-de-Claix	11268	118	11386
82	Rhône-Alpes	38	1	22	319	Pont-en-Royans	835	36	871
82	Rhône-Alpes	38	3	38	318	Pont-Évêque	5041	83	5124
82	Rhône-Alpes	38	1	10	314	Pontcharra	7162	199	7361
82	Rhône-Alpes	38	2	19	320	Porcieu-Amblagnieu	1603	32	1635
82	Rhône-Alpes	38	1	16	321	Prébois	163	5	168
82	Rhône-Alpes	38	1	22	322	Presles	99	2	101
82	Rhône-Alpes	38	2	21	323	Pressins	1102	37	1139
82	Rhône-Alpes	38	3	02	324	Primarette	720	14	734
82	Rhône-Alpes	38	1	51	325	Proveysieux	522	11	533
82	Rhône-Alpes	38	1	20	326	Prunières	376	9	385
82	Rhône-Alpes	38	1	51	328	Quaix-en-Chartreuse	924	19	943
82	Rhône-Alpes	38	1	06	329	Quet-en-Beaumont	64	0	64
82	Rhône-Alpes	38	1	35	330	Quincieu	81	0	81
82	Rhône-Alpes	38	1	23	331	Réaumont	964	26	990
82	Rhône-Alpes	38	1	23	332	Renage	3717	58	3775
82	Rhône-Alpes	38	1	22	333	Rencurel	304	9	313
82	Rhône-Alpes	38	1	09	334	Revel	1377	24	1401
82	Rhône-Alpes	38	3	02	335	Revel-Tourdan	1024	23	1047
82	Rhône-Alpes	38	3	39	336	Reventin-Vaugris	1765	59	1824
82	Rhône-Alpes	38	1	23	337	Rives	6062	91	6153
82	Rhône-Alpes	38	1	35	338	La Rivière	637	15	652
82	Rhône-Alpes	38	2	37	339	Roche	1878	37	1915
82	Rhône-Alpes	38	3	39	340	Les Roches-de-Condrieu	1957	29	1986
82	Rhône-Alpes	38	2	33	341	Rochetoirin	1034	32	1066
82	Rhône-Alpes	38	1	18	342	Roissard	251	2	253
82	Rhône-Alpes	38	2	21	343	Romagnieu	1433	42	1475
82	Rhône-Alpes	38	3	24	344	Roussillon	7964	164	8128
82	Rhône-Alpes	38	1	42	345	Rovon	593	12	605
82	Rhône-Alpes	38	3	28	346	Royas	386	8	394
82	Rhône-Alpes	38	1	25	347	Roybon	1297	40	1337
82	Rhône-Alpes	38	2	53	348	Ruy	4198	158	4356
82	Rhône-Alpes	38	3	24	349	Sablons	2031	54	2085
82	Rhône-Alpes	38	3	28	351	Saint-Agnin-sur-Bion	835	21	856
82	Rhône-Alpes	38	2	04	352	Saint-Alban-de-Roche	1811	54	1865
82	Rhône-Alpes	38	3	24	353	Saint-Alban-du-Rhône	865	15	880
82	Rhône-Alpes	38	2	21	354	Saint-Albin-de-Vaulserre	371	7	378
82	Rhône-Alpes	38	1	18	355	Saint-Andéol	116	5	121
82	Rhône-Alpes	38	1	22	356	Saint-André-en-Royans	326	8	334
82	Rhône-Alpes	38	2	21	357	Saint-André-le-Gaz	2522	164	2686
82	Rhône-Alpes	38	1	30	359	Saint-Antoine-l;Abbaye	1016	16	1032
82	Rhône-Alpes	38	1	30	360	Saint-Appolinard	398	6	404
82	Rhône-Alpes	38	1	20	361	Saint-Arey	79	1	80
82	Rhône-Alpes	38	1	45	362	Saint-Aupre	1077	33	1110
82	Rhône-Alpes	38	3	02	363	Saint-Barthélemy	961	46	1007
82	Rhône-Alpes	38	1	44	364	Saint-Barthélemy-de-Séchilienne	471	6	477
82	Rhône-Alpes	38	2	08	365	Saint-Baudille-de-la-Tour	744	17	761
82	Rhône-Alpes	38	1	16	366	Saint-Baudille-et-Pipet	254	10	264
82	Rhône-Alpes	38	1	34	367	Saint-Bernard	632	37	669
82	Rhône-Alpes	38	1	23	368	Saint-Blaise-du-Buis	993	17	1010
82	Rhône-Alpes	38	1	30	370	Saint-Bonnet-de-Chavagne	628	7	635
82	Rhône-Alpes	38	2	27	372	Saint-Bueil	700	19	719
82	Rhône-Alpes	38	1	23	373	Saint-Cassien	1107	24	1131
82	Rhône-Alpes	38	2	53	374	Saint-Chef	3493	105	3598
82	Rhône-Alpes	38	1	03	375	Saint-Christophe-en-Oisans	114	3	117
82	Rhône-Alpes	38	1	29	376	Saint-Christophe-sur-Guiers	798	11	809
82	Rhône-Alpes	38	2	33	377	Saint-Clair-de-la-Tour	3428	48	3476
82	Rhône-Alpes	38	3	24	378	Saint-Clair-du-Rhône	3890	68	3958
82	Rhône-Alpes	38	1	25	379	Saint-Clair-sur-Galaure	272	8	280
82	Rhône-Alpes	38	2	11	380	Saint-Didier-de-Bizonnes	288	4	292
82	Rhône-Alpes	38	2	33	381	Saint-Didier-de-la-Tour	1813	46	1859
82	Rhône-Alpes	38	1	51	382	Saint-Égrève	16006	349	16355
82	Rhône-Alpes	38	1	45	383	Saint-Étienne-de-Crossey	2545	139	2684
82	Rhône-Alpes	38	1	26	384	Saint-Étienne-de-Saint-Geoirs	2917	52	2969
82	Rhône-Alpes	38	2	27	386	Saint-Geoire-en-Valdaine	2402	60	2462
82	Rhône-Alpes	38	1	26	387	Saint-Geoirs	497	2	499
82	Rhône-Alpes	38	3	15	389	Saint-Georges-d;Espéranche	3208	57	3265
82	Rhône-Alpes	38	1	44	388	Saint-Georges-de-Commiers	2102	45	2147
82	Rhône-Alpes	38	1	42	390	Saint-Gervais	574	7	581
82	Rhône-Alpes	38	1	18	391	Saint-Guillaume	282	3	285
82	Rhône-Alpes	38	1	34	395	Saint-Hilaire	1532	33	1565
82	Rhône-Alpes	38	2	08	392	Saint-Hilaire-de-Brens	516	9	525
82	Rhône-Alpes	38	3	07	393	Saint-Hilaire-de-la-Côte	1434	46	1480
82	Rhône-Alpes	38	1	30	394	Saint-Hilaire-du-Rosier	1987	52	2039
82	Rhône-Alpes	38	1	20	396	Saint-Honoré	814	24	838
82	Rhône-Alpes	38	1	60	397	Saint-Ismier	6381	353	6734
82	Rhône-Alpes	38	2	21	398	Saint-Jean-d;Avelanne	901	18	919
82	Rhône-Alpes	38	1	16	403	Saint-Jean-d;Hérans	297	10	307
82	Rhône-Alpes	38	3	28	399	Saint-Jean-de-Bournay	4366	100	4466
82	Rhône-Alpes	38	1	23	400	Saint-Jean-de-Moirans	3090	73	3163
82	Rhône-Alpes	38	2	33	401	Saint-Jean-de-Soudain	1430	32	1462
82	Rhône-Alpes	38	1	44	402	Saint-Jean-de-Vaulx	552	9	561
82	Rhône-Alpes	38	1	09	404	Saint-Jean-le-Vieux	243	8	251
82	Rhône-Alpes	38	1	29	405	Saint-Joseph-de-Rivière	1145	29	1174
82	Rhône-Alpes	38	3	02	406	Saint-Julien-de-l;Herms	144	2	146
82	Rhône-Alpes	38	1	45	407	Saint-Julien-de-Raz	434	9	443
82	Rhône-Alpes	38	3	15	408	Saint-Just-Chaleyssin	2468	36	2504
82	Rhône-Alpes	38	1	22	409	Saint-Just-de-Claix	1219	14	1233
82	Rhône-Alpes	38	1	30	410	Saint-Lattier	1265	31	1296
82	Rhône-Alpes	38	1	29	412	Saint-Laurent-du-Pont	4484	79	4563
82	Rhône-Alpes	38	1	06	413	Saint-Laurent-en-Beaumont	444	3	447
82	Rhône-Alpes	38	2	53	415	Saint-Marcel-Bel-Accueil	1296	43	1339
82	Rhône-Alpes	38	1	30	416	Saint-Marcellin	8062	221	8283
82	Rhône-Alpes	38	1	97	421	Saint-Martin-d;Hères	36177	327	36504
82	Rhône-Alpes	38	1	09	422	Saint-Martin-d;Uriage	5446	175	5621
82	Rhône-Alpes	38	1	05	419	Saint-Martin-de-Clelles	160	9	169
82	Rhône-Alpes	38	1	18	115	Saint-Martin-de-la-Cluze	607	13	620
82	Rhône-Alpes	38	2	21	420	Saint-Martin-de-Vaulserre	254	12	266
82	Rhône-Alpes	38	1	51	423	Saint-Martin-le-Vinoux	5357	80	5437
82	Rhône-Alpes	38	1	05	424	Saint-Maurice-en-Trièves	168	7	175
82	Rhône-Alpes	38	3	24	425	Saint-Maurice-l;Exil	5845	209	6054
82	Rhône-Alpes	38	1	10	426	Saint-Maximin	641	17	658
82	Rhône-Alpes	38	1	26	427	Saint-Michel-de-Saint-Geoirs	293	12	305
82	Rhône-Alpes	38	1	06	428	Saint-Michel-en-Beaumont	37	0	37
82	Rhône-Alpes	38	1	05	429	Saint-Michel-les-Portes	248	6	254
82	Rhône-Alpes	38	1	09	430	Saint-Mury-Monteymond	349	10	359
82	Rhône-Alpes	38	1	60	431	Saint-Nazaire-les-Eymes	2907	73	2980
82	Rhône-Alpes	38	1	45	432	Saint-Nicolas-de-Macherin	887	38	925
82	Rhône-Alpes	38	1	41	433	Saint-Nizier-du-Moucherotte	1030	39	1069
82	Rhône-Alpes	38	2	43	434	Saint-Ondras	597	6	603
82	Rhône-Alpes	38	1	34	435	Saint-Pancrasse	438	25	463
82	Rhône-Alpes	38	1	35	437	Saint-Paul-d;Izeaux	314	10	324
82	Rhône-Alpes	38	1	40	436	Saint-Paul-de-Varces	2167	54	2221
82	Rhône-Alpes	38	1	18	438	Saint-Paul-lès-Monestier	260	4	264
82	Rhône-Alpes	38	1	01	439	Saint-Pierre-d;Allevard	2799	48	2847
82	Rhône-Alpes	38	1	29	446	Saint-Pierre-d;Entremont	559	18	577
82	Rhône-Alpes	38	1	26	440	Saint-Pierre-de-Bressieux	684	21	705
82	Rhône-Alpes	38	1	29	442	Saint-Pierre-de-Chartreuse	1011	23	1034
82	Rhône-Alpes	38	1	22	443	Saint-Pierre-de-Chérennes	476	10	486
82	Rhône-Alpes	38	1	06	444	Saint-Pierre-de-Méaroz	137	3	140
82	Rhône-Alpes	38	1	44	445	Saint-Pierre-de-Mésage	719	11	730
82	Rhône-Alpes	38	3	24	448	Saint-Prim	1200	20	1220
82	Rhône-Alpes	38	2	37	449	Saint-Quentin-Fallavier	5922	92	6014
82	Rhône-Alpes	38	1	35	450	Saint-Quentin-sur-Isère	1311	23	1334
82	Rhône-Alpes	38	2	08	451	Saint-Romain-de-Jalionas	3147	50	3197
82	Rhône-Alpes	38	3	24	452	Saint-Romain-de-Surieu	324	12	336
82	Rhône-Alpes	38	1	22	453	Saint-Romans	1742	29	1771
82	Rhône-Alpes	38	1	30	454	Saint-Sauveur	1927	42	1969
82	Rhône-Alpes	38	2	53	455	Saint-Savin	3566	89	3655
82	Rhône-Alpes	38	1	16	456	Saint-Sébastien	255	8	263
82	Rhône-Alpes	38	1	26	457	Saint-Siméon-de-Bressieux	2777	121	2898
82	Rhône-Alpes	38	2	19	458	Saint-Sorlin-de-Morestel	543	22	565
82	Rhône-Alpes	38	3	39	459	Saint-Sorlin-de-Vienne	821	15	836
82	Rhône-Alpes	38	2	27	460	Saint-Sulpice-des-Rivoires	450	15	465
82	Rhône-Alpes	38	1	20	462	Saint-Théoffrey	449	8	457
82	Rhône-Alpes	38	1	30	463	Saint-Vérand	1823	43	1866
82	Rhône-Alpes	38	2	33	464	Saint-Victor-de-Cessieu	2144	34	2178
82	Rhône-Alpes	38	2	19	465	Saint-Victor-de-Morestel	1125	21	1146
82	Rhône-Alpes	38	1	34	466	Saint-Vincent-de-Mercuze	1408	66	1474
82	Rhône-Alpes	38	1	09	350	Sainte-Agnès	537	10	547
82	Rhône-Alpes	38	3	28	358	Sainte-Anne-sur-Gervonde	581	17	598
82	Rhône-Alpes	38	2	33	369	Sainte-Blandine	904	25	929
82	Rhône-Alpes	38	1	06	414	Sainte-Luce	40	0	40
82	Rhône-Alpes	38	1	34	417	Sainte-Marie-d;Alloix	553	16	569
82	Rhône-Alpes	38	1	34	418	Sainte-Marie-du-Mont	238	1	239
82	Rhône-Alpes	38	2	53	467	Salagnon	1197	17	1214
82	Rhône-Alpes	38	3	24	468	Salaise-sur-Sanne	4201	82	4283
82	Rhône-Alpes	38	1	06	469	La Salette-Fallavaux	72	1	73
82	Rhône-Alpes	38	1	06	470	La Salle-en-Beaumont	307	7	314
82	Rhône-Alpes	38	1	50	471	Le Sappey-en-Chartreuse	1072	37	1109
82	Rhône-Alpes	38	1	51	472	Sarcenas	197	8	205
82	Rhône-Alpes	38	3	07	473	Sardieu	1017	7	1024
82	Rhône-Alpes	38	1	32	474	Sassenage	10996	321	11317
82	Rhône-Alpes	38	2	37	475	Satolas-et-Bonce	2101	40	2141
82	Rhône-Alpes	38	3	28	476	Savas-Mépin	806	7	813
82	Rhône-Alpes	38	1	44	478	Séchilienne	927	9	936
82	Rhône-Alpes	38	3	07	479	Semons	368	12	380
82	Rhône-Alpes	38	3	38	480	Septème	1750	35	1785
82	Rhône-Alpes	38	2	04	481	Sérézin-de-la-Tour	865	20	885
82	Rhône-Alpes	38	2	19	483	Sermérieu	1502	35	1537
82	Rhône-Alpes	38	3	38	484	Serpaize	1511	28	1539
82	Rhône-Alpes	38	1	42	275	Serre-Nerpol	297	27	324
82	Rhône-Alpes	38	1	56	485	Seyssinet-Pariset	12113	180	12293
82	Rhône-Alpes	38	1	56	486	Seyssins	6913	150	7063
82	Rhône-Alpes	38	3	38	487	Seyssuel	1990	58	2048
82	Rhône-Alpes	38	2	08	488	Siccieu-Saint-Julien-et-Carisieu	581	12	593
82	Rhône-Alpes	38	1	36	489	Siévoz	121	7	128
82	Rhône-Alpes	38	1	26	490	Sillans	1860	36	1896
82	Rhône-Alpes	38	1	18	492	Sinard	639	23	662
82	Rhône-Alpes	38	2	08	494	Soleymieu	702	19	721
82	Rhône-Alpes	38	1	30	495	La Sône	633	12	645
82	Rhône-Alpes	38	3	24	496	Sonnay	1299	21	1320
82	Rhône-Alpes	38	1	20	497	Sousville	149	5	154
82	Rhône-Alpes	38	2	04	498	Succieu	703	13	716
82	Rhône-Alpes	38	1	20	499	Susville	1402	26	1428
82	Rhône-Alpes	38	1	30	500	Têche	560	9	569
82	Rhône-Alpes	38	1	10	501	Tencin	1222	7	1229
82	Rhône-Alpes	38	1	34	503	La Terrasse	2374	89	2463
82	Rhône-Alpes	38	1	10	504	Theys	1992	71	2063
82	Rhône-Alpes	38	1	25	505	Thodure	704	16	720
82	Rhône-Alpes	38	2	08	507	Tignieu-Jameyzieu	6055	86	6141
82	Rhône-Alpes	38	2	33	508	Torchefelon	621	16	637
82	Rhône-Alpes	38	2	33	509	La Tour-du-Pin	7975	250	8225
82	Rhône-Alpes	38	1	34	511	Le Touvet	2977	55	3032
82	Rhône-Alpes	38	3	28	512	Tramolé	533	13	546
82	Rhône-Alpes	38	1	18	513	Treffort	245	7	252
82	Rhône-Alpes	38	1	16	514	Tréminis	173	7	180
82	Rhône-Alpes	38	2	08	515	Trept	1774	24	1798
82	Rhône-Alpes	38	1	50	516	La Tronche	6232	207	6439
82	Rhône-Alpes	38	1	35	517	Tullins	7663	156	7819
82	Rhône-Alpes	38	1	36	518	Valbonnais	503	11	514
82	Rhône-Alpes	38	3	15	519	Valencin	2510	30	2540
82	Rhône-Alpes	38	2	43	520	Valencogne	603	12	615
82	Rhône-Alpes	38	1	36	521	La Valette	73	8	81
82	Rhône-Alpes	38	1	36	522	Valjouffrey	148	3	151
82	Rhône-Alpes	38	1	42	523	Varacieux	826	20	846
82	Rhône-Alpes	38	1	40	524	Varces-Allières-et-Risset	6330	138	6468
82	Rhône-Alpes	38	2	19	525	Vasselin	424	5	429
82	Rhône-Alpes	38	1	35	526	Vatilieu	385	9	394
82	Rhône-Alpes	38	1	03	527	Vaujany	345	6	351
82	Rhône-Alpes	38	1	44	528	Vaulnaveys-le-Bas	1174	32	1206
82	Rhône-Alpes	38	1	44	529	Vaulnaveys-le-Haut	3533	63	3596
82	Rhône-Alpes	38	2	58	530	Vaulx-Milieu	2435	49	2484
82	Rhône-Alpes	38	2	27	531	Velanne	495	25	520
82	Rhône-Alpes	38	2	08	532	Vénérieu	583	9	592
82	Rhône-Alpes	38	1	55	533	Venon	722	20	742
82	Rhône-Alpes	38	1	03	534	Vénosc	815	18	833
82	Rhône-Alpes	38	2	08	535	Vernas	230	5	235
82	Rhône-Alpes	38	3	24	536	Vernioz	1183	28	1211
82	Rhône-Alpes	38	2	37	537	La Verpillière	6411	129	6540
82	Rhône-Alpes	38	1	09	538	Le Versoud	4566	58	4624
82	Rhône-Alpes	38	2	08	539	Vertrieu	660	8	668
82	Rhône-Alpes	38	1	32	540	Veurey-Voroize	1380	17	1397
82	Rhône-Alpes	38	2	19	541	Veyrins-Thuellin	1904	49	1953
82	Rhône-Alpes	38	2	08	542	Veyssilieu	293	8	301
82	Rhône-Alpes	38	2	19	543	Vézeronce-Curtin	1784	34	1818
82	Rhône-Alpes	38	3	99	544	Vienne	29328	841	30169
82	Rhône-Alpes	38	1	40	545	Vif	8053	185	8238
82	Rhône-Alpes	38	2	33	546	Vignieu	907	72	979
82	Rhône-Alpes	38	1	09	547	Villard-Bonnot	7296	67	7363
82	Rhône-Alpes	38	1	41	548	Villard-de-Lans	4034	255	4289
82	Rhône-Alpes	38	1	03	549	Villard-Notre-Dame	25	0	25
82	Rhône-Alpes	38	1	03	550	Villard-Reculas	62	0	62
82	Rhône-Alpes	38	1	03	551	Villard-Reymond	35	1	36
82	Rhône-Alpes	38	1	20	552	Villard-Saint-Christophe	374	7	381
82	Rhône-Alpes	38	3	24	556	Ville-sous-Anjou	1146	30	1176
82	Rhône-Alpes	38	2	58	553	Villefontaine	18374	329	18703
82	Rhône-Alpes	38	2	08	554	Villemoirieu	1809	98	1907
82	Rhône-Alpes	38	3	28	555	Villeneuve-de-Marc	1141	24	1165
82	Rhône-Alpes	38	3	46	557	Villette-d;Anthon	4284	59	4343
82	Rhône-Alpes	38	3	38	558	Villette-de-Vienne	1631	34	1665
82	Rhône-Alpes	38	1	42	559	Vinay	4070	60	4130
82	Rhône-Alpes	38	2	43	560	Virieu	1049	16	1065
82	Rhône-Alpes	38	1	25	561	Viriville	1545	31	1576
82	Rhône-Alpes	38	1	44	562	Vizille	7630	187	7817
82	Rhône-Alpes	38	1	45	563	Voiron	19893	680	20573
82	Rhône-Alpes	38	2	27	564	Voissant	205	2	207
82	Rhône-Alpes	38	1	45	565	Voreppe	9847	299	10146
82	Rhône-Alpes	38	1	23	566	Vourey	1578	38	1616
43	Franche-Comté	39	1	33	001	Abergement-la-Ronce	765	20	785
43	Franche-Comté	39	2	01	002	Abergement-le-Grand	64	6	70
43	Franche-Comté	39	2	23	003	Abergement-le-Petit	41	1	42
43	Franche-Comté	39	2	29	004	Abergement-lès-Thésy	67	3	70
43	Franche-Comté	39	2	29	006	Aiglepierre	428	18	446
43	Franche-Comté	39	2	21	007	Alièze	155	1	156
43	Franche-Comté	39	1	24	008	Amange	372	64	436
43	Franche-Comté	39	2	06	009	Andelot-en-Montagne	540	11	551
43	Franche-Comté	39	2	27	010	Andelot-Morval	88	3	91
43	Franche-Comté	39	1	09	011	Annoire	392	19	411
43	Franche-Comté	39	2	01	013	Arbois	3520	178	3698
43	Franche-Comté	39	1	24	014	Archelange	235	8	243
43	Franche-Comté	39	2	06	015	Ardon	132	6	138
43	Franche-Comté	39	2	29	586	Aresches	41	2	43
43	Franche-Comté	39	2	02	016	Arinthod	1150	48	1198
43	Franche-Comté	39	2	04	017	Arlay	734	20	754
43	Franche-Comté	39	2	02	018	Aromas	540	18	558
43	Franche-Comté	39	2	20	020	Arsure-Arsurette	92	3	95
43	Franche-Comté	39	2	01	019	Les Arsures	236	7	243
43	Franche-Comté	39	2	21	021	Arthenas	161	3	164
43	Franche-Comté	39	1	08	022	Asnans-Beauvoisin	696	15	711
43	Franche-Comté	39	2	25	023	L; Aubépin	140	1	141
43	Franche-Comté	39	1	24	024	Audelange	252	6	258
43	Franche-Comté	39	2	03	025	Augea	285	9	294
43	Franche-Comté	39	1	17	026	Augerans	151	1	152
43	Franche-Comté	39	2	03	027	Augisey	184	9	193
43	Franche-Comté	39	2	23	028	Aumont	430	4	434
43	Franche-Comté	39	1	09	029	Aumur	368	5	373
43	Franche-Comté	39	1	24	030	Authume	808	26	834
43	Franche-Comté	39	1	14	031	Auxange	202	9	211
43	Franche-Comté	39	3	26	032	Avignon-lès-Saint-Claude	360	6	366
43	Franche-Comté	39	1	08	034	Balaiseaux	268	7	275
43	Franche-Comté	39	2	25	035	Balanod	323	5	328
43	Franche-Comté	39	2	27	036	La Balme-d;Épy	53	0	53
43	Franche-Comté	39	1	17	037	Bans	197	10	207
43	Franche-Comté	39	2	10	038	Barésia-sur-l;Ain	154	2	156
43	Franche-Comté	39	1	12	039	La Barre	230	2	232
43	Franche-Comté	39	2	23	040	Barretaine	200	8	208
43	Franche-Comté	39	2	32	041	Baume-les-Messieurs	190	5	195
43	Franche-Comté	39	1	24	042	Baverans	444	20	464
43	Franche-Comté	39	2	03	043	Beaufort	1022	28	1050
43	Franche-Comté	39	2	21	045	Beffia	88	3	91
43	Franche-Comté	39	3	05	046	Bellecombe	79	7	86
43	Franche-Comté	39	3	19	047	Bellefontaine	550	21	571
43	Franche-Comté	39	1	17	048	Belmont	271	10	281
43	Franche-Comté	39	2	23	049	Bersaillin	392	2	394
43	Franche-Comté	39	2	23	050	Besain	157	12	169
43	Franche-Comté	39	1	13	051	Biarne	363	12	375
43	Franche-Comté	39	2	22	052	Bief-des-Maisons	75	8	83
43	Franche-Comté	39	2	20	053	Bief-du-Fourg	165	3	168
43	Franche-Comté	39	2	23	054	Biefmorin	76	1	77
43	Franche-Comté	39	2	20	055	Billecul	33	1	34
43	Franche-Comté	39	2	04	056	Bletterans	1394	21	1415
43	Franche-Comté	39	2	32	057	Blois-sur-Seille	103	3	106
43	Franche-Comté	39	2	11	058	Blye	152	7	159
43	Franche-Comté	39	3	19	059	Bois-d;Amont	1677	49	1726
43	Franche-Comté	39	2	07	060	Bois-de-Gand	60	1	61
43	Franche-Comté	39	2	10	061	Boissia	142	7	149
43	Franche-Comté	39	2	02	062	La Boissière	68	1	69
43	Franche-Comté	39	3	28	063	Bonlieu	259	3	262
43	Franche-Comté	39	2	03	064	Bonnaud	46	0	46
43	Franche-Comté	39	2	23	065	Bonnefontaine	96	6	102
43	Franche-Comté	39	2	34	066	Bornay	175	6	181
43	Franche-Comté	39	3	05	068	Les Bouchoux	314	12	326
43	Franche-Comté	39	2	27	069	Bourcia	115	7	122
43	Franche-Comté	39	2	06	070	Bourg-de-Sirod	98	2	100
43	Franche-Comté	39	2	29	072	Bracon	282	11	293
43	Franche-Comté	39	2	23	073	Brainans	168	5	173
43	Franche-Comté	39	1	18	074	Brans	235	7	242
43	Franche-Comté	39	2	30	075	Bréry	214	10	224
43	Franche-Comté	39	1	12	076	La Bretenière	202	6	208
43	Franche-Comté	39	1	08	077	Bretenières	38	0	38
43	Franche-Comté	39	1	24	078	Brevans	628	21	649
43	Franche-Comté	39	2	11	079	Briod	214	8	222
43	Franche-Comté	39	2	27	080	Broissia	53	0	53
43	Franche-Comté	39	2	23	081	Buvilly	360	7	367
43	Franche-Comté	39	2	20	083	Censeau	313	7	320
43	Franche-Comté	39	2	29	084	Cernans	141	9	150
43	Franche-Comté	39	2	20	085	Cerniébaud	65	3	68
43	Franche-Comté	39	2	02	086	Cernon	268	8	276
43	Franche-Comté	39	2	03	088	Cesancey	404	15	419
43	Franche-Comté	39	2	02	089	Cézia	69	3	72
43	Franche-Comté	39	1	08	090	Chaînée-des-Coupis	195	1	196
43	Franche-Comté	39	2	22	091	Les Chalesmes	102	10	112
43	Franche-Comté	39	2	21	092	Chambéria	167	9	176
43	Franche-Comté	39	1	31	093	Chamblay	415	8	423
43	Franche-Comté	39	2	23	094	Chamole	164	2	166
43	Franche-Comté	39	1	31	095	Champagne-sur-Loue	130	4	134
43	Franche-Comté	39	1	18	096	Champagney	402	4	406
43	Franche-Comté	39	2	06	097	Champagnole	8077	390	8467
43	Franche-Comté	39	1	09	099	Champdivers	439	15	454
43	Franche-Comté	39	2	23	100	Champrougier	94	1	95
43	Franche-Comté	39	1	13	101	Champvans	1357	50	1407
43	Franche-Comté	39	3	16	102	Chancia	239	11	250
43	Franche-Comté	39	2	29	103	La Chapelle-sur-Furieuse	329	9	338
43	Franche-Comté	39	2	04	104	Chapelle-Voland	619	15	634
43	Franche-Comté	39	2	06	105	Chapois	210	5	215
43	Franche-Comté	39	3	16	106	Charchilla	245	7	252
43	Franche-Comté	39	2	10	107	Charcier	120	3	123
43	Franche-Comté	39	2	20	108	Charency	55	0	55
43	Franche-Comté	39	2	10	109	Charézier	148	8	156
43	Franche-Comté	39	2	30	110	La Charme	53	3	56
43	Franche-Comté	39	2	02	111	Charnod	45	2	47
43	Franche-Comté	39	2	07	112	La Chassagne	120	2	122
43	Franche-Comté	39	3	26	113	Chassal	495	12	507
43	Franche-Comté	39	2	32	114	Château-Chalon	164	5	169
43	Franche-Comté	39	3	28	115	Château-des-Prés	183	5	188
43	Franche-Comté	39	3	16	118	Châtel-de-Joux	57	6	63
43	Franche-Comté	39	2	01	116	La Châtelaine	127	7	134
43	Franche-Comté	39	1	17	117	Chatelay	90	1	91
43	Franche-Comté	39	2	23	119	Le Chateley	85	1	86
43	Franche-Comté	39	2	06	120	Châtelneuf	137	7	144
43	Franche-Comté	39	1	24	121	Châtenois	345	13	358
43	Franche-Comté	39	2	11	122	Châtillon	141	7	148
43	Franche-Comté	39	2	02	123	Chatonnay	62	2	64
43	Franche-Comté	39	2	07	124	Chaumergy	478	7	485
43	Franche-Comté	39	3	28	126	La Chaumusse	357	25	382
43	Franche-Comté	39	2	23	127	Chaussenans	114	2	116
43	Franche-Comté	39	1	08	128	Chaussin	1617	48	1665
43	Franche-Comté	39	2	29	133	Chaux-Champagny	63	7	70
43	Franche-Comté	39	2	22	129	Chaux-des-Crotenay	404	13	417
43	Franche-Comté	39	3	28	130	Chaux-des-Prés	191	11	202
43	Franche-Comté	39	3	28	131	La Chaux-du-Dombief	526	39	565
43	Franche-Comté	39	2	07	132	La Chaux-en-Bresse	33	0	33
43	Franche-Comté	39	2	21	134	Chavéria	220	2	222
43	Franche-Comté	39	2	25	135	Chazelles	125	3	128
43	Franche-Comté	39	2	23	136	Chemenot	37	0	37
43	Franche-Comté	39	2	02	137	Chemilla	96	11	107
43	Franche-Comté	39	1	09	138	Chemin	351	8	359
43	Franche-Comté	39	1	08	139	Chêne-Bernard	72	0	72
43	Franche-Comté	39	2	07	140	Chêne-Sec	35	0	35
43	Franche-Comté	39	1	18	141	Chevigny	287	14	301
43	Franche-Comté	39	2	25	142	Chevreaux	139	4	143
43	Franche-Comté	39	2	10	143	Chevrotaine	37	0	37
43	Franche-Comté	39	2	15	145	Chille	326	24	350
43	Franche-Comté	39	2	34	146	Chilly-le-Vignoble	605	17	622
43	Franche-Comté	39	2	29	147	Chilly-sur-Salins	94	8	102
43	Franche-Comté	39	2	02	148	Chisséria	84	1	85
43	Franche-Comté	39	1	17	149	Chissey-sur-Loue	346	9	355
43	Franche-Comté	39	1	33	150	Choisey	1056	23	1079
43	Franche-Comté	39	3	05	151	Choux	126	8	134
43	Franche-Comté	39	2	06	153	Cize	821	25	846
43	Franche-Comté	39	2	10	154	Clairvaux-les-Lacs	1424	36	1460
43	Franche-Comté	39	2	29	155	Clucy	79	1	80
43	Franche-Comté	39	2	10	156	Cogna	260	5	265
43	Franche-Comté	39	3	05	157	Coiserette	46	1	47
43	Franche-Comté	39	2	02	158	Coisia	162	3	165
43	Franche-Comté	39	2	23	159	Colonne	257	7	264
43	Franche-Comté	39	2	07	160	Commenailles	780	10	790
43	Franche-Comté	39	2	20	161	Communailles-en-Montagne	44	3	47
43	Franche-Comté	39	2	15	162	Condamine	272	9	281
43	Franche-Comté	39	2	02	163	Condes	115	6	121
43	Franche-Comté	39	2	11	164	Conliège	701	20	721
43	Franche-Comté	39	2	20	165	Conte	58	0	58
43	Franche-Comté	39	2	02	166	Cornod	236	5	241
43	Franche-Comté	39	2	04	167	Cosges	329	9	338
43	Franche-Comté	39	2	11	168	Courbette	40	0	40
43	Franche-Comté	39	2	34	169	Courbouzon	592	19	611
43	Franche-Comté	39	2	15	170	Courlans	992	20	1012
43	Franche-Comté	39	2	15	171	Courlaoux	955	23	978
43	Franche-Comté	39	1	12	172	Courtefontaine	217	30	247
43	Franche-Comté	39	2	03	173	Cousance	1231	36	1267
43	Franche-Comté	39	3	05	174	Coyrière	67	5	72
43	Franche-Comté	39	3	16	175	Coyron	74	7	81
43	Franche-Comté	39	1	31	176	Cramans	480	17	497
43	Franche-Comté	39	2	22	178	Crans	67	1	68
43	Franche-Comté	39	2	11	177	Crançot	556	18	574
43	Franche-Comté	39	3	16	179	Crenans	246	9	255
43	Franche-Comté	39	2	21	180	Cressia	277	110	387
43	Franche-Comté	39	1	33	182	Crissey	655	18	673
43	Franche-Comté	39	2	06	183	Crotenay	677	79	756
43	Franche-Comté	39	3	16	184	Les Crozets	215	9	224
43	Franche-Comté	39	2	03	185	Cuisia	402	9	411
43	Franche-Comté	39	3	26	186	Cuttura	335	17	352
43	Franche-Comté	39	2	20	187	Cuvier	221	6	227
43	Franche-Comté	39	1	18	188	Dammartin-Marpain	290	7	297
43	Franche-Comté	39	1	33	189	Damparis	2799	51	2850
43	Franche-Comté	39	1	12	190	Dampierre	1209	27	1236
43	Franche-Comté	39	2	30	191	Darbonnay	97	3	100
43	Franche-Comté	39	3	28	192	Denezières	85	10	95
43	Franche-Comté	39	1	08	193	Le Deschaux	997	14	1011
43	Franche-Comté	39	2	04	194	Desnes	475	13	488
43	Franche-Comté	39	2	27	195	Dessia	74	7	81
43	Franche-Comté	39	2	07	196	Les Deux-Fays	122	1	123
43	Franche-Comté	39	2	25	197	Digna	367	9	376
43	Franche-Comté	39	1	96	198	Dole	24629	1147	25776
43	Franche-Comté	39	2	32	199	Domblans	926	36	962
43	Franche-Comté	39	2	21	200	Dompierre-sur-Mont	245	9	254
43	Franche-Comté	39	2	10	201	Doucier	295	11	306
43	Franche-Comté	39	2	29	202	Dournon	126	2	128
43	Franche-Comté	39	2	20	203	Doye	92	2	94
43	Franche-Comté	39	2	02	204	Dramelay	34	0	34
43	Franche-Comté	39	1	24	205	Éclans-Nenon	410	15	425
43	Franche-Comté	39	1	31	206	Écleux	202	3	205
43	Franche-Comté	39	2	21	207	Écrille	82	1	83
43	Franche-Comté	39	2	22	208	Entre-deux-Monts	159	4	163
43	Franche-Comté	39	2	06	210	Équevillon	612	22	634
43	Franche-Comté	39	1	08	211	Les Essards-Taignevaux	247	7	254
43	Franche-Comté	39	2	20	213	Esserval-Combe	17	0	17
43	Franche-Comté	39	2	20	214	Esserval-Tartre	84	0	84
43	Franche-Comté	39	2	21	215	Essia	64	4	68
43	Franche-Comté	39	3	16	216	Étival	319	4	323
43	Franche-Comté	39	2	15	217	L; Étoile	559	24	583
43	Franche-Comté	39	1	12	218	Étrepigney	409	16	425
43	Franche-Comté	39	1	12	219	Évans	621	13	634
43	Franche-Comté	39	1	24	220	Falletans	399	10	409
43	Franche-Comté	39	2	20	221	La Favière	32	0	32
43	Franche-Comté	39	2	23	222	Fay-en-Montagne	76	3	79
43	Franche-Comté	39	2	01	223	La Ferté	197	3	200
43	Franche-Comté	39	2	02	224	Fétigny	99	5	104
43	Franche-Comté	39	2	32	225	Le Fied	191	10	201
43	Franche-Comté	39	2	27	226	Florentia	35	0	35
43	Franche-Comté	39	2	22	227	Foncine-le-Bas	205	11	216
43	Franche-Comté	39	2	22	228	Foncine-le-Haut	1024	46	1070
43	Franche-Comté	39	2	04	229	Fontainebrux	178	5	183
43	Franche-Comté	39	2	10	230	Fontenu	67	0	67
43	Franche-Comté	39	3	28	232	Fort-du-Plasne	427	5	432
43	Franche-Comté	39	1	13	233	Foucherans	1877	39	1916
43	Franche-Comté	39	2	07	234	Foulenay	84	4	88
43	Franche-Comté	39	1	12	235	Fraisans	1228	27	1255
43	Franche-Comté	39	2	07	236	Francheville	37	0	37
43	Franche-Comté	39	2	20	237	Fraroz	45	2	47
43	Franche-Comté	39	1	18	238	Frasne-les-Meulières	109	5	114
43	Franche-Comté	39	2	10	239	La Frasnée	38	1	39
43	Franche-Comté	39	2	10	240	Le Frasnois	154	5	159
43	Franche-Comté	39	2	34	241	Frébuans	366	10	376
43	Franche-Comté	39	2	07	243	Froideville	74	1	75
43	Franche-Comté	39	2	32	244	Frontenay	167	2	169
43	Franche-Comté	39	1	08	245	Gatey	364	1	365
43	Franche-Comté	39	1	14	246	Gendrey	390	11	401
43	Franche-Comté	39	2	02	247	Genod	67	1	68
43	Franche-Comté	39	2	29	248	Geraise	44	1	45
43	Franche-Comté	39	1	17	249	Germigney	91	1	92
43	Franche-Comté	39	2	34	250	Geruge	166	7	173
43	Franche-Comté	39	2	34	251	Gevingey	452	83	535
43	Franche-Comté	39	1	33	252	Gevry	653	11	664
43	Franche-Comté	39	2	27	253	Gigny	299	5	304
43	Franche-Comté	39	2	20	254	Gillois	143	6	149
43	Franche-Comté	39	2	03	255	Gizia	216	2	218
43	Franche-Comté	39	3	28	258	Grande-Rivière	421	18	439
43	Franche-Comté	39	1	31	259	Grange-de-Vaivre	48	2	50
43	Franche-Comté	39	2	32	260	Granges-sur-Baume	132	1	133
43	Franche-Comté	39	2	25	261	Graye-et-Charnay	139	5	144
43	Franche-Comté	39	1	24	262	Gredisans	147	2	149
43	Franche-Comté	39	2	23	263	Grozon	483	3	486
43	Franche-Comté	39	2	03	264	Grusse	183	8	191
43	Franche-Comté	39	2	10	265	Hautecour	178	7	185
43	Franche-Comté	39	1	08	266	Les Hays	287	2	289
43	Franche-Comté	39	2	29	267	Ivory	84	2	86
43	Franche-Comté	39	2	29	268	Ivrey	58	1	59
43	Franche-Comté	39	3	16	269	Jeurre	253	5	258
43	Franche-Comté	39	1	24	270	Jouhe	569	59	628
43	Franche-Comté	39	3	28	271	Lac-des-Rouges-Truites	361	12	373
43	Franche-Comté	39	2	32	272	Ladoye-sur-Seille	61	6	67
43	Franche-Comté	39	2	27	273	Lains	80	2	82
43	Franche-Comté	39	3	26	274	Lajoux	252	9	261
43	Franche-Comté	39	3	26	275	Lamoura	529	22	551
43	Franche-Comté	39	2	06	277	Le Larderet	81	4	85
43	Franche-Comté	39	2	10	278	Largillay-Marsonnay	189	4	193
43	Franche-Comté	39	2	04	279	Larnaud	529	26	555
43	Franche-Comté	39	3	05	280	Larrivoire	102	5	107
43	Franche-Comté	39	2	06	281	Le Latet	75	2	77
43	Franche-Comté	39	2	20	282	La Latette	74	2	76
43	Franche-Comté	39	3	26	283	Lavancia-Epercy	647	22	669
43	Franche-Comté	39	1	24	284	Lavangeot	115	6	121
43	Franche-Comté	39	1	24	285	Lavans-lès-Dole	335	15	350
43	Franche-Comté	39	3	26	286	Lavans-lès-Saint-Claude	1878	105	1983
43	Franche-Comté	39	2	02	287	Lavans-sur-Valouse	139	0	139
43	Franche-Comté	39	2	32	288	Lavigny	365	10	375
43	Franche-Comté	39	3	16	289	Lect	382	8	390
43	Franche-Comté	39	2	02	290	Légna	200	3	203
43	Franche-Comté	39	2	29	291	Lemuy	234	6	240
43	Franche-Comté	39	2	06	292	Lent	125	4	129
43	Franche-Comté	39	3	26	293	Leschères	212	2	214
43	Franche-Comté	39	3	19	294	Lézat	186	7	193
43	Franche-Comté	39	2	25	295	Loisia	172	8	180
43	Franche-Comté	39	2	30	296	Lombard	182	6	188
43	Franche-Comté	39	3	19	297	Longchaumois	1145	47	1192
43	Franche-Comté	39	2	20	298	Longcochon	48	0	48
43	Franche-Comté	39	1	09	299	Longwy-sur-le-Doubs	537	18	555
43	Franche-Comté	39	2	97	300	Lons-le-Saunier	17681	879	18560
43	Franche-Comté	39	2	06	301	Loulle	172	3	175
43	Franche-Comté	39	1	14	302	Louvatange	117	0	117
43	Franche-Comté	39	2	27	303	Louvenne	143	1	144
43	Franche-Comté	39	2	32	304	Le Louverot	254	28	282
43	Franche-Comté	39	1	17	305	La Loye	546	12	558
43	Franche-Comté	39	2	34	306	Macornay	1011	47	1058
43	Franche-Comté	39	3	16	307	Maisod	318	8	326
43	Franche-Comté	39	1	14	308	Malange	295	7	302
43	Franche-Comté	39	2	03	309	Mallerey	63	1	64
43	Franche-Comté	39	2	30	310	Mantry	441	9	450
43	Franche-Comté	39	2	02	312	Marigna-sur-Valouse	106	4	110
43	Franche-Comté	39	2	10	313	Marigny	180	10	190
43	Franche-Comté	39	2	21	314	Marnézia	94	1	95
43	Franche-Comté	39	2	29	315	Marnoz	400	11	411
43	Franche-Comté	39	2	32	317	La Marre	328	5	333
43	Franche-Comté	39	3	16	318	Martigna	205	2	207
43	Franche-Comté	39	2	01	319	Mathenay	130	1	131
43	Franche-Comté	39	2	03	320	Maynal	306	10	316
43	Franche-Comté	39	2	32	321	Menétru-le-Vignoble	155	4	159
43	Franche-Comté	39	2	10	322	Menétrux-en-Joux	56	0	56
43	Franche-Comté	39	1	24	323	Menotey	279	9	288
43	Franche-Comté	39	2	21	324	Mérona	11	1	12
43	Franche-Comté	39	2	01	325	Mesnay	554	23	577
43	Franche-Comté	39	2	10	326	Mesnois	202	9	211
43	Franche-Comté	39	2	34	327	Messia-sur-Sorne	824	27	851
43	Franche-Comté	39	3	16	328	Meussia	424	11	435
43	Franche-Comté	39	2	20	329	Mièges	92	1	93
43	Franche-Comté	39	2	23	330	Miéry	147	2	149
43	Franche-Comté	39	2	20	331	Mignovillard	683	24	707
43	Franche-Comté	39	2	11	332	Mirebel	243	5	248
43	Franche-Comté	39	3	16	333	Moirans-en-Montagne	2284	143	2427
43	Franche-Comté	39	2	34	334	Moiron	142	4	146
43	Franche-Comté	39	1	18	335	Moissey	570	13	583
43	Franche-Comté	39	2	23	336	Molain	126	1	127
43	Franche-Comté	39	2	01	337	Molamboz	85	3	88
43	Franche-Comté	39	1	09	338	Molay	500	8	508
43	Franche-Comté	39	3	26	339	Molinges	669	27	696
43	Franche-Comté	39	2	20	340	Molpré	24	0	24
43	Franche-Comté	39	3	26	341	Les Molunes	141	8	149
43	Franche-Comté	39	2	30	342	Monay	134	4	138
43	Franche-Comté	39	2	06	344	Monnet-la-Ville	368	8	376
43	Franche-Comté	39	2	27	343	Monnetay	19	2	21
43	Franche-Comté	39	1	13	345	Monnières	453	10	463
43	Franche-Comté	39	1	17	365	Mont-sous-Vaudrey	1272	33	1305
43	Franche-Comté	39	2	06	366	Mont-sur-Monnet	220	8	228
43	Franche-Comté	39	2	25	346	Montagna-le-Reconduit	124	3	127
43	Franche-Comté	39	2	27	347	Montagna-le-Templier	95	1	96
43	Franche-Comté	39	2	11	348	Montaigu	500	67	567
43	Franche-Comté	39	2	32	349	Montain	496	21	517
43	Franche-Comté	39	1	17	350	Montbarrey	332	8	340
43	Franche-Comté	39	3	16	351	Montcusel	176	4	180
43	Franche-Comté	39	1	12	352	Monteplain	140	6	146
43	Franche-Comté	39	2	27	353	Montfleur	168	2	170
43	Franche-Comté	39	2	23	354	Montholier	326	11	337
43	Franche-Comté	39	2	01	355	Montigny-lès-Arsures	270	6	276
43	Franche-Comté	39	2	06	356	Montigny-sur-l;Ain	192	8	200
43	Franche-Comté	39	2	29	359	Montmarlon	31	0	31
43	Franche-Comté	39	1	18	360	Montmirey-la-Ville	184	5	189
43	Franche-Comté	39	1	18	361	Montmirey-le-Château	168	7	175
43	Franche-Comté	39	2	15	362	Montmorot	3061	278	3339
43	Franche-Comté	39	2	27	363	Montrevel	100	2	102
43	Franche-Comté	39	2	06	364	Montrond	504	17	521
43	Franche-Comté	39	3	19	367	Morbier	2255	126	2381
43	Franche-Comté	39	3	19	368	Morez	5154	220	5374
43	Franche-Comté	39	1	31	370	Mouchard	1142	246	1388
43	Franche-Comté	39	3	19	371	La Mouille	317	13	330
43	Franche-Comté	39	2	20	372	Mournans-Charbonny	85	5	90
43	Franche-Comté	39	3	05	373	Les Moussières	196	1	197
43	Franche-Comté	39	2	21	375	Moutonne	118	0	118
43	Franche-Comté	39	2	06	376	Moutoux	55	2	57
43	Franche-Comté	39	1	18	377	Mutigney	156	2	158
43	Franche-Comté	39	2	25	378	Nanc-lès-Saint-Amour	285	22	307
43	Franche-Comté	39	2	04	379	Nance	494	13	507
43	Franche-Comté	39	2	21	380	Nancuise	42	2	44
43	Franche-Comté	39	2	06	381	Les Nans	90	4	94
43	Franche-Comté	39	2	25	382	Nantey	75	0	75
43	Franche-Comté	39	1	08	385	Neublans-Abergement	515	14	529
43	Franche-Comté	39	2	23	386	Neuvilley	74	3	77
43	Franche-Comté	39	1	33	387	Nevy-lès-Dole	249	5	254
43	Franche-Comté	39	2	32	388	Nevy-sur-Seille	235	8	243
43	Franche-Comté	39	2	06	389	Ney	554	21	575
43	Franche-Comté	39	2	11	390	Nogna	255	8	263
43	Franche-Comté	39	2	20	391	Nozeroy	417	9	426
43	Franche-Comté	39	1	18	392	Offlanges	192	4	196
43	Franche-Comté	39	2	20	393	Onglières	74	2	76
43	Franche-Comté	39	2	21	394	Onoz	87	4	91
43	Franche-Comté	39	2	03	395	Orbagna	181	4	185
43	Franche-Comté	39	1	12	396	Orchamps	1047	26	1073
43	Franche-Comté	39	2	21	397	Orgelet	1685	52	1737
43	Franche-Comté	39	1	14	398	Ougney	322	6	328
43	Franche-Comté	39	1	31	399	Ounans	385	11	396
43	Franche-Comté	39	1	12	400	Our	164	5	169
43	Franche-Comté	39	2	23	401	Oussières	229	3	232
43	Franche-Comté	39	1	14	402	Pagney	357	8	365
43	Franche-Comté	39	1	31	403	Pagnoz	229	8	237
43	Franche-Comté	39	2	11	404	Pannessières	445	20	465
43	Franche-Comté	39	1	33	405	Parcey	955	32	987
43	Franche-Comté	39	2	06	406	Le Pasquier	254	10	264
43	Franche-Comté	39	2	30	407	Passenans	336	6	342
43	Franche-Comté	39	2	10	408	Patornay	137	2	139
43	Franche-Comté	39	1	18	409	Peintre	128	7	135
43	Franche-Comté	39	2	11	411	Perrigny	1538	61	1599
43	Franche-Comté	39	1	09	412	Peseux	289	6	295
43	Franche-Comté	39	3	05	413	La Pesse	353	14	367
43	Franche-Comté	39	1	14	414	Le Petit-Mercey	111	5	116
43	Franche-Comté	39	1	09	415	Petit-Noir	1134	29	1163
43	Franche-Comté	39	3	28	417	Les Piards	186	4	190
43	Franche-Comté	39	2	23	418	Picarreau	94	1	95
43	Franche-Comté	39	2	06	419	Pillemoine	61	2	63
43	Franche-Comté	39	2	21	420	Pimorin	189	5	194
43	Franche-Comté	39	2	32	421	Le Pin	264	15	279
43	Franche-Comté	39	2	32	422	Plainoiseau	547	11	558
43	Franche-Comté	39	2	21	423	Plaisia	115	10	125
43	Franche-Comté	39	2	22	424	Les Planches-en-Montagne	150	2	152
43	Franche-Comté	39	2	01	425	Les Planches-près-Arbois	101	10	111
43	Franche-Comté	39	2	23	426	Plasne	248	13	261
43	Franche-Comté	39	2	20	427	Plénise	58	4	62
43	Franche-Comté	39	2	20	428	Plénisette	25	0	25
43	Franche-Comté	39	1	08	429	Pleure	428	15	443
43	Franche-Comté	39	1	12	430	Plumont	92	0	92
43	Franche-Comté	39	2	11	431	Poids-de-Fiole	301	13	314
43	Franche-Comté	39	1	18	432	Pointre	114	4	118
43	Franche-Comté	39	2	23	434	Poligny	4226	309	4535
43	Franche-Comté	39	2	29	436	Pont-d;Héry	255	3	258
43	Franche-Comté	39	2	10	435	Pont-de-Poitte	659	19	678
43	Franche-Comté	39	2	06	437	Pont-du-Navoy	246	6	252
43	Franche-Comté	39	3	26	438	Ponthoux	92	2	94
43	Franche-Comté	39	1	31	439	Port-Lesney	553	53	606
43	Franche-Comté	39	3	16	440	Pratz	576	28	604
43	Franche-Comté	39	3	19	441	Prémanon	1043	20	1063
43	Franche-Comté	39	3	28	442	Prénovel	299	11	310
43	Franche-Comté	39	2	21	443	Présilly	118	3	121
43	Franche-Comté	39	2	29	444	Pretin	59	1	60
43	Franche-Comté	39	2	11	445	Publy	283	6	289
43	Franche-Comté	39	2	01	446	Pupillin	247	15	262
43	Franche-Comté	39	2	04	447	Quintigny	221	14	235
43	Franche-Comté	39	1	08	448	Rahon	522	13	535
43	Franche-Comté	39	1	24	449	Rainans	226	6	232
43	Franche-Comté	39	1	12	451	Ranchot	472	8	480
43	Franche-Comté	39	1	12	452	Rans	477	4	481
43	Franche-Comté	39	3	26	453	Ravilloles	514	15	529
43	Franche-Comté	39	2	07	454	Recanoz	80	0	80
43	Franche-Comté	39	2	21	455	Reithouse	51	3	54
43	Franche-Comté	39	2	04	456	Relans	345	5	350
43	Franche-Comté	39	2	04	457	Les Repôts	36	0	36
43	Franche-Comté	39	2	11	458	Revigny	264	21	285
43	Franche-Comté	39	2	20	461	Rix	81	6	87
43	Franche-Comté	39	3	26	460	La Rixouse	208	10	218
43	Franche-Comté	39	1	24	462	Rochefort-sur-Nenon	563	18	581
43	Franche-Comté	39	3	05	463	Rogna	204	8	212
43	Franche-Comté	39	1	14	464	Romain	210	6	216
43	Franche-Comté	39	1	24	465	Romange	212	5	217
43	Franche-Comté	39	2	03	466	Rosay	125	3	128
43	Franche-Comté	39	2	03	467	Rotalier	171	2	173
43	Franche-Comté	39	2	21	468	Rothonay	123	8	131
43	Franche-Comté	39	1	14	469	Rouffange	96	5	101
43	Franche-Comté	39	3	19	470	Les Rousses	3108	125	3233
43	Franche-Comté	39	2	04	471	Ruffey-sur-Seille	760	17	777
43	Franche-Comté	39	2	07	472	Rye	183	3	186
43	Franche-Comté	39	2	10	473	Saffloz	105	4	109
43	Franche-Comté	39	2	25	475	Saint-Amour	2371	101	2472
43	Franche-Comté	39	1	09	476	Saint-Aubin	1758	68	1826
43	Franche-Comté	39	1	08	477	Saint-Baraing	271	1	272
43	Franche-Comté	39	3	26	478	Saint-Claude	11026	455	11481
43	Franche-Comté	39	2	01	479	Saint-Cyr-Montmalin	208	7	215
43	Franche-Comté	39	2	15	480	Saint-Didier	308	15	323
43	Franche-Comté	39	2	06	481	Saint-Germain-en-Montagne	421	12	433
43	Franche-Comté	39	2	32	482	Saint-Germain-lès-Arlay	502	12	514
43	Franche-Comté	39	2	02	483	Saint-Hymetière	75	3	78
43	Franche-Comté	39	2	25	484	Saint-Jean-d;Étreux	142	2	144
43	Franche-Comté	39	2	27	485	Saint-Julien	463	15	478
43	Franche-Comté	39	2	30	486	Saint-Lamain	123	5	128
43	Franche-Comté	39	3	28	487	Saint-Laurent-en-Grandvaux	1800	78	1878
43	Franche-Comté	39	2	03	488	Saint-Laurent-la-Roche	347	10	357
43	Franche-Comté	39	2	30	489	Saint-Lothain	460	23	483
43	Franche-Comté	39	1	09	490	Saint-Loup	278	6	284
43	Franche-Comté	39	3	26	491	Saint-Lupicin	2140	84	2224
43	Franche-Comté	39	2	11	492	Saint-Maur	211	7	218
43	Franche-Comté	39	3	28	493	Saint-Maurice-Crillat	212	4	216
43	Franche-Comté	39	3	28	494	Saint-Pierre	322	8	330
43	Franche-Comté	39	2	29	495	Saint-Thiébaud	68	0	68
43	Franche-Comté	39	2	03	474	Sainte-Agnès	316	8	324
43	Franche-Comté	39	2	29	497	Saizenay	108	2	110
43	Franche-Comté	39	1	12	498	Salans	574	8	582
43	Franche-Comté	39	1	14	499	Saligney	171	7	178
43	Franche-Comté	39	2	29	500	Salins-les-Bains	2926	174	3100
43	Franche-Comté	39	1	13	501	Sampans	928	21	949
43	Franche-Comté	39	1	17	502	Santans	332	3	335
43	Franche-Comté	39	2	06	503	Sapois	340	14	354
43	Franche-Comté	39	2	21	504	Sarrogna	225	8	233
43	Franche-Comté	39	3	28	505	Saugeot	53	1	54
43	Franche-Comté	39	2	02	506	Savigna	110	8	118
43	Franche-Comté	39	1	08	507	Séligney	90	5	95
43	Franche-Comté	39	2	30	508	Sellières	786	17	803
43	Franche-Comté	39	2	25	509	Senaud	56	0	56
43	Franche-Comté	39	3	26	510	Septmoncel	684	27	711
43	Franche-Comté	39	2	07	511	Sergenaux	61	1	62
43	Franche-Comté	39	2	07	512	Sergenon	49	0	49
43	Franche-Comté	39	1	14	513	Sermange	282	6	288
43	Franche-Comté	39	1	14	514	Serre-les-Moulières	184	3	187
43	Franche-Comté	39	2	06	517	Sirod	572	12	584
43	Franche-Comté	39	2	10	518	Songeson	74	0	74
43	Franche-Comté	39	2	10	519	Soucia	163	1	164
43	Franche-Comté	39	1	17	520	Souvans	500	12	512
43	Franche-Comté	39	2	06	522	Supt	106	5	111
43	Franche-Comté	39	2	06	523	Syam	199	5	204
43	Franche-Comté	39	1	08	525	Tassenières	385	2	387
43	Franche-Comté	39	1	09	526	Tavaux	4123	134	4257
43	Franche-Comté	39	1	14	527	Taxenne	92	2	94
43	Franche-Comté	39	1	18	528	Thervay	377	9	386
43	Franche-Comté	39	2	29	529	Thésy	66	4	70
43	Franche-Comté	39	2	02	530	Thoirette	681	22	703
43	Franche-Comté	39	2	10	531	Thoiria	164	3	167
43	Franche-Comté	39	2	25	532	Thoissia	46	3	49
43	Franche-Comté	39	2	30	533	Toulouse-le-Château	212	4	216
43	Franche-Comté	39	2	21	534	La Tour-du-Meix	229	4	233
43	Franche-Comté	39	2	23	535	Tourmont	465	15	480
43	Franche-Comté	39	2	34	537	Trenal	369	25	394
43	Franche-Comté	39	2	10	538	Uxelles	46	2	48
43	Franche-Comté	39	2	01	539	Vadans	254	12	266
43	Franche-Comté	39	2	25	209	Val-d;Épy	151	3	154
43	Franche-Comté	39	2	06	540	Valempoulières	215	7	222
43	Franche-Comté	39	2	02	542	Valfin-sur-Valouse	85	6	91
43	Franche-Comté	39	2	06	543	Vannoz	233	8	241
43	Franche-Comté	39	2	21	544	Varessia	40	0	40
43	Franche-Comté	39	2	06	545	Le Vaudioux	162	9	171
43	Franche-Comté	39	1	17	546	Vaudrey	384	12	396
43	Franche-Comté	39	3	26	547	Vaux-lès-Saint-Claude	709	31	740
43	Franche-Comté	39	2	23	548	Vaux-sur-Poligny	126	33	159
43	Franche-Comté	39	2	03	549	Vercia	316	4	320
43	Franche-Comté	39	2	11	550	Verges	172	4	176
43	Franche-Comté	39	2	25	551	Véria	139	7	146
43	Franche-Comté	39	2	34	552	Vernantois	331	10	341
43	Franche-Comté	39	2	32	553	Le Vernois	280	11	291
43	Franche-Comté	39	2	06	554	Vers-en-Montagne	201	3	204
43	Franche-Comté	39	2	30	555	Vers-sous-Sellières	226	2	228
43	Franche-Comté	39	2	10	556	Vertamboz	93	4	97
43	Franche-Comté	39	2	02	557	Vescles	211	8	219
43	Franche-Comté	39	2	11	558	Vevy	243	10	253
43	Franche-Comté	39	1	17	559	La Vieille-Loye	383	9	392
43	Franche-Comté	39	3	26	560	Villard-Saint-Sauveur	627	23	650
43	Franche-Comté	39	3	26	562	Villard-sur-Bienne	196	9	205
43	Franche-Comté	39	3	16	561	Villards-d;Héria	449	19	468
43	Franche-Comté	39	2	27	564	Villechantria	124	4	128
43	Franche-Comté	39	1	31	565	Villeneuve-d;Aval	85	2	87
43	Franche-Comté	39	2	27	566	Villeneuve-lès-Charnod	85	0	85
43	Franche-Comté	39	2	15	567	Villeneuve-sous-Pymont	282	15	297
43	Franche-Comté	39	1	31	569	Villers-Farlay	551	8	559
43	Franche-Comté	39	2	23	570	Villers-les-Bois	200	4	204
43	Franche-Comté	39	1	08	571	Villers-Robert	206	7	213
43	Franche-Comté	39	2	30	568	Villerserine	50	1	51
43	Franche-Comté	39	2	01	572	Villette-lès-Arbois	399	10	409
43	Franche-Comté	39	1	13	573	Villette-lès-Dole	775	9	784
43	Franche-Comté	39	2	04	574	Villevieux	731	27	758
43	Franche-Comté	39	2	07	575	Le Villey	80	1	81
43	Franche-Comté	39	2	03	576	Vincelles	386	9	395
43	Franche-Comté	39	2	07	577	Vincent	322	12	334
43	Franche-Comté	39	3	05	579	Viry	925	29	954
43	Franche-Comté	39	1	14	581	Vitreux	266	7	273
43	Franche-Comté	39	2	32	582	Voiteur	756	40	796
43	Franche-Comté	39	2	02	583	Vosbles	98	9	107
43	Franche-Comté	39	1	24	584	Vriange	119	7	126
43	Franche-Comté	39	3	05	585	Vulvoz	20	0	20
72	Aquitaine	40	2	01	001	Aire-sur-l;Adour	6279	534	6813
72	Aquitaine	40	1	02	002	Amou	1559	47	1606
72	Aquitaine	40	1	04	003	Angoumé	288	13	301
72	Aquitaine	40	1	25	004	Angresse	1535	30	1565
72	Aquitaine	40	2	06	005	Arboucave	202	7	209
72	Aquitaine	40	2	13	006	Arengosse	706	17	723
72	Aquitaine	40	1	02	007	Argelos	185	5	190
72	Aquitaine	40	2	24	008	Argelouse	101	1	102
72	Aquitaine	40	2	13	009	Arjuzanx	212	1	213
72	Aquitaine	40	1	02	011	Arsague	347	9	356
72	Aquitaine	40	2	07	012	Artassenx	264	7	271
72	Aquitaine	40	2	28	013	Arthez-d;Armagnac	120	2	122
72	Aquitaine	40	2	19	014	Arue	309	11	320
72	Aquitaine	40	2	05	015	Arx	67	1	68
72	Aquitaine	40	2	08	016	Aubagnan	242	11	253
72	Aquitaine	40	2	22	017	Audignon	359	16	375
72	Aquitaine	40	1	26	018	Audon	321	3	324
72	Aquitaine	40	2	10	019	Aureilhan	946	30	976
72	Aquitaine	40	2	22	020	Aurice	645	14	659
72	Aquitaine	40	1	25	021	Azur	601	11	612
72	Aquitaine	40	2	01	022	Bahus-Soubiran	372	11	383
72	Aquitaine	40	1	14	023	Baigts	342	10	352
72	Aquitaine	40	2	22	024	Banos	253	2	255
72	Aquitaine	40	2	22	026	Bas-Mauco	319	9	328
72	Aquitaine	40	2	07	025	Bascons	912	32	944
72	Aquitaine	40	1	02	027	Bassercles	118	2	120
72	Aquitaine	40	1	02	028	Bastennes	264	5	269
72	Aquitaine	40	2	06	029	Bats	291	7	298
72	Aquitaine	40	2	05	030	Baudignan	42	3	45
72	Aquitaine	40	1	27	031	Bégaar	1089	21	1110
72	Aquitaine	40	2	17	032	Belhade	192	3	195
72	Aquitaine	40	2	09	033	Bélis	149	3	152
72	Aquitaine	40	1	16	034	Bélus	603	7	610
72	Aquitaine	40	1	29	035	Bénesse-lès-Dax	518	16	534
72	Aquitaine	40	1	23	036	Bénesse-Maremne	2297	56	2353
72	Aquitaine	40	2	30	037	Benquet	1494	55	1549
72	Aquitaine	40	1	14	038	Bergouey	98	4	102
72	Aquitaine	40	2	05	039	Betbezer-d;Armagnac	141	6	147
72	Aquitaine	40	1	27	040	Beylongue	363	2	365
72	Aquitaine	40	1	02	041	Beyries	106	2	108
72	Aquitaine	40	1	21	042	Biarrotte	249	7	256
72	Aquitaine	40	2	10	043	Bias	765	17	782
72	Aquitaine	40	1	21	044	Biaudos	803	15	818
72	Aquitaine	40	2	15	046	Biscarrosse	12197	295	12492
72	Aquitaine	40	1	02	047	Bonnegarde	287	9	296
72	Aquitaine	40	1	27	048	Boos	312	2	314
72	Aquitaine	40	2	07	049	Bordères-et-Lamensans	349	12	361
72	Aquitaine	40	2	11	050	Bostens	176	4	180
72	Aquitaine	40	2	30	051	Bougue	612	29	641
72	Aquitaine	40	2	28	052	Bourdalat	210	3	213
72	Aquitaine	40	2	19	053	Bourriot-Bergonce	328	7	335
72	Aquitaine	40	1	02	054	Brassempouy	302	15	317
72	Aquitaine	40	2	30	055	Bretagne-de-Marsan	1426	44	1470
72	Aquitaine	40	2	09	056	Brocas	787	20	807
72	Aquitaine	40	2	01	057	Buanes	278	9	287
72	Aquitaine	40	2	19	058	Cachen	232	4	236
72	Aquitaine	40	1	18	059	Cagnotte	700	23	723
72	Aquitaine	40	2	24	060	Callen	142	4	146
72	Aquitaine	40	2	30	061	Campagne	944	33	977
72	Aquitaine	40	2	11	062	Campet-et-Lamolère	346	9	355
72	Aquitaine	40	1	29	063	Candresse	791	34	825
72	Aquitaine	40	2	09	064	Canenx-et-Réaut	175	4	179
72	Aquitaine	40	1	23	065	Capbreton	7965	285	8250
72	Aquitaine	40	1	26	066	Carcarès-Sainte-Croix	488	22	510
72	Aquitaine	40	1	27	067	Carcen-Ponson	629	16	645
72	Aquitaine	40	1	12	068	Cassen	573	13	586
72	Aquitaine	40	1	02	069	Castaignos-Souslens	396	2	398
72	Aquitaine	40	2	07	070	Castandet	400	15	415
72	Aquitaine	40	1	02	074	Castel-Sarrazin	531	17	548
72	Aquitaine	40	1	02	071	Castelnau-Chalosse	555	23	578
72	Aquitaine	40	2	06	072	Castelnau-Tursan	187	3	190
72	Aquitaine	40	2	08	073	Castelner	116	2	118
72	Aquitaine	40	1	03	075	Castets	1963	57	2020
72	Aquitaine	40	2	22	076	Cauna	421	10	431
72	Aquitaine	40	1	16	077	Cauneille	797	21	818
72	Aquitaine	40	1	14	078	Caupenne	404	5	409
72	Aquitaine	40	2	08	079	Cazalis	149	3	152
72	Aquitaine	40	2	07	080	Cazères-sur-l;Adour	1144	26	1170
72	Aquitaine	40	2	09	081	Cère	407	3	410
72	Aquitaine	40	2	01	082	Classun	264	9	273
72	Aquitaine	40	2	06	083	Clèdes	120	6	126
72	Aquitaine	40	1	12	084	Clermont	810	23	833
72	Aquitaine	40	2	20	085	Commensacq	406	6	412
72	Aquitaine	40	2	22	086	Coudures	476	6	482
72	Aquitaine	40	2	05	087	Créon-d;Armagnac	335	4	339
72	Aquitaine	40	1	97	088	Dax	20665	1037	21702
72	Aquitaine	40	1	14	089	Doazit	900	25	925
72	Aquitaine	40	1	02	090	Donzacq	445	7	452
72	Aquitaine	40	2	01	091	Duhort-Bachen	632	14	646
72	Aquitaine	40	2	22	092	Dumes	268	4	272
72	Aquitaine	40	2	05	093	Escalans	251	7	258
72	Aquitaine	40	2	20	094	Escource	610	10	620
72	Aquitaine	40	1	18	095	Estibeaux	654	10	664
72	Aquitaine	40	2	05	096	Estigarde	84	3	87
72	Aquitaine	40	2	01	097	Eugénie-les-Bains	448	11	459
72	Aquitaine	40	2	22	098	Eyres-Moncube	375	10	385
72	Aquitaine	40	2	22	099	Fargues	322	10	332
72	Aquitaine	40	2	28	100	Le Frêche	392	12	404
72	Aquitaine	40	1	18	101	Gaas	490	13	503
72	Aquitaine	40	2	05	102	Gabarret	1287	194	1481
72	Aquitaine	40	2	11	103	Gaillères	571	20	591
72	Aquitaine	40	1	12	104	Gamarde-les-Bains	1050	26	1076
72	Aquitaine	40	2	09	105	Garein	424	8	432
72	Aquitaine	40	1	12	106	Garrey	179	9	188
72	Aquitaine	40	2	13	107	Garrosse	312	7	319
72	Aquitaine	40	2	15	108	Gastes	606	13	619
72	Aquitaine	40	1	02	109	Gaujacq	448	8	456
72	Aquitaine	40	2	06	110	Geaune	730	16	746
72	Aquitaine	40	2	11	111	Geloux	734	5	739
72	Aquitaine	40	1	12	112	Gibret	103	6	109
72	Aquitaine	40	1	12	113	Goos	538	24	562
72	Aquitaine	40	1	04	114	Gourbera	356	11	367
72	Aquitaine	40	1	12	115	Gousse	305	8	313
72	Aquitaine	40	1	26	116	Gouts	242	6	248
72	Aquitaine	40	2	07	117	Grenade-sur-l;Adour	2503	57	2560
72	Aquitaine	40	1	18	118	Habas	1443	23	1466
72	Aquitaine	40	2	08	119	Hagetmau	4535	125	4660
72	Aquitaine	40	1	16	120	Hastingues	601	21	622
72	Aquitaine	40	1	14	121	Hauriet	264	6	270
72	Aquitaine	40	2	30	122	Haut-Mauco	809	29	838
72	Aquitaine	40	1	04	123	Herm	1044	33	1077
72	Aquitaine	40	2	05	124	Herré	127	3	130
72	Aquitaine	40	1	29	125	Heugas	1237	47	1284
72	Aquitaine	40	1	12	126	Hinx	1775	45	1820
72	Aquitaine	40	2	28	127	Hontanx	548	9	557
72	Aquitaine	40	2	08	128	Horsarrieu	633	22	655
72	Aquitaine	40	1	23	129	Josse	817	14	831
72	Aquitaine	40	2	08	130	Labastide-Chalosse	135	4	139
72	Aquitaine	40	2	19	131	Labastide-d;Armagnac	689	22	711
72	Aquitaine	40	1	18	132	Labatut	1423	31	1454
72	Aquitaine	40	1	23	133	Labenne	4803	107	4910
72	Aquitaine	40	2	20	134	Labouheyre	2592	66	2658
72	Aquitaine	40	2	09	135	Labrit	874	20	894
72	Aquitaine	40	2	06	136	Lacajunte	134	0	134
72	Aquitaine	40	2	28	137	Lacquy	232	5	237
72	Aquitaine	40	2	08	138	Lacrabe	237	7	244
72	Aquitaine	40	2	30	139	Laglorieuse	557	30	587
72	Aquitaine	40	2	05	140	Lagrange	205	6	211
72	Aquitaine	40	1	14	141	Lahosse	292	11	303
72	Aquitaine	40	1	27	142	Laluque	823	21	844
72	Aquitaine	40	1	26	143	Lamothe	300	10	310
72	Aquitaine	40	1	14	144	Larbey	249	7	256
72	Aquitaine	40	2	07	145	Larrivière-Saint-Savin	600	10	610
72	Aquitaine	40	2	01	146	Latrille	166	6	172
72	Aquitaine	40	1	14	147	Laurède	371	13	384
72	Aquitaine	40	2	06	148	Lauret	82	0	82
72	Aquitaine	40	2	19	149	Lencouacq	398	11	409
72	Aquitaine	40	1	03	150	Léon	1877	50	1927
72	Aquitaine	40	1	27	151	Lesgor	375	9	384
72	Aquitaine	40	2	13	152	Lesperon	1017	30	1047
72	Aquitaine	40	1	26	153	Le Leuy	226	2	228
72	Aquitaine	40	1	03	154	Lévignacq	346	5	351
72	Aquitaine	40	1	03	155	Linxe	1275	27	1302
72	Aquitaine	40	2	17	156	Liposthey	438	5	443
72	Aquitaine	40	1	03	157	Lit-et-Mixe	1520	51	1571
72	Aquitaine	40	2	05	158	Losse	260	5	265
72	Aquitaine	40	1	12	159	Louer	266	6	272
72	Aquitaine	40	1	12	160	Lourquen	222	6	228
72	Aquitaine	40	2	05	161	Lubbon	106	2	108
72	Aquitaine	40	2	11	162	Lucbardez-et-Bargues	507	15	522
72	Aquitaine	40	2	20	163	Lüe	506	8	514
72	Aquitaine	40	2	20	165	Luglon	339	18	357
72	Aquitaine	40	2	07	166	Lussagnet	81	0	81
72	Aquitaine	40	2	24	167	Luxey	662	7	669
72	Aquitaine	40	1	25	168	Magescq	1853	42	1895
72	Aquitaine	40	2	19	169	Maillas	113	1	114
72	Aquitaine	40	2	09	170	Maillères	213	3	216
72	Aquitaine	40	2	17	171	Mano	109	4	113
72	Aquitaine	40	2	08	172	Mant	289	6	295
72	Aquitaine	40	1	02	173	Marpaps	147	2	149
72	Aquitaine	40	2	06	174	Mauries	90	4	94
72	Aquitaine	40	2	07	175	Maurrin	459	8	467
72	Aquitaine	40	2	05	176	Mauvezin-d;Armagnac	107	1	108
72	Aquitaine	40	1	14	177	Maylis	340	10	350
72	Aquitaine	40	2	30	178	Mazerolles	698	37	735
72	Aquitaine	40	1	04	179	Mées	1736	51	1787
72	Aquitaine	40	1	26	180	Meilhan	1104	32	1136
72	Aquitaine	40	1	25	181	Messanges	984	40	1024
72	Aquitaine	40	2	10	182	Mézos	854	14	868
72	Aquitaine	40	1	18	183	Mimbaste	1018	35	1053
72	Aquitaine	40	2	10	184	Mimizan	7069	201	7270
72	Aquitaine	40	2	06	185	Miramont-Sensacq	361	25	386
72	Aquitaine	40	1	18	186	Misson	716	24	740
72	Aquitaine	40	1	25	187	Moliets-et-Maa	956	19	975
72	Aquitaine	40	2	08	188	Momuy	453	9	462
72	Aquitaine	40	2	08	189	Monget	82	2	84
72	Aquitaine	40	2	08	190	Monségur	378	8	386
72	Aquitaine	40	2	98	192	Mont-de-Marsan	31225	1899	33124
72	Aquitaine	40	2	22	191	Montaut	556	22	578
72	Aquitaine	40	2	28	193	Montégut	71	0	71
72	Aquitaine	40	1	12	194	Montfort-en-Chalosse	1157	31	1188
72	Aquitaine	40	2	22	195	Montgaillard	577	8	585
72	Aquitaine	40	2	22	196	Montsoué	574	16	590
72	Aquitaine	40	2	13	197	Morcenx	4606	329	4935
72	Aquitaine	40	2	08	198	Morganx	186	7	193
72	Aquitaine	40	1	18	199	Mouscardès	258	6	264
72	Aquitaine	40	2	17	200	Moustey	668	12	680
72	Aquitaine	40	1	14	201	Mugron	1390	106	1496
72	Aquitaine	40	1	29	202	Narrosse	3015	78	3093
72	Aquitaine	40	1	02	203	Nassiet	331	10	341
72	Aquitaine	40	1	14	204	Nerbis	257	7	264
72	Aquitaine	40	1	12	205	Nousse	282	5	287
72	Aquitaine	40	1	16	206	Oeyregave	362	7	369
72	Aquitaine	40	1	29	207	Oeyreluy	1593	187	1780
72	Aquitaine	40	1	12	208	Onard	351	9	360
72	Aquitaine	40	1	21	209	Ondres	4555	122	4677
72	Aquitaine	40	2	13	210	Onesse-et-Laharie	959	21	980
72	Aquitaine	40	1	16	211	Orist	679	11	690
72	Aquitaine	40	1	16	212	Orthevielle	904	18	922
72	Aquitaine	40	1	23	213	Orx	521	13	534
72	Aquitaine	40	1	18	214	Ossages	478	18	496
72	Aquitaine	40	2	13	215	Ousse-Suzan	243	10	253
72	Aquitaine	40	1	12	216	Ozourt	201	3	204
72	Aquitaine	40	2	15	217	Parentis-en-Born	5304	252	5556
72	Aquitaine	40	2	05	218	Parleboscq	506	14	520
72	Aquitaine	40	2	06	219	Payros-Cazautets	95	4	99
72	Aquitaine	40	2	06	220	Pécorade	152	10	162
72	Aquitaine	40	2	28	221	Perquie	365	5	370
72	Aquitaine	40	1	16	222	Pey	696	9	705
72	Aquitaine	40	2	08	223	Peyre	214	0	214
72	Aquitaine	40	1	16	224	Peyrehorade	3467	159	3626
72	Aquitaine	40	2	06	225	Philondenx	215	3	218
72	Aquitaine	40	2	06	226	Pimbo	185	7	192
72	Aquitaine	40	2	17	227	Pissos	1356	25	1381
72	Aquitaine	40	1	02	228	Pomarez	1503	45	1548
72	Aquitaine	40	2	10	229	Pontenx-les-Forges	1467	36	1503
72	Aquitaine	40	1	27	230	Pontonx-sur-l;Adour	2516	134	2650
72	Aquitaine	40	1	16	231	Port-de-Lanne	901	11	912
72	Aquitaine	40	2	08	232	Poudenx	229	3	232
72	Aquitaine	40	1	18	233	Pouillon	2870	90	2960
72	Aquitaine	40	2	19	234	Pouydesseaux	901	17	918
72	Aquitaine	40	1	12	235	Poyanne	613	16	629
72	Aquitaine	40	1	12	236	Poyartin	754	26	780
72	Aquitaine	40	1	12	237	Préchacq-les-Bains	676	9	685
72	Aquitaine	40	2	28	238	Pujo-le-Plan	577	7	584
72	Aquitaine	40	2	06	239	Puyol-Cazalet	122	2	124
72	Aquitaine	40	2	01	240	Renung	508	22	530
72	Aquitaine	40	2	19	164	Retjons	320	4	324
72	Aquitaine	40	2	05	242	Rimbez-et-Baudiets	101	2	103
72	Aquitaine	40	1	27	243	Rion-des-Landes	2459	58	2517
72	Aquitaine	40	1	04	244	Rivière-Saas-et-Gourby	1180	28	1208
72	Aquitaine	40	2	19	245	Roquefort	1896	41	1937
72	Aquitaine	40	2	20	246	Sabres	1220	104	1324
72	Aquitaine	40	2	01	247	Saint-Agnet	193	6	199
72	Aquitaine	40	1	21	248	Saint-André-de-Seignanx	1542	32	1574
72	Aquitaine	40	1	14	249	Saint-Aubin	502	11	513
72	Aquitaine	40	2	11	250	Saint-Avit	615	22	637
72	Aquitaine	40	1	21	251	Saint-Barthélemy	370	6	376
72	Aquitaine	40	2	08	253	Saint-Cricq-Chalosse	659	19	678
72	Aquitaine	40	1	16	254	Saint-Cricq-du-Gave	370	4	374
72	Aquitaine	40	2	28	255	Saint-Cricq-Villeneuve	437	12	449
72	Aquitaine	40	1	16	256	Saint-Étienne-d;Orthe	593	7	600
72	Aquitaine	40	2	28	259	Saint-Gein	448	6	454
72	Aquitaine	40	1	12	260	Saint-Geours-d;Auribat	348	6	354
72	Aquitaine	40	1	25	261	Saint-Geours-de-Maremne	2157	41	2198
72	Aquitaine	40	2	19	262	Saint-Gor	310	6	316
72	Aquitaine	40	1	12	263	Saint-Jean-de-Lier	388	22	410
72	Aquitaine	40	1	23	264	Saint-Jean-de-Marsacq	1325	45	1370
72	Aquitaine	40	2	05	265	Saint-Julien-d;Armagnac	118	4	122
72	Aquitaine	40	1	03	266	Saint-Julien-en-Born	1451	69	1520
72	Aquitaine	40	2	19	267	Saint-Justin	929	22	951
72	Aquitaine	40	1	21	268	Saint-Laurent-de-Gosse	560	16	576
72	Aquitaine	40	1	16	269	Saint-Lon-les-Mines	1186	42	1228
72	Aquitaine	40	2	01	270	Saint-Loubouer	434	6	440
72	Aquitaine	40	2	11	274	Saint-Martin-d;Oney	1303	25	1328
72	Aquitaine	40	1	23	272	Saint-Martin-de-Hinx	1296	23	1319
72	Aquitaine	40	1	21	273	Saint-Martin-de-Seignanx	4863	111	4974
72	Aquitaine	40	2	07	275	Saint-Maurice-sur-Adour	578	22	600
72	Aquitaine	40	1	03	276	Saint-Michel-Escalus	291	12	303
72	Aquitaine	40	1	29	277	Saint-Pandelon	750	65	815
72	Aquitaine	40	2	10	278	Saint-Paul-en-Born	817	22	839
72	Aquitaine	40	1	04	279	Saint-Paul-lès-Dax	12409	495	12904
72	Aquitaine	40	2	30	280	Saint-Perdon	1707	54	1761
72	Aquitaine	40	2	30	281	Saint-Pierre-du-Mont	8924	390	9314
72	Aquitaine	40	2	22	282	Saint-Sever	4789	125	4914
72	Aquitaine	40	1	04	283	Saint-Vincent-de-Paul	2997	361	3358
72	Aquitaine	40	1	23	284	Saint-Vincent-de-Tyrosse	7585	214	7799
72	Aquitaine	40	1	27	285	Saint-Yaguen	569	11	580
72	Aquitaine	40	2	08	252	Sainte-Colombe	651	23	674
72	Aquitaine	40	2	15	257	Sainte-Eulalie-en-Born	1167	25	1192
72	Aquitaine	40	2	28	258	Sainte-Foy	254	4	258
72	Aquitaine	40	1	23	271	Sainte-Marie-de-Gosse	1060	12	1072
72	Aquitaine	40	2	06	286	Samadet	1056	26	1082
72	Aquitaine	40	2	15	287	Sanguinet	3258	65	3323
72	Aquitaine	40	2	19	288	Sarbazan	1098	28	1126
72	Aquitaine	40	2	22	289	Sarraziet	209	5	214
72	Aquitaine	40	2	01	290	Sarron	120	2	122
72	Aquitaine	40	1	23	291	Saubion	1377	22	1399
72	Aquitaine	40	1	23	292	Saubrigues	1381	51	1432
72	Aquitaine	40	1	04	293	Saubusse	818	22	840
72	Aquitaine	40	1	29	294	Saugnac-et-Cambran	1612	55	1667
72	Aquitaine	40	2	17	295	Saugnacq-et-Muret	905	17	922
72	Aquitaine	40	1	25	296	Seignosse	3310	74	3384
72	Aquitaine	40	2	09	297	Le Sen	207	4	211
72	Aquitaine	40	2	08	298	Serres-Gaston	360	7	367
72	Aquitaine	40	2	08	299	Serreslous-et-Arribans	208	5	213
72	Aquitaine	40	1	29	300	Seyresse	798	38	836
72	Aquitaine	40	1	29	301	Siest	113	4	117
72	Aquitaine	40	2	13	302	Sindères	185	3	188
72	Aquitaine	40	2	20	303	Solférino	345	8	353
72	Aquitaine	40	1	25	304	Soorts-Hossegor	3723	96	3819
72	Aquitaine	40	2	06	305	Sorbets	186	7	193
72	Aquitaine	40	1	16	306	Sorde-l;Abbaye	651	25	676
72	Aquitaine	40	2	24	307	Sore	1044	16	1060
72	Aquitaine	40	1	12	308	Sort-en-Chalosse	886	36	922
72	Aquitaine	40	1	26	309	Souprosse	997	26	1023
72	Aquitaine	40	1	25	310	Soustons	7294	153	7447
72	Aquitaine	40	1	03	311	Taller	458	14	472
72	Aquitaine	40	1	21	312	Tarnos	11906	235	12141
72	Aquitaine	40	1	99	313	Tartas	3088	81	3169
72	Aquitaine	40	1	29	314	Tercis-les-Bains	1161	47	1208
72	Aquitaine	40	1	04	315	Téthieu	656	28	684
72	Aquitaine	40	1	18	316	Tilh	816	14	830
72	Aquitaine	40	1	25	317	Tosse	2374	51	2425
72	Aquitaine	40	1	14	318	Toulouzette	279	6	285
72	Aquitaine	40	2	20	319	Trensacq	270	7	277
72	Aquitaine	40	2	11	320	Uchacq-et-Parentis	575	28	603
72	Aquitaine	40	2	06	321	Urgons	264	8	272
72	Aquitaine	40	1	03	322	Uza	155	7	162
72	Aquitaine	40	2	09	323	Vert	236	3	239
72	Aquitaine	40	1	12	324	Vicq-d;Auribat	262	10	272
72	Aquitaine	40	1	03	326	Vielle-Saint-Girons	1195	36	1231
72	Aquitaine	40	2	19	327	Vielle-Soubiran	246	5	251
72	Aquitaine	40	2	01	325	Vielle-Tursan	289	4	293
72	Aquitaine	40	1	25	328	Vieux-Boucau-les-Bains	1564	45	1609
72	Aquitaine	40	2	07	329	Le Vignau	487	10	497
72	Aquitaine	40	1	27	330	Villenave	264	7	271
72	Aquitaine	40	2	28	331	Villeneuve-de-Marsan	2371	57	2428
72	Aquitaine	40	2	15	332	Ychoux	2041	42	2083
72	Aquitaine	40	2	13	333	Ygos-Saint-Saturnin	1219	18	1237
72	Aquitaine	40	1	29	334	Yzosse	422	11	433
24	Centre	41	2	19	001	Ambloy	196	4	200
24	Centre	41	1	13	002	Angé	817	19	836
24	Centre	41	2	28	003	Areines	609	192	801
24	Centre	41	2	12	004	Artins	298	12	310
24	Centre	41	2	11	005	Arville	104	8	112
24	Centre	41	1	08	006	Autainville	378	9	387
24	Centre	41	2	19	007	Authon	641	13	654
24	Centre	41	1	10	008	Avaray	723	15	738
24	Centre	41	1	06	009	Averdon	703	14	717
24	Centre	41	2	24	010	Azé	1119	18	1137
24	Centre	41	2	23	011	Baigneaux	51	1	52
24	Centre	41	2	11	012	Baillou	246	6	252
24	Centre	41	1	03	013	Bauzy	264	5	269
24	Centre	41	2	11	014	Beauchêne	163	2	165
24	Centre	41	1	08	015	Beauvilliers	62	1	63
24	Centre	41	3	22	016	Billy	901	18	919
24	Centre	41	1	16	017	Binas	731	18	749
24	Centre	41	1	99	018	Blois	46492	2076	48568
24	Centre	41	1	08	019	Boisseau	100	4	104
24	Centre	41	2	21	020	Bonneveau	502	15	517
24	Centre	41	2	05	022	Bouffry	146	1	147
24	Centre	41	1	13	023	Bourré	748	12	760
24	Centre	41	2	05	024	Boursay	206	9	215
24	Centre	41	1	03	025	Bracieux	1254	19	1273
24	Centre	41	2	14	026	Brévainville	171	1	172
24	Centre	41	1	08	027	Briou	117	4	121
24	Centre	41	2	14	028	Busloup	433	9	442
24	Centre	41	1	04	029	Candé-sur-Beuvron	1479	33	1512
24	Centre	41	2	21	030	Cellé	249	5	254
24	Centre	41	1	02	031	Cellettes	2345	69	2414
24	Centre	41	1	02	032	Chailles	2537	47	2584
24	Centre	41	1	06	033	Chambon-sur-Cisse	689	49	738
24	Centre	41	1	03	034	Chambord	134	3	137
24	Centre	41	1	06	035	Champigny-en-Beauce	654	18	672
24	Centre	41	3	07	036	Chaon	448	11	459
24	Centre	41	2	23	037	La Chapelle-Enchérie	176	6	182
24	Centre	41	3	09	038	La Chapelle-Montmartin	420	7	427
24	Centre	41	1	10	039	La Chapelle-Saint-Martin-en-Plaine	689	24	713
24	Centre	41	1	06	040	La Chapelle-Vendômoise	741	27	768
24	Centre	41	2	05	041	La Chapelle-Vicomtesse	186	6	192
24	Centre	41	3	18	042	Châteauvieux	555	13	568
24	Centre	41	3	18	043	Châtillon-sur-Cher	1691	44	1735
24	Centre	41	3	09	044	Châtres-sur-Cher	1090	15	1105
24	Centre	41	1	13	045	Chaumont-sur-Loire	1056	25	1081
24	Centre	41	3	07	046	Chaumont-sur-Tharonne	1096	19	1115
24	Centre	41	1	01	047	La Chaussée-Saint-Victor	4230	133	4363
24	Centre	41	2	05	048	Chauvigny-du-Perche	227	8	235
24	Centre	41	3	18	049	Chémery	961	66	1027
24	Centre	41	1	04	050	Cheverny	932	28	960
24	Centre	41	1	13	051	Chissay-en-Touraine	1143	41	1184
24	Centre	41	1	04	052	Chitenay	1022	29	1051
24	Centre	41	2	11	053	Choue	529	11	540
24	Centre	41	3	18	054	Choussy	330	6	336
24	Centre	41	1	06	055	Chouzy-sur-Cisse	1860	75	1935
24	Centre	41	1	16	056	La Colombe	198	6	204
24	Centre	41	1	08	057	Conan	199	5	204
24	Centre	41	1	08	058	Concriers	162	3	165
24	Centre	41	1	04	059	Contres	3420	86	3506
24	Centre	41	2	11	060	Cormenon	697	11	708
24	Centre	41	1	04	061	Cormeray	1530	26	1556
24	Centre	41	3	18	062	Couddes	511	9	520
24	Centre	41	3	18	063	Couffy	558	23	581
24	Centre	41	1	06	064	Coulanges	308	4	312
24	Centre	41	2	23	065	Coulommiers-la-Tour	527	24	551
24	Centre	41	1	04	067	Cour-Cheverny	2731	91	2822
24	Centre	41	1	10	069	Cour-sur-Loire	272	15	287
24	Centre	41	1	10	066	Courbouzon	445	14	459
24	Centre	41	3	17	068	Courmemin	524	6	530
24	Centre	41	2	12	070	Couture-sur-Loir	415	5	420
24	Centre	41	1	03	071	Crouy-sur-Cosson	510	27	537
24	Centre	41	2	19	072	Crucheray	411	13	424
24	Centre	41	2	14	073	Danzé	721	21	742
24	Centre	41	3	15	074	Dhuizon	1430	22	1452
24	Centre	41	2	05	075	Droué	1073	19	1092
24	Centre	41	2	23	077	Épiais	142	3	145
24	Centre	41	2	21	078	Épuisay	745	15	760
24	Centre	41	2	12	079	Les Essarts	105	4	109
24	Centre	41	1	13	080	Faverolles-sur-Cher	1293	63	1356
24	Centre	41	2	23	081	Faye	220	1	221
24	Centre	41	1	04	082	Feings	708	13	721
24	Centre	41	3	15	083	La Ferté-Beauharnais	536	4	540
24	Centre	41	3	20	084	La Ferté-Imbault	989	19	1008
24	Centre	41	3	15	085	La Ferté-Saint-Cyr	1019	31	1050
24	Centre	41	2	21	087	Fontaine-les-Coteaux	385	13	398
24	Centre	41	2	05	088	Fontaine-Raoul	238	4	242
24	Centre	41	1	03	086	Fontaines-en-Sologne	623	7	630
24	Centre	41	2	05	089	La Fontenelle	196	9	205
24	Centre	41	2	21	090	Fortan	268	8	276
24	Centre	41	1	27	091	Fossé	1121	25	1146
24	Centre	41	1	04	092	Fougères-sur-Bièvre	801	63	864
24	Centre	41	1	06	093	Françay	297	11	308
24	Centre	41	1	04	094	Fresnes	1080	34	1114
24	Centre	41	2	14	095	Fréteval	1095	23	1118
24	Centre	41	2	05	096	Le Gault-Perche	290	9	299
24	Centre	41	3	22	097	Gièvres	2292	53	2345
24	Centre	41	2	19	098	Gombergean	182	3	185
24	Centre	41	3	22	099	Gy-en-Sologne	511	5	516
24	Centre	41	2	12	100	Les Hayes	201	7	208
24	Centre	41	1	06	101	Herbault	1197	52	1249
24	Centre	41	2	12	102	Houssay	370	12	382
24	Centre	41	2	19	103	Huisseau-en-Beauce	404	11	415
24	Centre	41	1	03	104	Huisseau-sur-Cosson	2193	59	2252
24	Centre	41	1	08	105	Josnes	907	18	925
24	Centre	41	3	07	106	Lamotte-Beuvron	4736	104	4840
24	Centre	41	2	19	107	Lancé	453	8	461
24	Centre	41	1	06	108	Lancôme	136	9	145
24	Centre	41	1	06	109	Landes-le-Gaulois	697	30	727
24	Centre	41	3	09	110	Langon	848	13	861
24	Centre	41	3	22	112	Lassay-sur-Croisne	245	9	254
24	Centre	41	2	12	113	Lavardin	208	5	213
24	Centre	41	1	10	114	Lestiou	269	8	277
24	Centre	41	2	14	115	Lignières	418	14	432
24	Centre	41	2	14	116	Lisle	211	7	218
24	Centre	41	3	29	118	Loreux	236	1	237
24	Centre	41	1	08	119	Lorges	370	5	375
24	Centre	41	2	21	120	Lunay	1334	43	1377
24	Centre	41	1	08	121	La Madeleine-Villefrouin	27	1	28
24	Centre	41	3	09	122	Maray	229	9	238
24	Centre	41	1	08	123	Marchenoir	699	5	704
24	Centre	41	2	28	124	Marcilly-en-Beauce	362	6	368
24	Centre	41	3	20	125	Marcilly-en-Gault	751	17	768
24	Centre	41	3	18	126	Mareuil-sur-Cher	1123	47	1170
24	Centre	41	3	15	127	La Marolle-en-Sologne	397	5	402
24	Centre	41	1	27	128	Marolles	710	23	733
24	Centre	41	1	03	129	Maslives	684	13	697
24	Centre	41	1	10	130	Maves	663	12	675
24	Centre	41	2	24	131	Mazangé	916	40	956
24	Centre	41	3	18	132	Méhers	341	7	348
24	Centre	41	1	16	133	Membrolles	263	7	270
24	Centre	41	1	10	134	Menars	606	40	646
24	Centre	41	3	09	135	Mennetou-sur-Cher	884	19	903
24	Centre	41	1	10	136	Mer	6115	138	6253
24	Centre	41	1	06	137	Mesland	556	11	567
24	Centre	41	2	28	138	Meslay	293	9	302
24	Centre	41	3	18	139	Meusnes	1047	17	1064
24	Centre	41	3	17	140	Millançay	744	13	757
24	Centre	41	1	16	141	Moisy	318	5	323
24	Centre	41	1	06	142	Molineuf	796	35	831
24	Centre	41	2	11	143	Mondoubleau	1497	43	1540
24	Centre	41	1	03	150	Mont-près-Chambord	3271	128	3399
24	Centre	41	1	06	144	Monteaux	792	25	817
24	Centre	41	1	04	145	Monthou-sur-Bièvre	764	18	782
24	Centre	41	1	13	146	Monthou-sur-Cher	969	18	987
24	Centre	41	1	04	147	Les Montils	1794	49	1843
24	Centre	41	1	30	148	Montlivault	1339	31	1370
24	Centre	41	2	12	149	Montoire-sur-le-Loir	4058	227	4285
24	Centre	41	1	13	151	Montrichard	3427	74	3501
24	Centre	41	3	15	152	Montrieux-en-Sologne	631	5	636
24	Centre	41	2	12	153	Montrouveau	133	1	134
24	Centre	41	2	14	154	Morée	1140	23	1163
24	Centre	41	1	03	155	Muides-sur-Loire	1365	31	1396
24	Centre	41	1	10	156	Mulsans	457	11	468
24	Centre	41	3	22	157	Mur-de-Sologne	1430	20	1450
24	Centre	41	2	24	158	Naveil	2143	75	2218
24	Centre	41	3	15	159	Neung-sur-Beuvron	1238	26	1264
24	Centre	41	1	03	160	Neuvy	326	4	330
24	Centre	41	3	07	161	Nouan-le-Fuzelier	2381	74	2455
24	Centre	41	2	19	163	Nourray	116	9	125
24	Centre	41	3	18	164	Noyers-sur-Cher	2809	175	2984
24	Centre	41	2	11	165	Oigny	93	1	94
24	Centre	41	1	04	166	Oisly	342	11	353
24	Centre	41	1	06	167	Onzain	3471	166	3637
24	Centre	41	1	06	169	Orchaise	897	28	925
24	Centre	41	3	20	168	Orçay	240	5	245
24	Centre	41	1	04	170	Ouchamps	832	24	856
24	Centre	41	1	08	171	Oucques	1482	22	1504
24	Centre	41	1	16	172	Ouzouer-le-Doyen	226	1	227
24	Centre	41	1	16	173	Ouzouer-le-Marché	1907	47	1954
24	Centre	41	2	23	174	Périgny	191	11	202
24	Centre	41	2	14	175	Pezou	1125	24	1149
24	Centre	41	3	20	176	Pierrefitte-sur-Sauldre	842	10	852
24	Centre	41	2	11	177	Le Plessis-Dorin	184	3	187
24	Centre	41	1	08	178	Le Plessis-l;Échelle	74	1	75
24	Centre	41	2	05	179	Le Poislay	210	1	211
24	Centre	41	1	13	180	Pontlevoy	1586	134	1720
24	Centre	41	3	18	181	Pouillé	807	21	828
24	Centre	41	2	23	182	Pray	305	5	310
24	Centre	41	1	16	183	Prénouvellon	218	3	221
24	Centre	41	2	19	184	Prunay-Cassereau	652	24	676
24	Centre	41	3	29	185	Pruniers-en-Sologne	2292	57	2349
24	Centre	41	2	14	186	Rahart	288	8	296
24	Centre	41	2	23	187	Renay	176	5	181
24	Centre	41	2	23	188	Rhodon	105	4	109
24	Centre	41	1	13	189	Rilly-sur-Loire	459	9	468
24	Centre	41	2	23	190	Rocé	188	6	194
24	Centre	41	1	08	191	Roches	73	1	74
24	Centre	41	2	12	192	Les Roches-l;Évêque	292	6	298
24	Centre	41	2	05	193	Romilly	162	2	164
24	Centre	41	3	97	194	Romorantin-Lanthenay	17027	731	17758
24	Centre	41	3	22	195	Rougeou	116	1	117
24	Centre	41	2	05	196	Ruan-sur-Egvonne	91	0	91
24	Centre	41	2	11	197	Saint-Agil	273	5	278
24	Centre	41	3	18	198	Saint-Aignan	3166	143	3309
24	Centre	41	2	19	199	Saint-Amand-Longpré	1218	20	1238
24	Centre	41	2	12	201	Saint-Arnoult	331	5	336
24	Centre	41	2	11	202	Saint-Avit	110	6	116
24	Centre	41	1	27	203	Saint-Bohaire	472	29	501
24	Centre	41	1	30	204	Saint-Claude-de-Diray	1698	62	1760
24	Centre	41	1	06	205	Saint-Cyr-du-Gault	179	3	182
24	Centre	41	1	01	206	Saint-Denis-sur-Loire	787	34	821
24	Centre	41	1	03	207	Saint-Dyé-sur-Loire	1114	22	1136
24	Centre	41	1	06	208	Saint-Étienne-des-Guérets	97	0	97
24	Centre	41	2	14	209	Saint-Firmin-des-Prés	835	65	900
24	Centre	41	1	13	211	Saint-Georges-sur-Cher	2448	82	2530
24	Centre	41	1	02	212	Saint-Gervais-la-Forêt	3312	128	3440
24	Centre	41	2	19	213	Saint-Gourgon	120	1	121
24	Centre	41	2	14	214	Saint-Hilaire-la-Gravelle	689	12	701
24	Centre	41	2	12	215	Saint-Jacques-des-Guérets	94	4	98
24	Centre	41	2	14	216	Saint-Jean-Froidmentel	503	6	509
24	Centre	41	1	13	217	Saint-Julien-de-Chédon	734	10	744
24	Centre	41	3	09	218	Saint-Julien-sur-Cher	747	17	764
24	Centre	41	1	08	219	Saint-Laurent-des-Bois	296	8	304
24	Centre	41	1	03	220	Saint-Laurent-Nouan	4222	115	4337
24	Centre	41	1	08	221	Saint-Léonard-en-Beauce	622	20	642
24	Centre	41	3	09	222	Saint-Loup	361	9	370
24	Centre	41	1	27	223	Saint-Lubin-en-Vergonnois	682	20	702
24	Centre	41	2	11	224	Saint-Marc-du-Cor	190	4	194
24	Centre	41	2	12	225	Saint-Martin-des-Bois	615	11	626
24	Centre	41	2	28	226	Saint-Ouen	3448	98	3546
24	Centre	41	2	12	228	Saint-Rimay	285	9	294
24	Centre	41	3	18	229	Saint-Romain-sur-Cher	1513	30	1543
24	Centre	41	1	27	230	Saint-Sulpice-de-Pommeray	1801	57	1858
24	Centre	41	3	20	231	Saint-Viâtre	1269	19	1288
24	Centre	41	2	28	200	Sainte-Anne	371	13	384
24	Centre	41	2	23	210	Sainte-Gemmes	101	3	104
24	Centre	41	3	20	232	Salbris	5704	124	5828
24	Centre	41	1	04	233	Sambin	917	16	933
24	Centre	41	1	06	234	Santenay	271	6	277
24	Centre	41	2	11	235	Sargé-sur-Braye	1003	10	1013
24	Centre	41	2	19	236	Sasnières	101	2	103
24	Centre	41	1	04	237	Sassay	918	9	927
24	Centre	41	2	21	238	Savigny-sur-Braye	2177	37	2214
24	Centre	41	3	18	239	Seigy	1121	20	1141
24	Centre	41	1	06	240	Seillac	84	3	87
24	Centre	41	3	20	241	Selles-Saint-Denis	1241	30	1271
24	Centre	41	3	22	242	Selles-sur-Cher	4616	101	4717
24	Centre	41	2	23	243	Selommes	843	13	856
24	Centre	41	1	16	244	Semerville	95	1	96
24	Centre	41	1	08	245	Séris	375	3	378
24	Centre	41	1	04	246	Seur	467	14	481
24	Centre	41	3	22	247	Soings-en-Sologne	1543	21	1564
24	Centre	41	2	11	248	Souday	538	8	546
24	Centre	41	3	20	249	Souesmes	1119	21	1140
24	Centre	41	2	21	250	Sougé	482	5	487
24	Centre	41	3	07	251	Souvigny-en-Sologne	494	9	503
24	Centre	41	1	10	252	Suèvres	1498	45	1543
24	Centre	41	1	08	253	Talcy	261	9	270
24	Centre	41	2	11	254	Le Temple	176	4	180
24	Centre	41	2	12	255	Ternay	314	7	321
24	Centre	41	3	20	256	Theillay	1274	20	1294
24	Centre	41	1	13	257	Thenay	846	13	859
24	Centre	41	3	18	258	Thésée	1181	38	1219
24	Centre	41	2	24	259	Thoré-la-Rochette	886	28	914
24	Centre	41	3	15	260	Thoury	391	4	395
24	Centre	41	1	03	262	Tour-en-Sologne	951	14	965
24	Centre	41	2	23	261	Tourailles	130	4	134
24	Centre	41	2	12	263	Tréhet	111	0	111
24	Centre	41	1	16	264	Tripleville	149	6	155
24	Centre	41	2	12	265	Troo	328	4	332
24	Centre	41	1	04	266	Valaire	75	3	78
24	Centre	41	1	13	267	Vallières-les-Grandes	836	14	850
24	Centre	41	3	17	268	Veilleins	150	4	154
24	Centre	41	2	98	269	Vendôme	16920	767	17687
24	Centre	41	1	16	270	Verdes	495	4	499
24	Centre	41	3	17	271	Vernou-en-Sologne	606	9	615
24	Centre	41	1	06	272	Veuves	212	11	223
24	Centre	41	1	16	273	Vievy-le-Rayé	490	12	502
24	Centre	41	2	12	274	Villavard	147	4	151
24	Centre	41	2	14	275	La Ville-aux-Clercs	1333	26	1359
24	Centre	41	1	01	276	Villebarou	2619	46	2665
24	Centre	41	2	05	277	Villebout	127	1	128
24	Centre	41	2	19	278	Villechauve	289	7	296
24	Centre	41	2	12	279	Villedieu-le-Château	409	8	417
24	Centre	41	3	09	280	Villefranche-sur-Cher	2701	72	2773
24	Centre	41	1	06	281	Villefrancoeur	486	12	498
24	Centre	41	3	29	282	Villeherviers	492	9	501
24	Centre	41	2	23	283	Villemardy	282	7	289
24	Centre	41	1	08	284	Villeneuve-Frouville	71	1	72
24	Centre	41	3	15	285	Villeny	403	4	407
24	Centre	41	2	19	286	Villeporcher	148	1	149
24	Centre	41	2	28	287	Villerable	535	13	548
24	Centre	41	1	01	288	Villerbon	776	27	803
24	Centre	41	1	16	289	Villermain	350	11	361
24	Centre	41	2	23	290	Villeromain	225	5	230
24	Centre	41	2	23	291	Villetrun	324	12	336
24	Centre	41	1	10	292	Villexanton	187	7	194
24	Centre	41	2	24	294	Villiers-sur-Loir	1192	54	1246
24	Centre	41	2	28	293	Villiersfaux	256	9	265
24	Centre	41	1	30	295	Vineuil	7119	214	7333
24	Centre	41	3	07	296	Vouzon	1487	40	1527
24	Centre	41	3	07	297	Yvoy-le-Marron	617	11	628
82	Rhône-Alpes	42	1	17	001	Aboën	363	8	371
82	Rhône-Alpes	42	1	02	002	Ailleux	147	6	153
82	Rhône-Alpes	42	2	27	003	Ambierle	1805	55	1860
82	Rhône-Alpes	42	2	26	004	Amions	290	12	302
82	Rhône-Alpes	42	1	23	005	Andrézieux-Bouthéon	9676	217	9893
82	Rhône-Alpes	42	1	17	006	Apinac	401	5	406
82	Rhône-Alpes	42	2	01	007	Arcinges	194	3	197
82	Rhône-Alpes	42	2	27	008	Arcon	99	0	99
82	Rhône-Alpes	42	1	02	009	Arthun	511	16	527
82	Rhône-Alpes	42	1	23	010	Aveizieux	1467	42	1509
82	Rhône-Alpes	42	2	10	011	Balbigny	2840	45	2885
82	Rhône-Alpes	42	1	09	012	Bard	610	24	634
82	Rhône-Alpes	42	1	23	013	Bellegarde-en-Forez	1847	36	1883
82	Rhône-Alpes	42	2	01	014	Belleroche	259	3	262
82	Rhône-Alpes	42	2	01	015	Belmont-de-la-Loire	1532	26	1558
82	Rhône-Alpes	42	2	16	016	La Bénisson-Dieu	439	11	450
82	Rhône-Alpes	42	3	24	017	Le Bessat	438	15	453
82	Rhône-Alpes	42	3	13	018	Bessey	398	9	407
82	Rhône-Alpes	42	1	02	019	Boën	3181	74	3255
82	Rhône-Alpes	42	1	31	020	Boisset-lès-Montrond	1081	21	1102
82	Rhône-Alpes	42	1	29	021	Boisset-Saint-Priest	1141	21	1162
82	Rhône-Alpes	42	1	31	022	Bonson	3593	58	3651
82	Rhône-Alpes	42	3	03	023	Bourg-Argental	3011	69	3080
82	Rhône-Alpes	42	2	05	025	Boyer	225	5	230
82	Rhône-Alpes	42	2	16	026	Briennon	1733	43	1776
82	Rhône-Alpes	42	2	26	027	Bully	395	4	399
82	Rhône-Alpes	42	3	03	028	Burdignes	347	14	361
82	Rhône-Alpes	42	2	10	029	Bussières	1515	29	1544
82	Rhône-Alpes	42	1	02	030	Bussy-Albieux	482	17	499
82	Rhône-Alpes	42	3	08	031	Caloire	335	6	341
82	Rhône-Alpes	42	3	33	032	Cellieu	1578	56	1634
82	Rhône-Alpes	42	2	01	033	Le Cergne	713	15	728
82	Rhône-Alpes	42	1	11	034	Cervières	115	5	120
82	Rhône-Alpes	42	1	02	035	Cezay	190	7	197
82	Rhône-Alpes	42	3	33	036	Chagnon	506	8	514
82	Rhône-Alpes	42	1	09	037	Chalain-d;Uzore	534	10	544
82	Rhône-Alpes	42	1	09	038	Chalain-le-Comtal	657	20	677
82	Rhône-Alpes	42	1	25	039	Chalmazel	409	7	416
82	Rhône-Alpes	42	1	11	040	La Chamba	51	2	53
82	Rhône-Alpes	42	1	07	041	Chambéon	483	14	497
82	Rhône-Alpes	42	1	31	042	Chambles	969	25	994
82	Rhône-Alpes	42	1	23	043	Chamboeuf	1590	60	1650
82	Rhône-Alpes	42	3	04	044	Le Chambon-Feugerolles	12851	172	13023
82	Rhône-Alpes	42	1	11	045	La Chambonie	59	0	59
82	Rhône-Alpes	42	1	09	046	Champdieu	1694	51	1745
82	Rhône-Alpes	42	2	30	047	Champoly	288	4	292
82	Rhône-Alpes	42	2	05	048	Chandon	1448	52	1500
82	Rhône-Alpes	42	2	12	049	Changy	615	10	625
82	Rhône-Alpes	42	1	29	050	La Chapelle-en-Lafaye	138	0	138
82	Rhône-Alpes	42	3	13	051	La Chapelle-Villars	561	7	568
82	Rhône-Alpes	42	2	05	052	Charlieu	3695	126	3821
82	Rhône-Alpes	42	3	15	053	Châteauneuf	1480	21	1501
82	Rhône-Alpes	42	1	25	054	Châtelneuf	317	9	326
82	Rhône-Alpes	42	1	06	055	Châtelus	127	1	128
82	Rhône-Alpes	42	2	30	339	Chausseterre	245	5	250
82	Rhône-Alpes	42	3	13	056	Chavanay	2833	58	2891
82	Rhône-Alpes	42	1	29	058	Chazelles-sur-Lavieu	247	3	250
82	Rhône-Alpes	42	1	06	059	Chazelles-sur-Lyon	5110	98	5208
82	Rhône-Alpes	42	1	29	060	Chenereilles	476	6	482
82	Rhône-Alpes	42	2	30	061	Cherier	483	7	490
82	Rhône-Alpes	42	1	06	062	Chevrières	1055	17	1072
82	Rhône-Alpes	42	2	32	063	Chirassimont	376	12	388
82	Rhône-Alpes	42	3	13	064	Chuyer	766	21	787
82	Rhône-Alpes	42	1	07	065	Civens	1367	42	1409
82	Rhône-Alpes	42	1	07	066	Cleppé	556	18	574
82	Rhône-Alpes	42	3	03	067	Colombier	308	3	311
82	Rhône-Alpes	42	2	14	068	Combre	421	7	428
82	Rhône-Alpes	42	2	14	069	Commelle-Vernay	2800	71	2871
82	Rhône-Alpes	42	2	32	070	Cordelle	892	26	918
82	Rhône-Alpes	42	1	11	072	La Côte-en-Couzan	76	8	84
82	Rhône-Alpes	42	2	14	071	Le Coteau	6905	183	7088
82	Rhône-Alpes	42	1	07	073	Cottance	664	14	678
82	Rhône-Alpes	42	2	14	074	Coutouvre	1098	13	1111
82	Rhône-Alpes	42	1	31	075	Craintilleux	1170	9	1179
82	Rhône-Alpes	42	2	30	076	Cremeaux	947	11	958
82	Rhône-Alpes	42	2	32	077	Croizet-sur-Gand	284	3	287
82	Rhône-Alpes	42	2	12	078	Le Crozet	298	2	300
82	Rhône-Alpes	42	2	01	079	Cuinzier	658	10	668
82	Rhône-Alpes	42	1	23	081	Cuzieu	1498	33	1531
82	Rhône-Alpes	42	2	26	082	Dancé	159	2	161
82	Rhône-Alpes	42	3	15	083	Dargoire	452	8	460
82	Rhône-Alpes	42	1	02	084	Débats-Rivière-d;Orpra	166	2	168
82	Rhône-Alpes	42	3	33	085	Doizieux	828	10	838
82	Rhône-Alpes	42	2	01	086	Écoche	552	2	554
82	Rhône-Alpes	42	1	09	087	Écotay-l;Olme	1130	44	1174
82	Rhône-Alpes	42	1	07	088	Épercieux-Saint-Paul	663	14	677
82	Rhône-Alpes	42	1	09	089	Essertines-en-Châtelneuf	664	18	682
82	Rhône-Alpes	42	1	07	090	Essertines-en-Donzy	490	11	501
82	Rhône-Alpes	42	1	17	091	Estivareilles	671	7	678
82	Rhône-Alpes	42	3	28	092	L; Étrat	2621	100	2721
82	Rhône-Alpes	42	3	33	093	Farnay	1342	21	1363
82	Rhône-Alpes	42	1	07	094	Feurs	7921	216	8137
82	Rhône-Alpes	42	3	08	095	Firminy	17133	247	17380
82	Rhône-Alpes	42	3	28	096	Fontanès	652	9	661
82	Rhône-Alpes	42	3	28	097	La Fouillouse	4393	97	4490
82	Rhône-Alpes	42	2	32	098	Fourneaux	617	19	636
82	Rhône-Alpes	42	3	08	099	Fraisses	3958	61	4019
82	Rhône-Alpes	42	3	15	225	Genilac	3730	122	3852
82	Rhône-Alpes	42	1	06	100	La Gimond	272	1	273
82	Rhône-Alpes	42	3	03	101	Graix	145	1	146
82	Rhône-Alpes	42	1	06	102	Grammond	860	17	877
82	Rhône-Alpes	42	3	33	103	La Grand-Croix	5070	71	5141
82	Rhône-Alpes	42	2	01	104	La Gresle	790	22	812
82	Rhône-Alpes	42	1	09	105	Grézieux-le-Fromental	121	5	126
82	Rhône-Alpes	42	2	26	106	Grézolles	279	5	284
82	Rhône-Alpes	42	1	29	107	Gumières	317	7	324
82	Rhône-Alpes	42	1	09	108	L; Hôpital-le-Grand	952	22	974
82	Rhône-Alpes	42	1	02	109	L; Hôpital-sous-Rochefort	118	3	121
82	Rhône-Alpes	42	3	33	110	L; Horme	4750	68	4818
82	Rhône-Alpes	42	2	05	112	Jarnosse	414	7	421
82	Rhône-Alpes	42	1	07	113	Jas	220	8	228
82	Rhône-Alpes	42	1	25	114	Jeansagnière	83	2	85
82	Rhône-Alpes	42	3	24	115	Jonzieux	1217	16	1233
82	Rhône-Alpes	42	2	30	116	Juré	244	5	249
82	Rhône-Alpes	42	1	29	117	Lavieu	95	2	97
82	Rhône-Alpes	42	2	32	118	Lay	710	24	734
82	Rhône-Alpes	42	1	02	119	Leigneux	391	14	405
82	Rhône-Alpes	42	2	34	120	Lentigny	1587	48	1635
82	Rhône-Alpes	42	1	09	121	Lérigneux	155	1	156
82	Rhône-Alpes	42	1	09	122	Lézigneux	1656	56	1712
82	Rhône-Alpes	42	3	33	123	Lorette	4498	62	4560
82	Rhône-Alpes	42	3	13	124	Lupé	316	17	333
82	Rhône-Alpes	42	2	26	125	Luré	142	1	143
82	Rhône-Alpes	42	1	29	126	Luriecq	1190	24	1214
82	Rhône-Alpes	42	2	16	127	Mably	7551	175	7726
82	Rhône-Alpes	42	2	32	128	Machézal	419	15	434
82	Rhône-Alpes	42	3	13	129	Maclas	1685	30	1715
82	Rhône-Alpes	42	1	09	130	Magneux-Haute-Rive	481	11	492
82	Rhône-Alpes	42	2	05	131	Maizilly	341	6	347
82	Rhône-Alpes	42	3	13	132	Malleval	552	19	571
82	Rhône-Alpes	42	3	28	133	Marcenod	650	6	656
82	Rhône-Alpes	42	1	02	134	Marcilly-le-Châtel	1272	30	1302
82	Rhône-Alpes	42	1	07	135	Marclopt	494	12	506
82	Rhône-Alpes	42	1	02	136	Marcoux	728	17	745
82	Rhône-Alpes	42	1	29	137	Margerie-Chantagret	699	4	703
82	Rhône-Alpes	42	1	06	138	Maringes	640	28	668
82	Rhône-Alpes	42	3	24	139	Marlhes	1393	77	1470
82	Rhône-Alpes	42	1	29	140	Marols	398	6	404
82	Rhône-Alpes	42	2	05	141	Mars	552	23	575
82	Rhône-Alpes	42	1	17	142	Merle-Leignec	306	11	317
82	Rhône-Alpes	42	1	07	143	Mizérieux	398	15	413
82	Rhône-Alpes	42	2	14	145	Montagny	1163	26	1189
82	Rhône-Alpes	42	1	29	146	Montarcher	63	1	64
82	Rhône-Alpes	42	1	09	147	Montbrison	15299	600	15899
82	Rhône-Alpes	42	1	07	148	Montchal	443	11	454
82	Rhône-Alpes	42	1	23	149	Montrond-les-Bains	4785	105	4890
82	Rhône-Alpes	42	1	02	150	Montverdun	1117	19	1136
82	Rhône-Alpes	42	1	09	151	Mornand-en-Forez	422	69	491
82	Rhône-Alpes	42	2	05	152	Nandax	529	290	819
82	Rhône-Alpes	42	2	32	153	Neaux	520	6	526
82	Rhône-Alpes	42	2	10	154	Néronde	472	91	563
82	Rhône-Alpes	42	1	07	155	Nervieux	906	11	917
82	Rhône-Alpes	42	2	32	156	Neulise	1269	22	1291
82	Rhône-Alpes	42	2	27	157	Noailly	776	22	798
82	Rhône-Alpes	42	2	27	158	Les Noës	186	7	193
82	Rhône-Alpes	42	1	11	159	Noirétable	1666	94	1760
82	Rhône-Alpes	42	2	26	160	Nollieux	156	7	163
82	Rhône-Alpes	42	2	14	161	Notre-Dame-de-Boisset	544	21	565
82	Rhône-Alpes	42	2	34	162	Ouches	1116	33	1149
82	Rhône-Alpes	42	2	12	163	La Pacaudière	1066	28	1094
82	Rhône-Alpes	42	1	25	164	Palogneux	73	2	75
82	Rhône-Alpes	42	1	07	165	Panissières	2972	92	3064
82	Rhône-Alpes	42	2	14	166	Parigny	624	17	641
82	Rhône-Alpes	42	3	15	167	Pavezin	339	7	346
82	Rhône-Alpes	42	3	13	168	Pélussin	3515	80	3595
82	Rhône-Alpes	42	1	31	169	Périgneux	1370	29	1399
82	Rhône-Alpes	42	2	14	170	Perreux	2169	191	2360
82	Rhône-Alpes	42	2	10	171	Pinay	278	9	287
82	Rhône-Alpes	42	3	24	172	Planfoy	909	30	939
82	Rhône-Alpes	42	2	26	173	Pommiers	374	10	384
82	Rhône-Alpes	42	1	07	174	Poncins	897	13	910
82	Rhône-Alpes	42	1	07	175	Pouilly-lès-Feurs	1181	33	1214
82	Rhône-Alpes	42	2	34	176	Pouilly-les-Nonains	1824	73	1897
82	Rhône-Alpes	42	2	05	177	Pouilly-sous-Charlieu	2544	60	2604
82	Rhône-Alpes	42	2	32	178	Pradines	679	14	693
82	Rhône-Alpes	42	1	02	179	Pralong	850	19	869
82	Rhône-Alpes	42	1	09	180	Précieux	1047	117	1164
82	Rhône-Alpes	42	2	32	181	Régny	1581	25	1606
82	Rhône-Alpes	42	2	27	182	Renaison	2866	110	2976
82	Rhône-Alpes	42	3	04	183	La Ricamarie	7976	65	8041
82	Rhône-Alpes	42	2	34	184	Riorges	10714	308	11022
82	Rhône-Alpes	42	1	23	185	Rivas	524	4	528
82	Rhône-Alpes	42	3	15	186	Rive-de-Gier	14996	157	15153
82	Rhône-Alpes	42	2	98	187	Roanne	36806	1419	38225
82	Rhône-Alpes	42	1	09	188	Roche	268	0	268
82	Rhône-Alpes	42	3	22	189	Roche-la-Molière	10359	163	10522
82	Rhône-Alpes	42	3	13	191	Roisey	881	8	889
82	Rhône-Alpes	42	1	17	192	Rozier-Côtes-d;Aurec	445	9	454
82	Rhône-Alpes	42	1	07	193	Rozier-en-Donzy	1362	30	1392
82	Rhône-Alpes	42	2	12	194	Sail-les-Bains	209	4	213
82	Rhône-Alpes	42	1	25	195	Sail-sous-Couzan	951	7	958
82	Rhône-Alpes	42	2	27	198	Saint-Alban-les-Eaux	920	35	955
82	Rhône-Alpes	42	2	27	199	Saint-André-d;Apchon	1909	57	1966
82	Rhône-Alpes	42	1	23	200	Saint-André-le-Puy	1265	21	1286
82	Rhône-Alpes	42	3	13	201	Saint-Appolinard	609	15	624
82	Rhône-Alpes	42	1	07	202	Saint-Barthélemy-Lestra	684	27	711
82	Rhône-Alpes	42	2	12	203	Saint-Bonnet-des-Quarts	361	5	366
82	Rhône-Alpes	42	1	17	204	Saint-Bonnet-le-Château	1562	51	1613
82	Rhône-Alpes	42	1	25	205	Saint-Bonnet-le-Courreau	733	19	752
82	Rhône-Alpes	42	1	23	206	Saint-Bonnet-les-Oules	1516	47	1563
82	Rhône-Alpes	42	3	97	207	Saint-Chamond	35793	604	36397
82	Rhône-Alpes	42	3	28	208	Saint-Christo-en-Jarez	1822	33	1855
82	Rhône-Alpes	42	1	31	211	Saint-Cyprien	2313	47	2360
82	Rhône-Alpes	42	2	32	212	Saint-Cyr-de-Favières	805	32	837
82	Rhône-Alpes	42	2	10	213	Saint-Cyr-de-Valorges	352	4	356
82	Rhône-Alpes	42	1	07	214	Saint-Cyr-les-Vignes	926	34	960
82	Rhône-Alpes	42	2	05	215	Saint-Denis-de-Cabanne	1300	31	1331
82	Rhône-Alpes	42	1	06	216	Saint-Denis-sur-Coise	586	15	601
82	Rhône-Alpes	42	1	11	217	Saint-Didier-sur-Rochefort	415	11	426
82	Rhône-Alpes	42	3	99	218	Saint-Étienne	171260	3306	174566
82	Rhône-Alpes	42	1	02	219	Saint-Étienne-le-Molard	969	26	995
82	Rhône-Alpes	42	2	12	220	Saint-Forgeux-Lespinasse	538	13	551
82	Rhône-Alpes	42	1	23	222	Saint-Galmier	5588	213	5801
82	Rhône-Alpes	42	3	22	223	Saint-Genest-Lerpt	5683	143	5826
82	Rhône-Alpes	42	3	24	224	Saint-Genest-Malifaux	2931	111	3042
82	Rhône-Alpes	42	2	26	226	Saint-Georges-de-Baroille	328	7	335
82	Rhône-Alpes	42	1	25	227	Saint-Georges-en-Couzan	406	15	421
82	Rhône-Alpes	42	1	29	228	Saint-Georges-Haute-Ville	1272	27	1299
82	Rhône-Alpes	42	2	01	229	Saint-Germain-la-Montagne	233	5	238
82	Rhône-Alpes	42	2	26	230	Saint-Germain-Laval	1672	24	1696
82	Rhône-Alpes	42	2	27	231	Saint-Germain-Lespinasse	1161	54	1215
82	Rhône-Alpes	42	2	27	232	Saint-Haon-le-Châtel	596	31	627
82	Rhône-Alpes	42	2	27	233	Saint-Haon-le-Vieux	907	35	942
82	Rhône-Alpes	42	3	28	234	Saint-Héand	3561	85	3646
82	Rhône-Alpes	42	1	17	235	Saint-Hilaire-Cusson-la-Valmitte	324	4	328
82	Rhône-Alpes	42	2	05	236	Saint-Hilaire-sous-Charlieu	563	29	592
82	Rhône-Alpes	42	3	20	237	Saint-Jean-Bonnefonds	6316	79	6395
82	Rhône-Alpes	42	1	11	238	Saint-Jean-la-Vêtre	344	12	356
82	Rhône-Alpes	42	2	34	239	Saint-Jean-Saint-Maurice-sur-Loire	1124	26	1150
82	Rhône-Alpes	42	1	29	240	Saint-Jean-Soleymieux	850	16	866
82	Rhône-Alpes	42	2	10	241	Saint-Jodard	555	18	573
82	Rhône-Alpes	42	3	15	242	Saint-Joseph	1908	39	1947
82	Rhône-Alpes	42	2	26	243	Saint-Julien-d;Oddes	270	9	279
82	Rhône-Alpes	42	1	11	245	Saint-Julien-la-Vêtre	376	8	384
82	Rhône-Alpes	42	3	03	246	Saint-Julien-Molin-Molette	1243	15	1258
82	Rhône-Alpes	42	1	25	247	Saint-Just-en-Bas	304	7	311
82	Rhône-Alpes	42	2	30	248	Saint-Just-en-Chevalet	1182	64	1246
82	Rhône-Alpes	42	2	32	249	Saint-Just-la-Pendue	1569	16	1585
82	Rhône-Alpes	42	1	31	279	Saint-Just-Saint-Rambert	14172	253	14425
82	Rhône-Alpes	42	1	07	251	Saint-Laurent-la-Conche	594	7	601
82	Rhône-Alpes	42	1	02	252	Saint-Laurent-Rochefort	252	4	256
82	Rhône-Alpes	42	2	34	253	Saint-Léger-sur-Roanne	1148	73	1221
82	Rhône-Alpes	42	2	30	255	Saint-Marcel-d;Urfé	283	4	287
82	Rhône-Alpes	42	2	10	254	Saint-Marcel-de-Félines	779	14	793
82	Rhône-Alpes	42	1	31	256	Saint-Marcellin-en-Forez	4213	78	4291
82	Rhône-Alpes	42	2	12	257	Saint-Martin-d;Estréaux	897	13	910
82	Rhône-Alpes	42	3	15	259	Saint-Martin-la-Plaine	3686	81	3767
82	Rhône-Alpes	42	2	26	260	Saint-Martin-la-Sauveté	974	54	1028
82	Rhône-Alpes	42	1	07	261	Saint-Martin-Lestra	910	7	917
82	Rhône-Alpes	42	1	17	262	Saint-Maurice-en-Gourgois	1728	22	1750
82	Rhône-Alpes	42	1	06	264	Saint-Médard-en-Forez	935	34	969
82	Rhône-Alpes	42	3	13	265	Saint-Michel-sur-Rhône	778	15	793
82	Rhône-Alpes	42	1	17	266	Saint-Nizier-de-Fornas	642	10	652
82	Rhône-Alpes	42	2	05	267	Saint-Nizier-sous-Charlieu	1661	47	1708
82	Rhône-Alpes	42	1	09	269	Saint-Paul-d;Uzore	138	7	145
82	Rhône-Alpes	42	2	26	268	Saint-Paul-de-Vézelin	306	5	311
82	Rhône-Alpes	42	3	08	270	Saint-Paul-en-Cornillon	1321	73	1394
82	Rhône-Alpes	42	3	33	271	Saint-Paul-en-Jarez	4103	143	4246
82	Rhône-Alpes	42	3	13	272	Saint-Pierre-de-Boeuf	1621	29	1650
82	Rhône-Alpes	42	2	05	273	Saint-Pierre-la-Noaille	368	6	374
82	Rhône-Alpes	42	2	26	274	Saint-Polgues	240	13	253
82	Rhône-Alpes	42	3	20	275	Saint-Priest-en-Jarez	6177	128	6305
82	Rhône-Alpes	42	2	30	276	Saint-Priest-la-Prugne	459	19	478
82	Rhône-Alpes	42	2	32	277	Saint-Priest-la-Roche	302	5	307
82	Rhône-Alpes	42	1	11	278	Saint-Priest-la-Vêtre	134	3	137
82	Rhône-Alpes	42	3	24	280	Saint-Régis-du-Coin	374	9	383
82	Rhône-Alpes	42	2	27	281	Saint-Rirand	158	2	160
82	Rhône-Alpes	42	2	30	282	Saint-Romain-d;Urfé	284	7	291
82	Rhône-Alpes	42	3	15	283	Saint-Romain-en-Jarez	1168	14	1182
82	Rhône-Alpes	42	2	27	284	Saint-Romain-la-Motte	1554	51	1605
82	Rhône-Alpes	42	1	31	285	Saint-Romain-le-Puy	3607	49	3656
82	Rhône-Alpes	42	3	24	286	Saint-Romain-les-Atheux	924	17	941
82	Rhône-Alpes	42	3	03	287	Saint-Sauveur-en-Rue	1124	14	1138
82	Rhône-Alpes	42	1	02	288	Saint-Sixte	695	3	698
82	Rhône-Alpes	42	2	32	289	Saint-Symphorien-de-Lay	1800	35	1835
82	Rhône-Alpes	42	1	09	290	Saint-Thomas-la-Garde	585	11	596
82	Rhône-Alpes	42	1	11	291	Saint-Thurin	194	19	213
82	Rhône-Alpes	42	2	32	293	Saint-Victor-sur-Rhins	1126	18	1144
82	Rhône-Alpes	42	2	14	294	Saint-Vincent-de-Boisset	884	31	915
82	Rhône-Alpes	42	2	10	196	Sainte-Agathe-en-Donzy	111	1	112
82	Rhône-Alpes	42	1	02	197	Sainte-Agathe-la-Bouteresse	1116	21	1137
82	Rhône-Alpes	42	2	10	209	Sainte-Colombe-sur-Gand	410	3	413
82	Rhône-Alpes	42	3	15	210	Sainte-Croix-en-Jarez	435	13	448
82	Rhône-Alpes	42	1	02	221	Sainte-Foy-Saint-Sulpice	483	9	492
82	Rhône-Alpes	42	1	11	295	Les Salles	479	13	492
82	Rhône-Alpes	42	1	07	296	Salt-en-Donzy	535	22	557
82	Rhône-Alpes	42	1	07	297	Salvizinet	599	29	628
82	Rhône-Alpes	42	1	25	298	Sauvain	401	18	419
82	Rhône-Alpes	42	1	09	299	Savigneux	3186	57	3243
82	Rhône-Alpes	42	2	01	300	Sevelinges	651	17	668
82	Rhône-Alpes	42	1	29	301	Soleymieux	644	17	661
82	Rhône-Alpes	42	3	28	302	Sorbiers	7717	160	7877
82	Rhône-Alpes	42	2	26	303	Souternon	326	2	328
82	Rhône-Alpes	42	1	31	304	Sury-le-Comtal	5605	219	5824
82	Rhône-Alpes	42	3	28	305	La Talaudière	6459	136	6595
82	Rhône-Alpes	42	3	24	306	Tarentaise	450	13	463
82	Rhône-Alpes	42	3	15	307	Tartaras	767	43	810
82	Rhône-Alpes	42	3	33	308	La Terrasse-sur-Dorlay	765	12	777
82	Rhône-Alpes	42	3	03	310	Thélis-la-Combe	175	3	178
82	Rhône-Alpes	42	3	28	311	La Tour-en-Jarez	1327	41	1368
82	Rhône-Alpes	42	1	17	312	La Tourette	566	13	579
82	Rhône-Alpes	42	1	02	313	Trelins	616	11	627
82	Rhône-Alpes	42	2	30	314	La Tuilière	287	3	290
82	Rhône-Alpes	42	1	31	315	Unias	373	9	382
82	Rhône-Alpes	42	3	08	316	Unieux	8643	116	8759
82	Rhône-Alpes	42	2	12	317	Urbise	137	1	138
82	Rhône-Alpes	42	1	17	318	Usson-en-Forez	1466	26	1492
82	Rhône-Alpes	42	1	07	319	Valeille	665	22	687
82	Rhône-Alpes	42	3	33	320	Valfleury	664	11	675
82	Rhône-Alpes	42	3	18	322	La Valla-en-Gier	939	40	979
82	Rhône-Alpes	42	1	11	321	La Valla-sur-Rochefort	137	3	140
82	Rhône-Alpes	42	1	23	323	Veauche	8507	152	8659
82	Rhône-Alpes	42	1	31	324	Veauchette	921	15	936
82	Rhône-Alpes	42	2	32	325	Vendranges	325	6	331
82	Rhône-Alpes	42	3	13	326	Véranne	808	13	821
82	Rhône-Alpes	42	3	13	327	Vérin	692	12	704
82	Rhône-Alpes	42	1	09	328	Verrières-en-Forez	632	104	736
82	Rhône-Alpes	42	3	03	329	La Versanne	355	9	364
82	Rhône-Alpes	42	3	21	330	Villars	7831	216	8047
82	Rhône-Alpes	42	2	34	331	Villemontais	981	24	1005
82	Rhône-Alpes	42	2	34	332	Villerest	4641	200	4841
82	Rhône-Alpes	42	2	05	333	Villers	575	6	581
82	Rhône-Alpes	42	2	10	334	Violay	1338	37	1375
82	Rhône-Alpes	42	1	06	335	Viricelles	432	8	440
82	Rhône-Alpes	42	1	06	336	Virigneux	588	20	608
82	Rhône-Alpes	42	2	12	337	Vivans	247	4	251
82	Rhône-Alpes	42	2	05	338	Vougy	1408	72	1480
83	Auvergne	43	1	02	001	Agnat	190	11	201
83	Auvergne	43	2	19	002	Aiguilhe	1585	75	1660
83	Auvergne	43	2	01	003	Allègre	987	23	1010
83	Auvergne	43	2	13	004	Alleyrac	123	12	135
83	Auvergne	43	2	98	005	Alleyras	173	6	179
83	Auvergne	43	1	11	006	Ally	163	5	168
83	Auvergne	43	3	29	007	Araules	623	23	646
83	Auvergne	43	2	18	008	Arlempdes	132	4	136
83	Auvergne	43	1	11	009	Arlet	23	1	24
83	Auvergne	43	2	20	010	Arsac-en-Velay	1179	18	1197
83	Auvergne	43	1	11	011	Aubazat	188	7	195
83	Auvergne	43	3	30	012	Aurec-sur-Loire	5614	107	5721
83	Auvergne	43	1	04	014	Autrac	78	1	79
83	Auvergne	43	1	17	015	Auvers	62	0	62
83	Auvergne	43	1	02	016	Auzon	925	21	946
83	Auvergne	43	1	02	017	Azérat	265	9	274
83	Auvergne	43	2	26	018	Bains	1270	94	1364
83	Auvergne	43	2	18	019	Barges	70	2	72
83	Auvergne	43	3	03	020	Bas-en-Basset	4126	83	4209
83	Auvergne	43	2	28	021	Beaulieu	923	18	941
83	Auvergne	43	1	05	022	Beaumont	269	11	280
83	Auvergne	43	2	08	023	Beaune-sur-Arzon	209	9	218
83	Auvergne	43	3	29	024	Beaux	794	15	809
83	Auvergne	43	3	14	025	Beauzac	2762	60	2822
83	Auvergne	43	2	01	026	Bellevue-la-Montagne	468	10	478
83	Auvergne	43	1	07	027	Berbezit	59	3	62
83	Auvergne	43	3	29	028	Bessamorel	409	10	419
83	Auvergne	43	1	17	029	La Besseyre-Saint-Mary	134	5	139
83	Auvergne	43	2	24	030	Blanzac	311	11	322
83	Auvergne	43	1	11	031	Blassac	152	4	156
83	Auvergne	43	2	31	032	Blavozy	1592	40	1632
83	Auvergne	43	1	04	033	Blesle	634	21	655
83	Auvergne	43	3	03	034	Boisset	285	8	293
83	Auvergne	43	1	07	035	Bonneval	86	1	87
83	Auvergne	43	2	24	036	Borne	425	10	435
83	Auvergne	43	2	06	037	Le Bouchet-Saint-Nicolas	241	12	253
83	Auvergne	43	1	05	038	Bournoncle-Saint-Pierre	1008	23	1031
83	Auvergne	43	2	26	039	Le Brignon	595	10	605
83	Auvergne	43	1	97	040	Brioude	6664	368	7032
83	Auvergne	43	2	31	041	Brives-Charensac	4231	215	4446
83	Auvergne	43	2	06	042	Cayres	708	13	721
83	Auvergne	43	2	01	043	Céaux-d;Allègre	462	10	472
83	Auvergne	43	1	11	044	Cerzat	194	5	199
83	Auvergne	43	2	32	045	Ceyssac	398	20	418
83	Auvergne	43	2	19	046	Chadrac	2671	84	2755
83	Auvergne	43	2	13	047	Chadron	258	11	269
83	Auvergne	43	1	07	048	La Chaise-Dieu	722	72	794
83	Auvergne	43	2	28	049	Chamalières-sur-Loire	465	11	476
83	Auvergne	43	1	04	050	Chambezon	88	3	91
83	Auvergne	43	3	27	051	Le Chambon-sur-Lignon	2672	177	2849
83	Auvergne	43	1	02	052	Champagnac-le-Vieux	232	10	242
83	Auvergne	43	2	09	053	Champclause	207	4	211
83	Auvergne	43	1	25	054	Chanaleilles	207	7	214
83	Auvergne	43	1	34	055	Chaniat	166	7	173
83	Auvergne	43	1	10	056	Chanteuges	424	6	430
83	Auvergne	43	2	01	057	La Chapelle-Bertin	58	1	59
83	Auvergne	43	3	14	058	La Chapelle-d;Aurec	902	15	917
83	Auvergne	43	1	07	059	La Chapelle-Geneste	139	1	140
83	Auvergne	43	1	10	060	Charraix	95	3	98
83	Auvergne	43	2	19	061	Chaspinhac	725	21	746
83	Auvergne	43	2	12	062	Chaspuzac	687	18	705
83	Auvergne	43	1	16	063	Chassagnes	178	12	190
83	Auvergne	43	1	02	064	Chassignolles	80	2	82
83	Auvergne	43	1	17	065	Chastel	145	5	150
83	Auvergne	43	2	09	066	Chaudeyrolles	102	0	102
83	Auvergne	43	1	16	067	Chavaniac-Lafayette	280	16	296
83	Auvergne	43	1	17	068	Chazelles	34	3	37
83	Auvergne	43	3	27	069	Chenereilles	301	8	309
83	Auvergne	43	1	11	070	Chilhac	197	11	208
83	Auvergne	43	2	08	071	Chomelix	488	11	499
83	Auvergne	43	1	16	072	La Chomette	140	1	141
83	Auvergne	43	1	07	073	Cistrières	136	6	142
83	Auvergne	43	1	05	074	Cohade	823	33	856
83	Auvergne	43	1	16	075	Collat	85	2	87
83	Auvergne	43	1	07	076	Connangles	137	2	139
83	Auvergne	43	2	06	077	Costaros	620	11	631
83	Auvergne	43	2	20	078	Coubon	3063	107	3170
83	Auvergne	43	1	16	079	Couteuges	302	3	305
83	Auvergne	43	2	08	080	Craponne-sur-Arzon	2164	36	2200
83	Auvergne	43	1	25	081	Croisances	35	0	35
83	Auvergne	43	1	17	082	Cronce	81	3	84
83	Auvergne	43	1	25	083	Cubelles	136	7	143
83	Auvergne	43	2	26	084	Cussac-sur-Loire	1688	48	1736
83	Auvergne	43	1	17	085	Desges	63	4	67
83	Auvergne	43	1	16	086	Domeyrat	192	8	200
83	Auvergne	43	3	15	087	Dunières	2934	70	3004
83	Auvergne	43	1	04	088	Espalem	287	7	294
83	Auvergne	43	2	32	089	Espaly-Saint-Marcel	3548	169	3717
83	Auvergne	43	1	25	090	Esplantas	101	1	102
83	Auvergne	43	2	09	091	Les Estables	344	9	353
83	Auvergne	43	2	09	092	Fay-sur-Lignon	419	9	428
83	Auvergne	43	1	07	093	Félines	283	6	289
83	Auvergne	43	1	17	094	Ferrussac	85	5	90
83	Auvergne	43	2	01	095	Fix-Saint-Geneys	139	8	147
83	Auvergne	43	1	34	096	Fontannes	1058	190	1248
83	Auvergne	43	2	13	097	Freycenet-la-Cuche	137	6	143
83	Auvergne	43	2	13	098	Freycenet-la-Tour	129	8	137
83	Auvergne	43	1	02	099	Frugerès-les-Mines	510	6	516
83	Auvergne	43	1	16	100	Frugières-le-Pin	135	8	143
83	Auvergne	43	2	13	101	Goudet	61	3	64
83	Auvergne	43	3	29	102	Grazac	1000	10	1010
83	Auvergne	43	1	04	103	Grenier-Montgon	118	1	119
83	Auvergne	43	1	25	104	Grèzes	213	6	219
83	Auvergne	43	1	34	105	Javaugues	197	4	201
83	Auvergne	43	1	16	106	Jax	134	3	137
83	Auvergne	43	1	16	107	Josat	91	3	94
83	Auvergne	43	2	08	108	Jullianges	439	13	452
83	Auvergne	43	2	18	109	Lafarre	63	2	65
83	Auvergne	43	1	05	110	Lamothe	824	32	856
83	Auvergne	43	2	18	111	Landos	932	21	953
83	Auvergne	43	1	10	112	Langeac	3978	114	4092
83	Auvergne	43	2	23	113	Lantriac	1860	64	1924
83	Auvergne	43	3	29	114	Lapte	1502	30	1532
83	Auvergne	43	2	13	115	Laussonne	1007	19	1026
83	Auvergne	43	1	07	116	Laval-sur-Doulon	62	1	63
83	Auvergne	43	1	34	117	Lavaudieu	224	7	231
83	Auvergne	43	1	11	118	Lavoûte-Chilhac	308	8	316
83	Auvergne	43	2	24	119	Lavoûte-sur-Loire	760	15	775
83	Auvergne	43	1	02	120	Lempdes-sur-Allagnon	1323	25	1348
83	Auvergne	43	1	04	121	Léotoing	207	5	212
83	Auvergne	43	2	24	122	Lissac	260	7	267
83	Auvergne	43	1	04	123	Lorlanges	326	2	328
83	Auvergne	43	2	12	124	Loudes	870	22	892
83	Auvergne	43	1	04	125	Lubilhac	107	4	111
83	Auvergne	43	2	19	126	Malrevers	720	20	740
83	Auvergne	43	3	03	127	Malvalette	732	6	738
83	Auvergne	43	1	07	128	Malvières	134	2	136
83	Auvergne	43	3	27	129	Le Mas-de-Tence	175	4	179
83	Auvergne	43	1	16	131	Mazerat-Aurouze	200	5	205
83	Auvergne	43	3	27	130	Mazet-Saint-Voy	1150	37	1187
83	Auvergne	43	1	10	132	Mazeyrat-d;Allier	1546	42	1588
83	Auvergne	43	1	11	133	Mercoeur	136	6	142
83	Auvergne	43	2	28	134	Mézères	158	3	161
83	Auvergne	43	2	13	135	Le Monastier-sur-Gazeille	1767	35	1802
83	Auvergne	43	1	25	136	Monistrol-d;Allier	219	13	232
83	Auvergne	43	3	14	137	Monistrol-sur-Loire	8717	473	9190
83	Auvergne	43	2	01	138	Monlet	416	16	432
83	Auvergne	43	1	16	139	Montclard	62	4	66
83	Auvergne	43	2	19	140	Le Monteil	604	14	618
83	Auvergne	43	3	15	141	Montfaucon-en-Velay	1277	67	1344
83	Auvergne	43	3	15	142	Montregard	607	6	613
83	Auvergne	43	2	23	143	Montusclat	130	3	133
83	Auvergne	43	2	13	144	Moudeyres	107	6	113
83	Auvergne	43	2	06	145	Ouides	55	1	56
83	Auvergne	43	1	05	147	Paulhac	656	29	685
83	Auvergne	43	1	16	148	Paulhaguet	940	19	959
83	Auvergne	43	1	10	149	Pébrac	124	1	125
83	Auvergne	43	2	23	150	Le Pertuis	423	7	430
83	Auvergne	43	1	17	151	Pinols	227	8	235
83	Auvergne	43	2	19	152	Polignac	2809	104	2913
83	Auvergne	43	3	22	153	Pont-Salomon	1870	23	1893
83	Auvergne	43	2	18	154	Pradelles	613	24	637
83	Auvergne	43	1	10	155	Prades	62	2	64
83	Auvergne	43	2	13	156	Présailles	152	6	158
83	Auvergne	43	2	99	157	Le Puy-en-Velay	18521	1144	19665
83	Auvergne	43	2	23	158	Queyrières	310	14	324
83	Auvergne	43	3	15	159	Raucoules	891	32	923
83	Auvergne	43	2	18	160	Rauret	178	4	182
83	Auvergne	43	3	21	162	Retournac	2714	39	2753
83	Auvergne	43	3	15	163	Riotord	1197	24	1221
83	Auvergne	43	2	28	164	Roche-en-Régnier	491	10	501
83	Auvergne	43	2	28	165	Rosières	1431	15	1446
83	Auvergne	43	3	21	166	Saint-André-de-Chalencon	340	10	350
83	Auvergne	43	1	10	167	Saint-Arcons-d;Allier	194	10	204
83	Auvergne	43	2	18	168	Saint-Arcons-de-Barges	115	4	119
83	Auvergne	43	1	11	169	Saint-Austremoine	50	6	56
83	Auvergne	43	1	05	170	Saint-Beauzire	332	11	343
83	Auvergne	43	1	10	171	Saint-Bérain	96	2	98
83	Auvergne	43	3	15	172	Saint-Bonnet-le-Froid	231	8	239
83	Auvergne	43	1	25	173	Saint-Christophe-d;Allier	105	5	110
83	Auvergne	43	2	26	174	Saint-Christophe-sur-Dolaison	954	16	970
83	Auvergne	43	1	11	175	Saint-Cirgues	161	8	169
83	Auvergne	43	2	06	176	Saint-Didier-d;Allier	34	2	36
83	Auvergne	43	3	22	177	Saint-Didier-en-Velay	3367	64	3431
83	Auvergne	43	1	16	178	Saint-Didier-sur-Doulon	211	16	227
83	Auvergne	43	2	18	180	Saint-Étienne-du-Vigan	112	3	115
83	Auvergne	43	2	23	181	Saint-Étienne-Lardeyrol	695	22	717
83	Auvergne	43	1	04	182	Saint-Étienne-sur-Blesle	51	1	52
83	Auvergne	43	3	22	184	Saint-Ferréol-d;Auroure	2390	42	2432
83	Auvergne	43	2	09	186	Saint-Front	458	9	467
83	Auvergne	43	2	24	187	Saint-Geneys-près-Saint-Paulien	303	15	318
83	Auvergne	43	1	16	188	Saint-Georges-d;Aurac	452	21	473
83	Auvergne	43	2	08	189	Saint-Georges-Lagricol	498	10	508
83	Auvergne	43	2	31	190	Saint-Germain-Laprade	3413	115	3528
83	Auvergne	43	1	05	191	Saint-Géron	233	3	236
83	Auvergne	43	2	18	192	Saint-Haon	347	9	356
83	Auvergne	43	1	02	193	Saint-Hilaire	183	6	189
83	Auvergne	43	2	23	194	Saint-Hostien	684	20	704
83	Auvergne	43	1	11	195	Saint-Ilpize	176	11	187
83	Auvergne	43	2	08	196	Saint-Jean-d;Aubrigoux	187	3	190
83	Auvergne	43	2	12	197	Saint-Jean-de-Nay	384	6	390
83	Auvergne	43	2	06	198	Saint-Jean-Lachalm	285	8	293
83	Auvergne	43	3	27	199	Saint-Jeures	910	3	913
83	Auvergne	43	2	23	200	Saint-Julien-Chapteuil	1870	63	1933
83	Auvergne	43	2	08	201	Saint-Julien-d;Ance	238	4	242
83	Auvergne	43	1	10	202	Saint-Julien-des-Chazes	75	2	77
83	Auvergne	43	3	29	203	Saint-Julien-du-Pinet	452	10	462
83	Auvergne	43	3	15	204	Saint-Julien-Molhesabate	206	2	208
83	Auvergne	43	3	22	205	Saint-Just-Malmont	4126	70	4196
83	Auvergne	43	1	34	206	Saint-Just-près-Brioude	425	15	440
83	Auvergne	43	1	05	207	Saint-Laurent-Chabreuges	233	15	248
83	Auvergne	43	2	13	210	Saint-Martin-de-Fugères	204	4	208
83	Auvergne	43	3	14	211	Saint-Maurice-de-Lignon	2402	60	2462
83	Auvergne	43	3	03	212	Saint-Pal-de-Chalencon	1018	30	1048
83	Auvergne	43	3	35	213	Saint-Pal-de-Mons	2069	52	2121
83	Auvergne	43	1	07	214	Saint-Pal-de-Senouire	101	3	104
83	Auvergne	43	2	18	215	Saint-Paul-de-Tartas	192	8	200
83	Auvergne	43	2	24	216	Saint-Paulien	2406	47	2453
83	Auvergne	43	2	28	217	Saint-Pierre-du-Champ	489	15	504
83	Auvergne	43	2	23	218	Saint-Pierre-Eynac	1030	38	1068
83	Auvergne	43	1	16	219	Saint-Préjet-Armandon	107	7	114
83	Auvergne	43	1	25	220	Saint-Préjet-d;Allier	171	9	180
83	Auvergne	43	2	12	221	Saint-Privat-d;Allier	401	4	405
83	Auvergne	43	1	11	222	Saint-Privat-du-Dragon	164	6	170
83	Auvergne	43	3	22	223	Saint-Romain-Lachalm	1074	28	1102
83	Auvergne	43	1	25	225	Saint-Vénérand	55	1	56
83	Auvergne	43	1	02	226	Saint-Vert	109	1	110
83	Auvergne	43	3	22	227	Saint-Victor-Malescours	790	17	807
83	Auvergne	43	2	08	228	Saint-Victor-sur-Arlanc	106	1	107
83	Auvergne	43	2	12	229	Saint-Vidal	521	23	544
83	Auvergne	43	2	24	230	Saint-Vincent	978	16	994
83	Auvergne	43	1	16	183	Sainte-Eugénie-de-Villeneuve	93	1	94
83	Auvergne	43	1	02	185	Sainte-Florine	3145	102	3247
83	Auvergne	43	1	16	208	Sainte-Marguerite	37	1	38
83	Auvergne	43	3	35	224	Sainte-Sigolène	5913	133	6046
83	Auvergne	43	2	13	231	Salettes	148	4	152
83	Auvergne	43	1	16	232	Salzuit	361	10	371
83	Auvergne	43	2	12	233	Sanssac-l;Église	1049	28	1077
83	Auvergne	43	1	25	234	Saugues	1873	132	2005
83	Auvergne	43	3	22	236	La Séauve-sur-Semène	1414	30	1444
83	Auvergne	43	1	07	237	Sembadel	248	7	255
83	Auvergne	43	2	06	238	Séneujols	304	3	307
83	Auvergne	43	1	10	239	Siaugues-Sainte-Marie	798	17	815
83	Auvergne	43	3	21	240	Solignac-sous-Roche	216	11	227
83	Auvergne	43	2	26	241	Solignac-sur-Loire	1210	25	1235
83	Auvergne	43	1	17	242	Tailhac	81	5	86
83	Auvergne	43	3	27	244	Tence	3193	103	3296
83	Auvergne	43	1	25	245	Thoras	216	9	225
83	Auvergne	43	3	03	246	Tiranges	456	17	473
83	Auvergne	43	1	04	247	Torsiac	72	1	73
83	Auvergne	43	3	03	249	Valprivas	498	11	509
83	Auvergne	43	1	16	250	Vals-le-Chastel	46	3	49
83	Auvergne	43	2	33	251	Vals-près-le-Puy	3518	148	3666
83	Auvergne	43	2	01	252	Varennes-Saint-Honorat	34	1	35
83	Auvergne	43	2	09	253	Les Vastres	212	8	220
83	Auvergne	43	2	12	254	Vazeilles-Limandre	241	3	244
83	Auvergne	43	1	25	255	Vazeilles-près-Saugues	42	1	43
83	Auvergne	43	1	25	256	Venteuges	366	12	378
83	Auvergne	43	2	12	257	Vergezac	428	12	440
83	Auvergne	43	1	02	258	Vergongheon	1838	50	1888
83	Auvergne	43	2	01	259	Vernassal	393	9	402
83	Auvergne	43	2	12	260	Le Vernet	31	0	31
83	Auvergne	43	1	02	261	Vézézoux	517	6	523
83	Auvergne	43	1	34	262	Vieille-Brioude	1215	51	1266
83	Auvergne	43	2	18	263	Vielprat	63	0	63
83	Auvergne	43	1	11	264	Villeneuve-d;Allier	329	7	336
83	Auvergne	43	3	35	265	Les Villettes	1204	26	1230
83	Auvergne	43	1	10	013	Vissac-Auteyrac	336	5	341
83	Auvergne	43	2	28	267	Vorey	1423	20	1443
83	Auvergne	43	3	29	268	Yssingeaux	7009	444	7453
52	Pays de la Loire	44	1	28	001	Abbaretz	1916	37	1953
52	Pays de la Loire	44	2	01	002	Aigrefeuille-sur-Maine	3320	99	3419
52	Pays de la Loire	44	4	02	003	Ancenis	7551	313	7864
52	Pays de la Loire	44	4	02	004	Anetz	1910	37	1947
52	Pays de la Loire	44	3	32	005	Arthon-en-Retz	3761	53	3814
52	Pays de la Loire	44	3	14	006	Assérac	1789	38	1827
52	Pays de la Loire	44	1	40	007	Avessac	2437	52	2489
52	Pays de la Loire	44	2	17	008	Barbechat	1284	16	1300
52	Pays de la Loire	44	2	59	009	Basse-Goulaine	8091	247	8338
52	Pays de la Loire	44	3	10	010	Batz-sur-Mer	3071	90	3161
52	Pays de la Loire	44	3	57	055	La Baule-Escoublac	16040	583	16623
52	Pays de la Loire	44	4	45	011	Belligné	1765	48	1813
52	Pays de la Loire	44	3	05	012	La Bernerie-en-Retz	2564	53	2617
52	Pays de la Loire	44	3	31	013	Besné	2646	51	2697
52	Pays de la Loire	44	2	01	014	Le Bignon	3309	64	3373
52	Pays de la Loire	44	1	03	015	Blain	9434	184	9618
52	Pays de la Loire	44	2	17	016	La Boissière-du-Doré	913	13	926
52	Pays de la Loire	44	4	38	017	Bonnoeuvre	561	16	577
52	Pays de la Loire	44	2	04	018	Bouaye	5958	149	6107
52	Pays de la Loire	44	3	43	019	Bouée	860	19	879
52	Pays de la Loire	44	2	51	020	Bouguenais	18194	568	18762
52	Pays de la Loire	44	3	05	021	Bourgneuf-en-Retz	3408	48	3456
52	Pays de la Loire	44	2	09	022	Boussay	2684	64	2748
52	Pays de la Loire	44	1	03	023	Bouvron	2863	52	2915
52	Pays de la Loire	44	2	04	024	Brains	2584	63	2647
52	Pays de la Loire	44	3	43	025	Campbon	3805	155	3960
52	Pays de la Loire	44	2	06	026	Carquefou	17805	470	18275
52	Pays de la Loire	44	1	27	027	Casson	2089	39	2128
52	Pays de la Loire	44	4	16	028	Le Cellier	3713	77	3790
52	Pays de la Loire	44	2	17	029	La Chapelle-Basse-Mer	5195	65	5260
52	Pays de la Loire	44	3	14	030	La Chapelle-des-Marais	3772	65	3837
52	Pays de la Loire	44	1	37	031	La Chapelle-Glain	822	17	839
52	Pays de la Loire	44	2	44	032	La Chapelle-Heulin	3045	33	3078
52	Pays de la Loire	44	3	43	033	La Chapelle-Launay	2778	89	2867
52	Pays de la Loire	44	4	45	034	La Chapelle-Saint-Sauveur	780	16	796
52	Pays de la Loire	44	2	07	035	La Chapelle-sur-Erdre	17300	514	17814
52	Pays de la Loire	44	2	59	037	Château-Thébaud	2862	58	2920
52	Pays de la Loire	44	1	08	036	Châteaubriant	12022	608	12630
52	Pays de la Loire	44	3	41	038	Chauvé	2515	36	2551
52	Pays de la Loire	44	2	30	039	Cheix-en-Retz	844	13	857
52	Pays de la Loire	44	3	05	040	Chéméré	2259	31	2290
52	Pays de la Loire	44	1	28	221	La Chevallerais	1377	17	1394
52	Pays de la Loire	44	2	42	041	La Chevrolière	5017	92	5109
52	Pays de la Loire	44	2	09	043	Clisson	6732	319	7051
52	Pays de la Loire	44	1	12	044	Conquereuil	1046	33	1079
52	Pays de la Loire	44	2	15	156	Corcoué-sur-Logne	2553	52	2605
52	Pays de la Loire	44	2	35	045	Cordemais	2983	66	3049
52	Pays de la Loire	44	3	29	046	Corsept	2742	42	2784
52	Pays de la Loire	44	2	35	047	Couëron	18591	270	18861
52	Pays de la Loire	44	4	16	048	Couffé	2290	55	2345
52	Pays de la Loire	44	3	10	049	Le Croisic	4050	58	4108
52	Pays de la Loire	44	3	31	050	Crossac	2739	104	2843
52	Pays de la Loire	44	1	11	051	Derval	3246	375	3621
52	Pays de la Loire	44	3	47	052	Donges	6748	302	7050
52	Pays de la Loire	44	3	36	053	Drefféac	1843	46	1889
52	Pays de la Loire	44	1	37	054	Erbray	2940	104	3044
52	Pays de la Loire	44	1	03	056	Fay-de-Bretagne	3230	49	3279
52	Pays de la Loire	44	1	40	057	Fégréac	2278	45	2323
52	Pays de la Loire	44	1	34	058	Fercé	485	13	498
52	Pays de la Loire	44	3	05	059	Fresnay-en-Retz	1235	24	1259
52	Pays de la Loire	44	4	45	060	Le Fresne-sur-Loire	982	14	996
52	Pays de la Loire	44	3	41	061	Frossay	2977	40	3017
52	Pays de la Loire	44	1	03	062	Le Gâvre	1557	26	1583
52	Pays de la Loire	44	2	01	223	Geneston	3524	52	3576
52	Pays de la Loire	44	2	09	063	Gétigné	3397	79	3476
52	Pays de la Loire	44	2	09	064	Gorges	4189	167	4356
52	Pays de la Loire	44	1	19	065	Grand-Auverné	805	19	824
52	Pays de la Loire	44	2	07	066	Grandchamps-des-Fontaines	4837	79	4916
52	Pays de la Loire	44	1	28	224	La Grigonnais	1548	22	1570
52	Pays de la Loire	44	1	12	067	Guémené-Penfao	5035	121	5156
52	Pays de la Loire	44	3	36	068	Guenrouet	3007	48	3055
52	Pays de la Loire	44	3	13	069	Guérande	15534	729	16263
52	Pays de la Loire	44	2	59	070	La Haie-Fouassière	4358	98	4456
52	Pays de la Loire	44	2	59	071	Haute-Goulaine	5530	124	5654
52	Pays de la Loire	44	3	14	072	Herbignac	5817	142	5959
52	Pays de la Loire	44	1	27	073	Héric	5276	84	5360
52	Pays de la Loire	44	2	55	074	Indre	4006	46	4052
52	Pays de la Loire	44	1	19	075	Issé	1827	33	1860
52	Pays de la Loire	44	1	11	076	Jans	1098	18	1116
52	Pays de la Loire	44	4	33	077	Joué-sur-Erdre	2163	34	2197
52	Pays de la Loire	44	1	37	078	Juigné-des-Moutiers	353	6	359
52	Pays de la Loire	44	2	17	079	Le Landreau	2876	292	3168
52	Pays de la Loire	44	3	43	080	Lavau-sur-Loire	758	18	776
52	Pays de la Loire	44	2	15	081	Legé	4290	108	4398
52	Pays de la Loire	44	4	16	082	Ligné	4592	90	4682
52	Pays de la Loire	44	2	42	083	La Limouzinière	2139	36	2175
52	Pays de la Loire	44	2	17	084	Le Loroux-Bottereau	7052	103	7155
52	Pays de la Loire	44	1	19	085	Louisfert	898	26	924
52	Pays de la Loire	44	1	11	086	Lusanger	1019	31	1050
52	Pays de la Loire	44	2	18	087	Machecoul	5914	274	6188
52	Pays de la Loire	44	2	01	088	Maisdon-sur-Sèvre	2636	72	2708
52	Pays de la Loire	44	3	43	089	Malville	3161	89	3250
52	Pays de la Loire	44	2	18	090	La Marne	1364	23	1387
52	Pays de la Loire	44	1	12	091	Marsac-sur-Don	1447	37	1484
52	Pays de la Loire	44	1	12	092	Massérac	643	18	661
52	Pays de la Loire	44	4	38	093	Maumusson	1011	25	1036
52	Pays de la Loire	44	2	06	094	Mauves-sur-Loire	3033	63	3096
52	Pays de la Loire	44	1	19	095	La Meilleraye-de-Bretagne	1345	29	1374
52	Pays de la Loire	44	4	02	096	Mésanger	4394	68	4462
52	Pays de la Loire	44	3	13	097	Mesquer	1727	50	1777
52	Pays de la Loire	44	3	36	098	Missillac	4843	69	4912
52	Pays de la Loire	44	1	19	099	Moisdon-la-Rivière	1920	60	1980
52	Pays de la Loire	44	2	09	100	Monnières	1932	47	1979
52	Pays de la Loire	44	2	30	101	La Montagne	5985	106	6091
52	Pays de la Loire	44	2	01	102	Montbert	2976	50	3026
52	Pays de la Loire	44	3	47	103	Montoir-de-Bretagne	6793	221	7014
52	Pays de la Loire	44	4	45	104	Montrelais	822	17	839
52	Pays de la Loire	44	1	11	105	Mouais	388	7	395
52	Pays de la Loire	44	3	05	106	Les Moutiers-en-Retz	1316	30	1346
52	Pays de la Loire	44	4	16	107	Mouzeil	1783	25	1808
52	Pays de la Loire	44	2	44	108	Mouzillon	2594	45	2639
52	Pays de la Loire	44	2	99	109	Nantes	284970	8264	293234
52	Pays de la Loire	44	1	27	110	Nort-sur-Erdre	7781	238	8019
52	Pays de la Loire	44	1	03	111	Notre-Dame-des-Landes	1970	29	1999
52	Pays de la Loire	44	1	34	112	Noyal-sur-Brutz	582	15	597
52	Pays de la Loire	44	1	28	113	Nozay	3835	73	3908
52	Pays de la Loire	44	2	54	114	Orvault	24504	712	25216
52	Pays de la Loire	44	4	02	115	Oudon	3355	83	3438
52	Pays de la Loire	44	3	29	116	Paimboeuf	3206	107	3313
52	Pays de la Loire	44	2	44	117	Le Pallet	2948	62	3010
52	Pays de la Loire	44	4	33	118	Pannecé	1349	21	1370
52	Pays de la Loire	44	2	18	119	Paulx	1909	47	1956
52	Pays de la Loire	44	2	30	120	Le Pellerin	4382	155	4537
52	Pays de la Loire	44	1	37	121	Petit-Auverné	433	7	440
52	Pays de la Loire	44	1	27	122	Petit-Mars	3462	61	3523
52	Pays de la Loire	44	1	12	123	Pierric	943	19	962
52	Pays de la Loire	44	4	38	124	Le Pin	731	17	748
52	Pays de la Loire	44	3	13	125	Piriac-sur-Mer	2209	56	2265
52	Pays de la Loire	44	3	32	126	La Plaine-sur-Mer	3835	49	3884
52	Pays de la Loire	44	2	01	127	La Planche	2382	55	2437
52	Pays de la Loire	44	1	40	128	Plessé	4631	173	4804
52	Pays de la Loire	44	2	04	130	Pont-Saint-Martin	5684	86	5770
52	Pays de la Loire	44	3	31	129	Pontchâteau	9683	278	9961
52	Pays de la Loire	44	3	32	131	Pornic	14101	349	14450
52	Pays de la Loire	44	3	57	132	Pornichet	10451	345	10796
52	Pays de la Loire	44	2	30	133	Port-Saint-Père	2724	51	2775
52	Pays de la Loire	44	4	02	134	Pouillé-les-Côteaux	873	19	892
52	Pays de la Loire	44	3	10	135	Le Pouliguen	4979	139	5118
52	Pays de la Loire	44	3	32	136	Préfailles	1256	28	1284
52	Pays de la Loire	44	3	43	137	Prinquiau	3103	84	3187
52	Pays de la Loire	44	1	28	138	Puceul	960	15	975
52	Pays de la Loire	44	3	43	139	Quilly	1280	28	1308
52	Pays de la Loire	44	2	44	140	La Regrippière	1544	21	1565
52	Pays de la Loire	44	2	17	141	La Remaudière	1140	12	1152
52	Pays de la Loire	44	2	01	142	Remouillé	1695	27	1722
52	Pays de la Loire	44	2	97	143	Rezé	38425	1258	39683
52	Pays de la Loire	44	4	33	144	Riaillé	2127	76	2203
52	Pays de la Loire	44	4	02	222	La Roche-Blanche	1131	17	1148
52	Pays de la Loire	44	2	30	145	Rouans	2663	36	2699
52	Pays de la Loire	44	1	34	146	Rougé	2253	52	2305
52	Pays de la Loire	44	4	45	147	La Rouxière	1014	18	1032
52	Pays de la Loire	44	1	08	148	Ruffigné	719	12	731
52	Pays de la Loire	44	1	28	149	Saffré	3537	69	3606
52	Pays de la Loire	44	2	04	150	Saint-Aignan-Grandlieu	3506	79	3585
52	Pays de la Loire	44	3	13	151	Saint-André-des-Eaux	5336	173	5509
52	Pays de la Loire	44	1	08	153	Saint-Aubin-des-Châteaux	1615	38	1653
52	Pays de la Loire	44	3	29	154	Saint-Brevin-les-Pins	12248	273	12521
52	Pays de la Loire	44	2	42	155	Saint-Colomban	3129	47	3176
52	Pays de la Loire	44	2	18	157	Saint-Étienne-de-Mer-Morte	1483	17	1500
52	Pays de la Loire	44	2	35	158	Saint-Étienne-de-Montluc	6611	226	6837
52	Pays de la Loire	44	2	59	159	Saint-Fiacre-sur-Maine	1194	37	1231
52	Pays de la Loire	44	4	02	160	Saint-Géréon	2692	123	2815
52	Pays de la Loire	44	3	36	161	Saint-Gildas-des-Bois	3454	134	3588
52	Pays de la Loire	44	2	96	162	Saint-Herblain	43153	925	44078
52	Pays de la Loire	44	4	02	163	Saint-Herblon	2407	39	2446
52	Pays de la Loire	44	3	05	164	Saint-Hilaire-de-Chaléons	1967	30	1997
52	Pays de la Loire	44	2	09	165	Saint-Hilaire-de-Clisson	2019	30	2049
52	Pays de la Loire	44	2	30	166	Saint-Jean-de-Boiseau	5131	69	5200
52	Pays de la Loire	44	3	31	168	Saint-Joachim	4046	78	4124
52	Pays de la Loire	44	2	17	169	Saint-Julien-de-Concelles	6820	139	6959
52	Pays de la Loire	44	1	37	170	Saint-Julien-de-Vouvantes	924	15	939
52	Pays de la Loire	44	2	04	171	Saint-Léger-les-Vignes	1518	31	1549
52	Pays de la Loire	44	2	09	173	Saint-Lumine-de-Clisson	1959	31	1990
52	Pays de la Loire	44	2	42	174	Saint-Lumine-de-Coutais	1891	37	1928
52	Pays de la Loire	44	3	14	175	Saint-Lyphard	4326	117	4443
52	Pays de la Loire	44	3	47	176	Saint-Malo-de-Guersac	3212	64	3276
52	Pays de la Loire	44	2	18	178	Saint-Mars-de-Coutais	2505	43	2548
52	Pays de la Loire	44	1	27	179	Saint-Mars-du-Désert	4027	62	4089
52	Pays de la Loire	44	4	38	180	Saint-Mars-la-Jaille	2445	54	2499
52	Pays de la Loire	44	2	18	181	Saint-Même-le-Tenu	1152	28	1180
52	Pays de la Loire	44	3	32	182	Saint-Michel-Chef-Chef	4435	87	4522
52	Pays de la Loire	44	3	13	183	Saint-Molf	2324	52	2376
52	Pays de la Loire	44	3	98	184	Saint-Nazaire	67031	2693	69724
52	Pays de la Loire	44	1	40	185	Saint-Nicolas-de-Redon	3109	94	3203
52	Pays de la Loire	44	3	41	187	Saint-Père-en-Retz	4135	182	4317
52	Pays de la Loire	44	2	42	188	Saint-Philbert-de-Grand-Lieu	8061	159	8220
52	Pays de la Loire	44	2	50	190	Saint-Sébastien-sur-Loire	25017	815	25832
52	Pays de la Loire	44	4	38	191	Saint-Sulpice-des-Landes	650	11	661
52	Pays de la Loire	44	3	41	192	Saint-Viaud	2116	43	2159
52	Pays de la Loire	44	1	11	193	Saint-Vincent-des-Landes	1462	28	1490
52	Pays de la Loire	44	3	31	152	Sainte-Anne-sur-Brivet	2588	44	2632
52	Pays de la Loire	44	2	06	172	Sainte-Luce-sur-Loire	11907	280	12187
52	Pays de la Loire	44	2	30	186	Sainte-Pazanne	5437	82	5519
52	Pays de la Loire	44	3	31	189	Sainte-Reine-de-Bretagne	2135	27	2162
52	Pays de la Loire	44	2	54	194	Sautron	6901	194	7095
52	Pays de la Loire	44	3	43	195	Savenay	7565	354	7919
52	Pays de la Loire	44	3	36	196	Sévérac	1557	31	1588
52	Pays de la Loire	44	1	11	197	Sion-les-Mines	1678	37	1715
52	Pays de la Loire	44	2	46	198	Les Sorinières	7444	132	7576
52	Pays de la Loire	44	1	08	199	Soudan	2013	68	2081
52	Pays de la Loire	44	1	34	200	Soulvache	397	7	404
52	Pays de la Loire	44	2	07	201	Sucé-sur-Erdre	6258	150	6408
52	Pays de la Loire	44	4	33	202	Teillé	1740	37	1777
52	Pays de la Loire	44	2	35	203	Le Temple-de-Bretagne	1850	18	1868
52	Pays de la Loire	44	2	06	204	Thouaré-sur-Loire	7674	151	7825
52	Pays de la Loire	44	1	27	205	Les Touches	2268	28	2296
52	Pays de la Loire	44	2	15	206	Touvois	1627	23	1650
52	Pays de la Loire	44	4	33	207	Trans-sur-Erdre	970	18	988
52	Pays de la Loire	44	1	28	208	Treffieux	786	19	805
52	Pays de la Loire	44	2	07	209	Treillières	7965	177	8142
52	Pays de la Loire	44	3	47	210	Trignac	7264	486	7750
52	Pays de la Loire	44	3	13	211	La Turballe	4582	125	4707
52	Pays de la Loire	44	2	44	212	Vallet	8425	253	8678
52	Pays de la Loire	44	4	45	213	Varades	3514	137	3651
52	Pays de la Loire	44	1	28	214	Vay	1940	24	1964
52	Pays de la Loire	44	2	46	215	Vertou	21443	674	22117
52	Pays de la Loire	44	2	01	216	Vieillevigne	3905	72	3977
52	Pays de la Loire	44	2	35	217	Vigneux-de-Bretagne	5438	138	5576
52	Pays de la Loire	44	1	34	218	Villepot	653	20	673
52	Pays de la Loire	44	4	38	219	Vritz	729	14	743
52	Pays de la Loire	44	2	30	220	Vue	1415	28	1443
24	Centre	45	1	05	001	Adon	179	12	191
24	Centre	45	1	08	002	Aillant-sur-Milleron	389	12	401
24	Centre	45	1	32	004	Amilly	11588	649	12237
24	Centre	45	3	26	005	Andonville	196	8	204
24	Centre	45	2	13	006	Ardon	1113	46	1159
24	Centre	45	2	01	008	Artenay	1827	35	1862
24	Centre	45	3	26	009	Aschères-le-Marché	1191	18	1209
24	Centre	45	3	29	010	Ascoux	913	31	944
24	Centre	45	3	26	011	Attray	214	3	217
24	Centre	45	3	17	012	Audeville	177	4	181
24	Centre	45	3	30	013	Augerville-la-Rivière	236	3	239
24	Centre	45	3	30	014	Aulnay-la-Rivière	507	17	524
24	Centre	45	3	26	015	Autruy-sur-Juine	728	16	744
24	Centre	45	1	09	016	Autry-le-Châtel	1017	53	1070
24	Centre	45	1	04	017	Auvilliers-en-Gâtinais	352	17	369
24	Centre	45	3	03	018	Auxy	994	13	1007
24	Centre	45	2	18	019	Baccon	717	18	735
24	Centre	45	2	18	020	Le Bardon	1039	20	1059
24	Centre	45	3	03	021	Barville-en-Gâtinais	305	7	312
24	Centre	45	3	03	022	Batilly-en-Gâtinais	404	9	413
24	Centre	45	1	05	023	Batilly-en-Puisaye	112	11	123
24	Centre	45	2	02	024	Baule	2043	66	2109
24	Centre	45	3	26	025	Bazoches-les-Gallerandes	1452	25	1477
24	Centre	45	1	11	026	Bazoches-sur-le-Betz	985	17	1002
24	Centre	45	1	04	027	Beauchamps-sur-Huillard	413	25	438
24	Centre	45	2	02	028	Beaugency	7659	255	7914
24	Centre	45	1	09	029	Beaulieu-sur-Loire	1785	55	1840
24	Centre	45	3	03	030	Beaune-la-Rolande	2018	156	2174
24	Centre	45	1	04	031	Bellegarde	1759	123	1882
24	Centre	45	1	12	032	Le Bignon-Mirabeau	282	4	286
24	Centre	45	3	30	033	Boësses	390	12	402
24	Centre	45	2	38	034	Boigny-sur-Bionne	2164	75	2239
24	Centre	45	3	03	035	Boiscommun	1147	29	1176
24	Centre	45	1	14	036	Boismorand	863	36	899
24	Centre	45	3	26	037	Boisseaux	422	3	425
24	Centre	45	3	29	038	Bondaroy	393	17	410
24	Centre	45	2	27	039	Bonnée	670	26	696
24	Centre	45	1	05	040	Bonny-sur-Loire	2049	62	2111
24	Centre	45	3	03	041	Bordeaux-en-Gâtinais	117	3	120
24	Centre	45	2	27	042	Les Bordes	1777	64	1841
24	Centre	45	2	38	043	Bou	902	30	932
24	Centre	45	2	20	044	Bougy-lez-Neuville	189	0	189
24	Centre	45	3	29	045	Bouilly-en-Gâtinais	344	5	349
24	Centre	45	2	28	046	Boulay-les-Barres	1120	19	1139
24	Centre	45	3	29	047	Bouzonville-aux-Bois	420	4	424
24	Centre	45	2	06	049	Bouzy-la-Forêt	1215	15	1230
24	Centre	45	3	29	050	Boynes	1266	50	1316
24	Centre	45	2	27	051	Bray-en-Val	1366	26	1392
24	Centre	45	1	05	052	Breteau	73	7	80
24	Centre	45	1	05	053	Briare	5710	173	5883
24	Centre	45	3	30	054	Briarres-sur-Essonne	537	8	545
24	Centre	45	2	28	055	Bricy	540	12	552
24	Centre	45	3	30	056	Bromeilles	318	5	323
24	Centre	45	2	01	058	Bucy-le-Roi	191	4	195
24	Centre	45	2	28	059	Bucy-Saint-Liphard	205	7	212
24	Centre	45	1	05	060	La Bussière	793	26	819
24	Centre	45	1	33	061	Cepoy	2347	80	2427
24	Centre	45	2	01	062	Cercottes	1232	17	1249
24	Centre	45	2	31	063	Cerdon	1039	28	1067
24	Centre	45	1	09	064	Cernoy-en-Berry	457	10	467
24	Centre	45	3	17	065	Césarville-Dossainville	220	4	224
24	Centre	45	1	16	066	Chailly-en-Gâtinais	675	18	693
24	Centre	45	2	18	067	Chaingy	3531	116	3647
24	Centre	45	1	33	068	Châlette-sur-Loing	13050	348	13398
24	Centre	45	3	03	069	Chambon-la-Forêt	840	11	851
24	Centre	45	1	05	070	Champoulet	47	0	47
24	Centre	45	2	34	072	Chanteau	1281	43	1324
24	Centre	45	1	11	073	Chantecoq	524	11	535
24	Centre	45	2	28	074	La Chapelle-Onzerain	115	3	118
24	Centre	45	2	39	075	La Chapelle-Saint-Mesmin	9658	182	9840
24	Centre	45	1	11	076	La Chapelle-Saint-Sépulcre	262	10	272
24	Centre	45	1	08	077	La Chapelle-sur-Aveyron	550	10	560
24	Centre	45	1	04	078	Chapelon	282	9	291
24	Centre	45	1	08	079	Le Charme	151	6	157
24	Centre	45	3	26	080	Charmont-en-Beauce	402	7	409
24	Centre	45	2	18	081	Charsonville	588	15	603
24	Centre	45	1	07	083	Château-Renard	2280	82	2362
24	Centre	45	2	06	082	Châteauneuf-sur-Loire	8005	170	8175
24	Centre	45	2	06	084	Châtenoy	420	17	437
24	Centre	45	1	08	085	Châtillon-Coligny	1983	66	2049
24	Centre	45	3	26	086	Châtillon-le-Roi	277	12	289
24	Centre	45	1	09	087	Châtillon-sur-Loire	3132	90	3222
24	Centre	45	3	26	088	Chaussy	341	14	355
24	Centre	45	2	38	089	Chécy	8208	176	8384
24	Centre	45	1	12	091	Chevannes	343	7	350
24	Centre	45	1	32	092	Chevillon-sur-Huillard	1308	45	1353
24	Centre	45	2	01	093	Chevilly	2495	42	2537
24	Centre	45	1	12	094	Chevry-sous-le-Bignon	231	4	235
24	Centre	45	3	29	095	Chilleurs-aux-Bois	1841	29	1870
24	Centre	45	1	14	096	Les Choux	500	24	524
24	Centre	45	1	07	097	Chuelles	1136	45	1181
24	Centre	45	2	10	098	Cléry-Saint-André	3255	112	3367
24	Centre	45	2	28	099	Coinces	556	13	569
24	Centre	45	2	38	100	Combleux	475	23	498
24	Centre	45	2	06	101	Combreux	241	4	245
24	Centre	45	1	32	102	Conflans-sur-Loing	359	33	392
24	Centre	45	1	12	103	Corbeilles	1490	49	1539
24	Centre	45	1	33	104	Corquilleroy	2621	89	2710
24	Centre	45	1	08	105	Cortrat	90	5	95
24	Centre	45	3	17	106	Coudray	404	9	413
24	Centre	45	1	16	107	Coudroy	348	9	357
24	Centre	45	1	14	108	Coullons	2451	66	2517
24	Centre	45	2	18	109	Coulmiers	535	11	546
24	Centre	45	1	16	112	La Cour-Marigny	349	6	355
24	Centre	45	3	03	110	Courcelles	285	5	290
24	Centre	45	3	29	111	Courcy-aux-Loges	434	4	438
24	Centre	45	1	11	113	Courtemaux	289	21	310
24	Centre	45	1	12	114	Courtempierre	243	4	247
24	Centre	45	1	11	115	Courtenay	3976	100	4076
24	Centre	45	2	02	116	Cravant	949	18	967
24	Centre	45	3	26	118	Crottes-en-Pithiverais	330	9	339
24	Centre	45	3	29	119	Dadonville	2259	76	2335
24	Centre	45	1	05	120	Dammarie-en-Puisaye	180	5	185
24	Centre	45	1	08	121	Dammarie-sur-Loing	530	19	549
24	Centre	45	2	27	122	Dampierre-en-Burly	1260	41	1301
24	Centre	45	2	15	123	Darvoy	1869	32	1901
24	Centre	45	3	30	124	Desmonts	172	4	176
24	Centre	45	3	30	125	Dimancheville	112	3	115
24	Centre	45	2	38	126	Donnery	2533	56	2589
24	Centre	45	1	12	127	Dordives	2976	50	3026
24	Centre	45	1	07	129	Douchy	1012	31	1043
24	Centre	45	2	10	130	Dry	1391	16	1407
24	Centre	45	3	30	131	Échilleuses	374	4	378
24	Centre	45	3	03	132	Égry	341	6	347
24	Centre	45	3	17	133	Engenville	507	13	520
24	Centre	45	2	18	134	Épieds-en-Beauce	1429	22	1451
24	Centre	45	3	26	135	Erceville	323	6	329
24	Centre	45	1	11	136	Ervauville	565	15	580
24	Centre	45	3	29	137	Escrennes	709	9	718
24	Centre	45	1	05	138	Escrignelles	64	1	65
24	Centre	45	3	29	139	Estouy	519	11	530
24	Centre	45	1	05	141	Faverelles	159	2	161
24	Centre	45	2	06	142	Fay-aux-Loges	3349	59	3408
24	Centre	45	1	05	143	Feins-en-Gâtinais	50	1	51
24	Centre	45	2	15	144	Férolles	1175	71	1246
24	Centre	45	1	12	145	Ferrières-en-Gâtinais	3395	74	3469
24	Centre	45	2	13	146	La Ferté-Saint-Aubin	7127	124	7251
24	Centre	45	2	34	147	Fleury-les-Aubrais	21171	279	21450
24	Centre	45	1	12	148	Fontenay-sur-Loing	1713	55	1768
24	Centre	45	1	11	149	Foucherolles	295	8	303
24	Centre	45	1	04	150	Fréville-du-Gâtinais	182	2	184
24	Centre	45	3	03	151	Gaubertin	268	2	270
24	Centre	45	2	28	152	Gémigny	223	4	227
24	Centre	45	2	06	153	Germigny-des-Prés	730	17	747
24	Centre	45	2	01	154	Gidy	1585	26	1611
24	Centre	45	1	14	155	Gien	14684	570	15254
24	Centre	45	1	12	156	Girolles	676	26	702
24	Centre	45	3	29	157	Givraines	378	7	385
24	Centre	45	1	12	158	Gondreville	371	11	382
24	Centre	45	3	30	159	Grangermont	209	3	212
24	Centre	45	3	26	160	Greneville-en-Beauce	662	16	678
24	Centre	45	1	12	161	Griselles	801	22	823
24	Centre	45	3	29	162	Guigneville	527	9	536
24	Centre	45	2	31	164	Guilly	666	7	673
24	Centre	45	1	07	165	Gy-les-Nonains	638	15	653
24	Centre	45	2	01	166	Huêtre	252	3	255
24	Centre	45	2	18	167	Huisseau-sur-Mauves	1638	31	1669
24	Centre	45	2	20	168	Ingrannes	521	9	530
24	Centre	45	2	39	169	Ingré	7899	194	8093
24	Centre	45	3	17	170	Intville-la-Guétard	123	2	125
24	Centre	45	2	31	171	Isdes	590	23	613
24	Centre	45	2	15	173	Jargeau	4488	98	4586
24	Centre	45	3	26	174	Jouy-en-Pithiverais	249	7	256
24	Centre	45	2	10	175	Jouy-le-Potier	1324	38	1362
24	Centre	45	3	03	176	Juranville	485	8	493
24	Centre	45	3	29	177	Laas	203	8	211
24	Centre	45	3	17	057	Labrosse	79	1	80
24	Centre	45	1	04	178	Ladon	1342	38	1380
24	Centre	45	2	02	179	Lailly-en-Val	2639	57	2696
24	Centre	45	1	14	180	Langesse	79	0	79
24	Centre	45	3	26	181	Léouville	66	0	66
24	Centre	45	2	13	182	Ligny-le-Ribault	1305	37	1342
24	Centre	45	2	01	183	Lion-en-Beauce	135	4	139
24	Centre	45	2	31	184	Lion-en-Sullias	393	14	407
24	Centre	45	1	32	185	Lombreuil	306	15	321
24	Centre	45	3	03	186	Lorcy	546	12	558
24	Centre	45	1	16	187	Lorris	2966	77	3043
24	Centre	45	2	20	188	Loury	2519	52	2571
24	Centre	45	1	11	189	Louzouer	266	11	277
24	Centre	45	3	17	190	Mainvilliers	237	4	241
24	Centre	45	3	17	191	Malesherbes	6190	111	6301
24	Centre	45	3	17	192	Manchecourt	641	17	658
24	Centre	45	2	13	193	Marcilly-en-Villette	1999	59	2058
24	Centre	45	2	38	194	Mardié	2560	61	2621
24	Centre	45	3	29	195	Mareau-aux-Bois	608	18	626
24	Centre	45	2	10	196	Mareau-aux-Prés	1290	22	1312
24	Centre	45	2	38	197	Marigny-les-Usages	1140	31	1171
24	Centre	45	3	29	198	Marsainvilliers	302	15	317
24	Centre	45	1	07	199	Melleroy	519	11	530
24	Centre	45	2	13	200	Ménestreau-en-Villette	1467	51	1518
24	Centre	45	1	11	201	Mérinville	164	6	170
24	Centre	45	2	02	202	Messas	875	18	893
24	Centre	45	2	18	203	Meung-sur-Loire	6086	104	6190
24	Centre	45	1	04	205	Mézières-en-Gâtinais	260	3	263
24	Centre	45	2	10	204	Mézières-lez-Cléry	793	15	808
24	Centre	45	1	12	206	Mignères	317	15	332
24	Centre	45	1	12	207	Mignerette	357	21	378
24	Centre	45	1	19	208	Montargis	14649	934	15583
24	Centre	45	3	03	209	Montbarrois	272	12	284
24	Centre	45	1	08	210	Montbouy	745	17	762
24	Centre	45	1	07	211	Montcorbon	460	10	470
24	Centre	45	1	08	212	Montcresson	1299	40	1339
24	Centre	45	1	16	213	Montereau	622	16	638
24	Centre	45	3	26	214	Montigny	250	6	256
24	Centre	45	3	03	215	Montliard	224	5	229
24	Centre	45	1	32	216	Mormant-sur-Vernisson	125	6	131
24	Centre	45	3	17	217	Morville-en-Beauce	187	5	192
24	Centre	45	1	14	218	Le Moulinet-sur-Solin	138	0	138
24	Centre	45	1	04	219	Moulon	188	13	201
24	Centre	45	3	03	220	Nancray-sur-Rimarde	554	6	560
24	Centre	45	3	17	221	Nangeville	116	2	118
24	Centre	45	1	12	222	Nargis	1394	41	1435
24	Centre	45	1	04	223	Nesploy	387	7	394
24	Centre	45	2	20	224	Neuville-aux-Bois	4113	74	4187
24	Centre	45	3	30	225	La Neuville-sur-Essonne	366	0	366
24	Centre	45	2	15	226	Neuvy-en-Sullias	1198	26	1224
24	Centre	45	1	14	227	Nevoy	1149	48	1197
24	Centre	45	3	03	228	Nibelle	1045	16	1061
24	Centre	45	1	08	229	Nogent-sur-Vernisson	2594	48	2642
24	Centre	45	1	16	230	Noyers	722	26	748
24	Centre	45	3	26	231	Oison	130	1	131
24	Centre	45	2	35	232	Olivet	19583	613	20196
24	Centre	45	3	30	233	Ondreville-sur-Essonne	389	8	397
24	Centre	45	2	99	234	Orléans	114167	3666	117833
24	Centre	45	2	39	235	Ormes	3435	69	3504
24	Centre	45	3	17	236	Orveau-Bellesauve	381	7	388
24	Centre	45	3	30	237	Orville	109	3	112
24	Centre	45	1	05	238	Ousson-sur-Loire	743	31	774
24	Centre	45	1	16	239	Oussoy-en-Gâtinais	406	13	419
24	Centre	45	3	26	240	Outarville	1433	38	1471
24	Centre	45	2	15	241	Ouvrouer-les-Champs	521	12	533
24	Centre	45	1	16	242	Ouzouer-des-Champs	280	8	288
24	Centre	45	1	04	243	Ouzouer-sous-Bellegarde	283	6	289
24	Centre	45	2	27	244	Ouzouer-sur-Loire	2765	81	2846
24	Centre	45	1	05	245	Ouzouer-sur-Trézée	1276	25	1301
24	Centre	45	3	17	246	Pannecières	118	0	118
24	Centre	45	1	33	247	Pannes	3379	107	3486
24	Centre	45	2	28	248	Patay	2080	50	2130
24	Centre	45	1	33	249	Paucourt	894	47	941
24	Centre	45	1	11	250	Pers-en-Gâtinais	225	4	229
24	Centre	45	1	09	251	Pierrefitte-ès-Bois	286	3	289
24	Centre	45	3	29	252	Pithiviers	8804	196	9000
24	Centre	45	3	29	253	Pithiviers-le-Vieil	1828	50	1878
24	Centre	45	1	14	254	Poilly-lez-Gien	2341	69	2410
24	Centre	45	1	12	255	Préfontaines	461	24	485
24	Centre	45	1	16	256	Presnoy	245	4	249
24	Centre	45	1	08	257	Pressigny-les-Pins	454	3	457
24	Centre	45	3	30	258	Puiseaux	3297	72	3369
24	Centre	45	1	04	259	Quiers-sur-Bézonde	1173	24	1197
24	Centre	45	3	17	260	Ramoulu	259	5	264
24	Centre	45	2	20	261	Rebréchien	1363	23	1386
24	Centre	45	2	28	262	Rouvray-Sainte-Croix	139	5	144
24	Centre	45	3	17	263	Rouvres-Saint-Jean	282	11	293
24	Centre	45	2	18	264	Rozières-en-Beauce	183	4	187
24	Centre	45	1	11	265	Rozoy-le-Vieil	391	5	396
24	Centre	45	2	01	266	Ruan	232	7	239
24	Centre	45	2	06	267	Saint-Aignan-des-Gués	342	9	351
24	Centre	45	2	31	268	Saint-Aignan-le-Jaillard	573	8	581
24	Centre	45	2	18	269	Saint-Ay	3161	54	3215
24	Centre	45	2	27	270	Saint-Benoît-sur-Loire	2057	39	2096
24	Centre	45	1	14	271	Saint-Brisson-sur-Loire	1029	46	1075
24	Centre	45	2	40	272	Saint-Cyr-en-Val	3107	149	3256
24	Centre	45	2	06	273	Saint-Denis-de-l;Hôtel	2925	43	2968
24	Centre	45	2	40	274	Saint-Denis-en-Val	7162	214	7376
24	Centre	45	1	07	275	Saint-Firmin-des-Bois	489	10	499
24	Centre	45	1	09	276	Saint-Firmin-sur-Loire	502	13	515
24	Centre	45	2	31	277	Saint-Florent	464	7	471
24	Centre	45	1	07	279	Saint-Germain-des-Prés	1881	45	1926
24	Centre	45	1	14	280	Saint-Gondon	1099	49	1148
24	Centre	45	1	11	281	Saint-Hilaire-les-Andrésis	976	32	1008
24	Centre	45	2	35	282	Saint-Hilaire-Saint-Mesmin	2847	81	2928
24	Centre	45	1	16	283	Saint-Hilaire-sur-Puiseaux	166	5	171
24	Centre	45	2	36	284	Saint-Jean-de-Braye	19057	566	19623
24	Centre	45	2	37	285	Saint-Jean-de-la-Ruelle	16631	320	16951
24	Centre	45	2	40	286	Saint-Jean-le-Blanc	8185	245	8430
24	Centre	45	1	11	287	Saint-Loup-de-Gonois	111	2	113
24	Centre	45	3	03	288	Saint-Loup-des-Vignes	441	11	452
24	Centre	45	2	20	289	Saint-Lyé-la-Forêt	1098	17	1115
24	Centre	45	2	06	290	Saint-Martin-d;Abbat	1643	40	1683
24	Centre	45	1	14	291	Saint-Martin-sur-Ocre	1244	45	1289
24	Centre	45	1	08	292	Saint-Maurice-sur-Aveyron	873	43	916
24	Centre	45	1	32	293	Saint-Maurice-sur-Fessard	1160	35	1195
24	Centre	45	3	03	294	Saint-Michel	125	4	129
24	Centre	45	2	28	296	Saint-Péravy-la-Colombe	688	10	698
24	Centre	45	2	31	297	Saint-Père-sur-Loire	1040	55	1095
24	Centre	45	2	35	298	Saint-Pryvé-Saint-Mesmin	5188	144	5332
24	Centre	45	2	28	299	Saint-Sigismond	295	4	299
24	Centre	45	1	08	278	Sainte-Geneviève-des-Bois	1081	70	1151
24	Centre	45	2	15	300	Sandillon	3865	80	3945
24	Centre	45	3	29	301	Santeau	367	8	375
24	Centre	45	2	39	302	Saran	15120	303	15423
24	Centre	45	1	12	303	Sceaux-du-Gâtinais	620	25	645
24	Centre	45	2	06	305	Seichebrières	173	4	177
24	Centre	45	1	07	306	La Selle-en-Hermoy	779	24	803
24	Centre	45	1	11	307	La Selle-sur-le-Bied	977	37	1014
24	Centre	45	2	36	308	Semoy	3107	73	3180
24	Centre	45	2	13	309	Sennely	651	12	663
24	Centre	45	3	17	310	Sermaises	1593	42	1635
24	Centre	45	2	15	311	Sigloy	664	10	674
24	Centre	45	1	32	312	Solterre	500	22	522
24	Centre	45	2	01	313	Sougy	874	21	895
24	Centre	45	2	20	314	Sully-la-Chapelle	416	6	422
24	Centre	45	2	31	315	Sully-sur-Loire	5443	131	5574
24	Centre	45	2	06	316	Sury-aux-Bois	787	15	802
24	Centre	45	2	02	317	Tavers	1334	45	1379
24	Centre	45	3	17	320	Thignonville	330	8	338
24	Centre	45	1	16	321	Thimory	728	21	749
24	Centre	45	1	11	322	Thorailles	158	6	164
24	Centre	45	1	05	323	Thou	237	12	249
24	Centre	45	2	15	324	Tigy	2271	43	2314
24	Centre	45	3	26	325	Tivernon	238	2	240
24	Centre	45	2	28	326	Tournoisis	371	8	379
24	Centre	45	2	20	327	Traînou	3105	49	3154
24	Centre	45	1	12	328	Treilles-en-Gâtinais	297	5	302
24	Centre	45	1	07	329	Triguères	1355	27	1382
24	Centre	45	2	01	330	Trinay	214	5	219
24	Centre	45	2	15	331	Vannes-sur-Cosson	600	16	616
24	Centre	45	1	16	332	Varennes-Changy	1564	34	1598
24	Centre	45	2	20	333	Vennecy	1408	17	1425
24	Centre	45	1	16	334	Vieilles-Maisons-sur-Joudry	600	12	612
24	Centre	45	2	15	335	Vienne-en-Val	1887	41	1928
24	Centre	45	2	31	336	Viglain	897	22	919
24	Centre	45	2	28	337	Villamblain	275	4	279
24	Centre	45	1	32	338	Villemandeur	6450	406	6856
24	Centre	45	1	04	339	Villemoutiers	492	12	504
24	Centre	45	2	31	340	Villemurlin	584	9	593
24	Centre	45	2	28	341	Villeneuve-sur-Conie	204	10	214
24	Centre	45	2	20	342	Villereau	402	12	414
24	Centre	45	1	33	343	Villevoques	205	12	217
24	Centre	45	2	02	344	Villorceau	1158	25	1183
24	Centre	45	1	32	345	Vimory	1123	30	1153
24	Centre	45	2	06	346	Vitry-aux-Loges	1850	45	1895
24	Centre	45	3	29	347	Vrigny	778	30	808
24	Centre	45	3	29	348	Yèvre-la-Ville	699	22	721
73	Midi-Pyrénées	46	1	19	001	Albas	516	20	536
73	Midi-Pyrénées	46	2	13	002	Albiac	87	1	88
73	Midi-Pyrénées	46	3	11	003	Alvignac	733	23	756
73	Midi-Pyrénées	46	2	13	004	Anglars	176	2	178
73	Midi-Pyrénées	46	1	19	005	Anglars-Juillac	349	10	359
73	Midi-Pyrénées	46	3	10	006	Anglars-Nozac	307	4	311
73	Midi-Pyrénées	46	1	03	007	Arcambal	997	35	1032
73	Midi-Pyrénées	46	1	07	008	Les Arques	207	3	210
73	Midi-Pyrénées	46	2	18	009	Assier	684	26	710
73	Midi-Pyrénées	46	1	14	010	Aujols	307	10	317
73	Midi-Pyrénées	46	2	24	011	Autoire	342	16	358
73	Midi-Pyrénées	46	2	13	012	Aynac	590	6	596
73	Midi-Pyrénées	46	1	14	013	Bach	170	9	179
73	Midi-Pyrénées	46	1	21	014	Bagat-en-Quercy	196	5	201
73	Midi-Pyrénées	46	2	08	015	Bagnac-sur-Célé	1556	54	1610
73	Midi-Pyrénées	46	3	20	016	Baladou	409	8	417
73	Midi-Pyrénées	46	2	24	017	Bannes	137	5	142
73	Midi-Pyrénées	46	3	11	018	Le Bastit	147	4	151
73	Midi-Pyrénées	46	3	12	019	Beaumat	76	0	76
73	Midi-Pyrénées	46	1	17	020	Beauregard	241	7	248
73	Midi-Pyrénées	46	2	09	021	Béduer	740	19	759
73	Midi-Pyrénées	46	1	19	022	Bélaye	218	9	227
73	Midi-Pyrénées	46	1	14	023	Belfort-du-Quercy	523	8	531
73	Midi-Pyrénées	46	2	01	024	Belmont-Bretenoux	354	7	361
73	Midi-Pyrénées	46	1	14	026	Belmont-Sainte-Foi	109	0	109
73	Midi-Pyrénées	46	1	21	025	Belmontet	147	4	151
73	Midi-Pyrénées	46	1	26	027	Berganty	102	4	106
73	Midi-Pyrénées	46	2	15	338	Bessonies	101	3	104
73	Midi-Pyrénées	46	3	29	028	Bétaille	1072	17	1089
73	Midi-Pyrénées	46	2	01	029	Biars-sur-Cère	1906	86	1992
73	Midi-Pyrénées	46	3	11	030	Bio	310	12	322
73	Midi-Pyrénées	46	1	16	031	Blars	126	1	127
73	Midi-Pyrénées	46	1	06	032	Boissières	372	8	380
73	Midi-Pyrénées	46	1	21	033	Le Boulvé	179	8	187
73	Midi-Pyrénées	46	2	13	034	Le Bourg	296	7	303
73	Midi-Pyrénées	46	2	18	035	Boussac	168	7	175
73	Midi-Pyrénées	46	2	13	036	Le Bouyssou	122	8	130
73	Midi-Pyrénées	46	1	26	037	Bouziès	78	2	80
73	Midi-Pyrénées	46	2	18	039	Brengues	206	6	212
73	Midi-Pyrénées	46	2	01	038	Bretenoux	1355	35	1390
73	Midi-Pyrénées	46	1	16	040	Cabrerets	231	1	232
73	Midi-Pyrénées	46	2	04	041	Cadrieu	158	4	162
73	Midi-Pyrénées	46	1	98	042	Cahors	20194	1139	21333
73	Midi-Pyrénées	46	2	01	043	Cahus	189	5	194
73	Midi-Pyrénées	46	1	19	044	Caillac	575	14	589
73	Midi-Pyrénées	46	2	04	045	Cajarc	1119	51	1170
73	Midi-Pyrénées	46	1	06	046	Calamane	465	12	477
73	Midi-Pyrénées	46	3	22	047	Calès	168	7	175
73	Midi-Pyrénées	46	2	30	048	Calviac	165	8	173
73	Midi-Pyrénées	46	1	17	049	Calvignac	202	8	210
73	Midi-Pyrénées	46	1	19	050	Cambayrac	143	3	146
73	Midi-Pyrénées	46	2	18	051	Cambes	331	19	350
73	Midi-Pyrénées	46	2	09	052	Camboulit	251	5	256
73	Midi-Pyrénées	46	2	09	053	Camburat	446	27	473
73	Midi-Pyrénées	46	3	12	054	Caniac-du-Causse	339	14	353
73	Midi-Pyrénées	46	2	09	055	Capdenac	1092	30	1122
73	Midi-Pyrénées	46	2	04	056	Carayac	79	1	80
73	Midi-Pyrénées	46	2	13	057	Cardaillac	566	28	594
73	Midi-Pyrénées	46	3	29	058	Carennac	389	14	403
73	Midi-Pyrénées	46	3	11	059	Carlucet	231	12	243
73	Midi-Pyrénées	46	1	19	060	Carnac-Rouffiac	249	4	253
73	Midi-Pyrénées	46	1	23	061	Cassagnes	207	1	208
73	Midi-Pyrénées	46	1	19	062	Castelfranc	409	7	416
73	Midi-Pyrénées	46	1	05	063	Castelnau-Montratier	1847	47	1894
73	Midi-Pyrénées	46	1	06	064	Catus	920	16	936
73	Midi-Pyrénées	46	3	29	065	Cavagnac	444	14	458
73	Midi-Pyrénées	46	1	07	066	Cazals	617	19	636
73	Midi-Pyrénées	46	3	20	067	Cazillac	422	7	429
73	Midi-Pyrénées	46	1	17	068	Cénevières	179	3	182
73	Midi-Pyrénées	46	1	05	069	Cézac	180	2	182
73	Midi-Pyrénées	46	1	14	070	Cieurac	426	16	442
73	Midi-Pyrénées	46	2	30	071	Comiac	234	10	244
73	Midi-Pyrénées	46	3	25	072	Concorès	287	6	293
73	Midi-Pyrénées	46	1	17	073	Concots	418	8	426
73	Midi-Pyrénées	46	3	29	074	Condat	414	7	421
73	Midi-Pyrénées	46	2	18	075	Corn	198	5	203
73	Midi-Pyrénées	46	2	01	076	Cornac	355	8	363
73	Midi-Pyrénées	46	1	26	077	Cours	300	10	310
73	Midi-Pyrénées	46	3	11	078	Couzou	107	2	109
73	Midi-Pyrénées	46	1	16	079	Cras	93	2	95
73	Midi-Pyrénées	46	1	06	080	Crayssac	737	18	755
73	Midi-Pyrénées	46	1	26	081	Crégols	78	3	81
73	Midi-Pyrénées	46	1	14	082	Cremps	328	7	335
73	Midi-Pyrénées	46	3	20	083	Cressensac	637	18	655
73	Midi-Pyrénées	46	3	20	084	Creysse	293	5	298
73	Midi-Pyrénées	46	2	08	085	Cuzac	238	5	243
73	Midi-Pyrénées	46	3	20	086	Cuzance	547	10	557
73	Midi-Pyrénées	46	3	27	087	Dégagnac	607	3	610
73	Midi-Pyrénées	46	1	19	088	Douelle	823	21	844
73	Midi-Pyrénées	46	1	23	089	Duravel	960	23	983
73	Midi-Pyrénées	46	2	18	090	Durbans	129	4	133
73	Midi-Pyrénées	46	1	14	091	Escamps	169	4	173
73	Midi-Pyrénées	46	1	26	092	Esclauzels	218	4	222
73	Midi-Pyrénées	46	2	18	093	Espagnac-Sainte-Eulalie	85	2	87
73	Midi-Pyrénées	46	2	18	094	Espédaillac	261	6	267
73	Midi-Pyrénées	46	1	31	095	Espère	1004	22	1026
73	Midi-Pyrénées	46	2	13	096	Espeyroux	96	4	100
73	Midi-Pyrénées	46	2	01	097	Estal	124	1	125
73	Midi-Pyrénées	46	3	22	098	Fajoles	262	8	270
73	Midi-Pyrénées	46	1	21	099	Fargues	159	2	161
73	Midi-Pyrénées	46	2	09	100	Faycelles	630	14	644
73	Midi-Pyrénées	46	2	08	101	Felzins	387	7	394
73	Midi-Pyrénées	46	2	99	102	Figeac	9810	761	10571
73	Midi-Pyrénées	46	1	05	103	Flaugnac	430	11	441
73	Midi-Pyrénées	46	2	18	104	Flaujac-Gare	92	4	96
73	Midi-Pyrénées	46	1	14	105	Flaujac-Poujols	698	24	722
73	Midi-Pyrénées	46	3	20	106	Floirac	275	4	279
73	Midi-Pyrénées	46	1	23	107	Floressas	154	4	158
73	Midi-Pyrénées	46	2	09	108	Fons	393	13	406
73	Midi-Pyrénées	46	1	14	109	Fontanes	456	11	467
73	Midi-Pyrénées	46	3	12	110	Fontanes-du-Causse	75	1	76
73	Midi-Pyrénées	46	2	09	111	Fourmagnac	155	2	157
73	Midi-Pyrénées	46	1	06	112	Francoulès	217	4	221
73	Midi-Pyrénées	46	3	25	113	Frayssinet	318	9	327
73	Midi-Pyrénées	46	1	07	114	Frayssinet-le-Gélat	383	9	392
73	Midi-Pyrénées	46	2	24	115	Frayssinhes	198	8	206
73	Midi-Pyrénées	46	2	04	116	Frontenac	76	0	76
73	Midi-Pyrénées	46	2	01	117	Gagnac-sur-Cère	736	40	776
73	Midi-Pyrénées	46	3	28	118	Gignac	640	18	658
73	Midi-Pyrénées	46	1	06	119	Gigouzac	231	9	240
73	Midi-Pyrénées	46	1	07	120	Gindou	310	14	324
73	Midi-Pyrénées	46	3	12	121	Ginouillac	171	1	172
73	Midi-Pyrénées	46	2	01	122	Gintrac	112	3	115
73	Midi-Pyrénées	46	2	01	123	Girac	369	15	384
73	Midi-Pyrénées	46	2	01	124	Glanes	286	12	298
73	Midi-Pyrénées	46	2	15	125	Gorses	344	7	351
73	Midi-Pyrénées	46	1	07	126	Goujounac	229	3	232
73	Midi-Pyrénées	46	3	10	127	Gourdon	4640	190	4830
73	Midi-Pyrénées	46	3	11	128	Gramat	3537	106	3643
73	Midi-Pyrénées	46	2	04	129	Gréalou	254	9	263
73	Midi-Pyrénées	46	1	23	130	Grézels	243	12	255
73	Midi-Pyrénées	46	2	18	131	Grèzes	162	7	169
73	Midi-Pyrénées	46	2	13	132	Issendolus	528	9	537
73	Midi-Pyrénées	46	2	18	133	Issepts	179	4	183
73	Midi-Pyrénées	46	1	06	134	Les Junies	251	13	264
73	Midi-Pyrénées	46	2	15	135	Labastide-du-Haut-Mont	45	3	48
73	Midi-Pyrénées	46	1	06	136	Labastide-du-Vert	235	8	243
73	Midi-Pyrénées	46	1	03	137	Labastide-Marnhac	1139	39	1178
73	Midi-Pyrénées	46	3	12	138	Labastide-Murat	659	22	681
73	Midi-Pyrénées	46	2	13	139	Labathude	189	6	195
73	Midi-Pyrénées	46	1	14	140	Laburgade	314	6	320
73	Midi-Pyrénées	46	2	30	141	Lacam-d;Ourcet	124	3	127
73	Midi-Pyrénées	46	1	23	142	Lacapelle-Cabanac	163	4	167
73	Midi-Pyrénées	46	2	13	143	Lacapelle-Marival	1328	40	1368
73	Midi-Pyrénées	46	3	28	144	Lacave	285	9	294
73	Midi-Pyrénées	46	3	28	145	Lachapelle-Auzac	764	27	791
73	Midi-Pyrénées	46	2	15	146	Ladirat	114	4	118
73	Midi-Pyrénées	46	1	23	147	Lagardelle	139	1	140
73	Midi-Pyrénées	46	1	14	148	Lalbenque	1619	39	1658
73	Midi-Pyrénées	46	1	02	149	Lamagdelaine	751	44	795
73	Midi-Pyrénées	46	2	30	150	Lamativie	65	2	67
73	Midi-Pyrénées	46	3	25	151	Lamothe-Cassel	97	1	98
73	Midi-Pyrénées	46	3	22	152	Lamothe-Fénelon	338	5	343
73	Midi-Pyrénées	46	3	28	153	Lanzac	592	22	614
73	Midi-Pyrénées	46	1	17	154	Laramière	320	11	331
73	Midi-Pyrénées	46	2	04	155	Larnagol	133	7	140
73	Midi-Pyrénées	46	1	02	156	Laroque-des-Arcs	503	17	520
73	Midi-Pyrénées	46	2	04	157	Larroque-Toirac	143	1	144
73	Midi-Pyrénées	46	1	21	158	Lascabanes	189	3	192
73	Midi-Pyrénées	46	2	24	159	Latouille-Lentillac	239	15	254
73	Midi-Pyrénées	46	2	15	160	Latronquière	544	8	552
73	Midi-Pyrénées	46	2	15	161	Lauresses	283	7	290
73	Midi-Pyrénées	46	1	16	162	Lauzès	167	2	169
73	Midi-Pyrénées	46	2	01	163	Laval-de-Cère	342	9	351
73	Midi-Pyrénées	46	3	27	164	Lavercantière	273	3	276
73	Midi-Pyrénées	46	3	11	165	Lavergne	433	16	449
73	Midi-Pyrénées	46	1	21	166	Lebreil	154	6	160
73	Midi-Pyrénées	46	1	16	167	Lentillac-du-Causse	110	2	112
73	Midi-Pyrénées	46	2	08	168	Lentillac-Saint-Blaise	138	2	140
73	Midi-Pyrénées	46	3	27	169	Léobard	207	6	213
73	Midi-Pyrénées	46	2	13	170	Leyme	961	21	982
73	Midi-Pyrénées	46	1	06	171	Lherm	242	7	249
73	Midi-Pyrénées	46	1	05	172	Lhospitalet	449	10	459
73	Midi-Pyrénées	46	1	17	173	Limogne-en-Quercy	796	17	813
73	Midi-Pyrénées	46	2	08	174	Linac	215	7	222
73	Midi-Pyrénées	46	2	09	175	Lissac-et-Mouret	939	32	971
73	Midi-Pyrénées	46	2	18	176	Livernon	633	11	644
73	Midi-Pyrénées	46	2	24	177	Loubressac	520	25	545
73	Midi-Pyrénées	46	3	22	178	Loupiac	270	5	275
73	Midi-Pyrénées	46	1	17	179	Lugagnac	118	12	130
73	Midi-Pyrénées	46	2	08	180	Lunan	528	14	542
73	Midi-Pyrénées	46	3	12	181	Lunegarde	90	1	91
73	Midi-Pyrénées	46	1	19	182	Luzech	1679	34	1713
73	Midi-Pyrénées	46	2	04	183	Marcilhac-sur-Célé	197	7	204
73	Midi-Pyrénées	46	1	07	184	Marminiac	383	14	397
73	Midi-Pyrénées	46	3	20	185	Martel	1650	45	1695
73	Midi-Pyrénées	46	3	22	186	Masclat	347	12	359
73	Midi-Pyrénées	46	1	23	187	Mauroux	539	11	550
73	Midi-Pyrénées	46	1	06	188	Maxou	291	5	296
73	Midi-Pyrénées	46	3	28	337	Mayrac	268	5	273
73	Midi-Pyrénées	46	2	24	189	Mayrinhac-Lentour	519	16	535
73	Midi-Pyrénées	46	1	06	190	Mechmont	115	6	121
73	Midi-Pyrénées	46	1	31	191	Mercuès	1054	31	1085
73	Midi-Pyrénées	46	3	28	192	Meyronne	300	10	310
73	Midi-Pyrénées	46	3	11	193	Miers	437	20	457
73	Midi-Pyrénées	46	3	10	194	Milhac	199	5	204
73	Midi-Pyrénées	46	2	13	195	Molières	368	4	372
73	Midi-Pyrénées	46	3	25	196	Montamel	96	7	103
73	Midi-Pyrénées	46	1	03	197	Le Montat	972	115	1087
73	Midi-Pyrénées	46	2	04	198	Montbrun	116	2	118
73	Midi-Pyrénées	46	1	23	199	Montcabrier	351	11	362
73	Midi-Pyrénées	46	1	07	200	Montcléra	273	12	285
73	Midi-Pyrénées	46	1	21	201	Montcuq	1273	49	1322
73	Midi-Pyrénées	46	1	14	202	Montdoumerc	437	5	442
73	Midi-Pyrénées	46	2	15	203	Montet-et-Bouxal	229	8	237
73	Midi-Pyrénées	46	3	12	204	Montfaucon	526	11	537
73	Midi-Pyrénées	46	1	06	205	Montgesty	310	3	313
73	Midi-Pyrénées	46	1	21	206	Montlauzun	128	3	131
73	Midi-Pyrénées	46	2	08	207	Montredon	285	2	287
73	Midi-Pyrénées	46	3	20	208	Montvalent	302	13	315
73	Midi-Pyrénées	46	3	22	209	Nadaillac-de-Rouge	190	0	190
73	Midi-Pyrénées	46	1	16	210	Nadillac	74	3	77
73	Midi-Pyrénées	46	1	06	211	Nuzéjouls	335	10	345
73	Midi-Pyrénées	46	1	16	212	Orniac	86	0	86
73	Midi-Pyrénées	46	3	11	213	Padirac	189	6	195
73	Midi-Pyrénées	46	1	19	214	Parnac	390	15	405
73	Midi-Pyrénées	46	3	22	215	Payrac	653	22	675
73	Midi-Pyrénées	46	3	10	216	Payrignac	696	18	714
73	Midi-Pyrénées	46	1	05	217	Pern	477	60	537
73	Midi-Pyrénées	46	1	23	218	Pescadoires	135	1	136
73	Midi-Pyrénées	46	3	25	219	Peyrilles	366	12	378
73	Midi-Pyrénées	46	3	28	220	Pinsac	742	8	750
73	Midi-Pyrénées	46	2	09	221	Planioles	488	25	513
73	Midi-Pyrénées	46	1	07	222	Pomarède	186	12	198
73	Midi-Pyrénées	46	1	06	223	Pontcirq	158	3	161
73	Midi-Pyrénées	46	1	31	224	Pradines	3490	137	3627
73	Midi-Pyrénées	46	1	23	225	Prayssac	2469	102	2571
73	Midi-Pyrénées	46	2	08	226	Prendeignes	214	7	221
73	Midi-Pyrénées	46	1	17	227	Promilhanes	214	2	216
73	Midi-Pyrénées	46	2	01	228	Prudhomat	716	17	733
73	Midi-Pyrénées	46	1	23	231	Puy-l;Évêque	2106	45	2151
73	Midi-Pyrénées	46	2	01	229	Puybrun	904	25	929
73	Midi-Pyrénées	46	2	04	230	Puyjourdes	70	2	72
73	Midi-Pyrénées	46	3	29	232	Les Quatre-Routes-du-Lot	672	9	681
73	Midi-Pyrénées	46	2	18	233	Quissac	117	2	119
73	Midi-Pyrénées	46	3	27	234	Rampoux	101	4	105
73	Midi-Pyrénées	46	2	18	235	Reilhac	172	7	179
73	Midi-Pyrénées	46	3	22	236	Reilhaguet	120	2	122
73	Midi-Pyrénées	46	2	18	237	Reyrevignes	296	2	298
73	Midi-Pyrénées	46	3	11	238	Rignac	267	16	283
73	Midi-Pyrénées	46	3	22	239	Le Roc	230	2	232
73	Midi-Pyrénées	46	3	11	240	Rocamadour	675	18	693
73	Midi-Pyrénées	46	3	10	241	Rouffilhac	161	12	173
73	Midi-Pyrénées	46	2	13	242	Rudelle	191	6	197
73	Midi-Pyrénées	46	2	13	243	Rueyres	230	3	233
73	Midi-Pyrénées	46	2	15	244	Sabadel-Latronquière	87	4	91
73	Midi-Pyrénées	46	1	16	245	Sabadel-Lauzès	92	1	93
73	Midi-Pyrénées	46	2	24	246	Saignes	74	1	75
73	Midi-Pyrénées	46	1	17	247	Saillac	143	9	152
73	Midi-Pyrénées	46	2	13	249	Saint-Bressou	118	6	124
73	Midi-Pyrénées	46	1	07	250	Saint-Caprais	80	1	81
73	Midi-Pyrénées	46	2	24	251	Saint-Céré	3545	150	3695
73	Midi-Pyrénées	46	1	16	252	Saint-Cernin	194	5	199
73	Midi-Pyrénées	46	3	25	253	Saint-Chamarand	206	7	213
73	Midi-Pyrénées	46	2	04	254	Saint-Chels	158	3	161
73	Midi-Pyrénées	46	2	15	255	Saint-Cirgues	379	12	391
73	Midi-Pyrénées	46	1	26	256	Saint-Cirq-Lapopie	217	5	222
73	Midi-Pyrénées	46	3	10	257	Saint-Cirq-Madelon	145	4	149
73	Midi-Pyrénées	46	3	10	258	Saint-Cirq-Souillaguet	146	1	147
73	Midi-Pyrénées	46	3	10	259	Saint-Clair	144	2	146
73	Midi-Pyrénées	46	1	21	262	Saint-Cyprien	308	5	313
73	Midi-Pyrénées	46	1	21	263	Saint-Daunès	216	2	218
73	Midi-Pyrénées	46	1	06	264	Saint-Denis-Catus	205	4	209
73	Midi-Pyrénées	46	3	20	265	Saint-Denis-lès-Martel	355	12	367
73	Midi-Pyrénées	46	2	08	266	Saint-Félix	475	15	490
73	Midi-Pyrénées	46	3	25	267	Saint-Germain-du-Bel-Air	528	17	545
73	Midi-Pyrénées	46	1	26	268	Saint-Géry	458	9	467
73	Midi-Pyrénées	46	2	15	269	Saint-Hilaire	76	3	79
73	Midi-Pyrénées	46	2	04	270	Saint-Jean-de-Laur	208	6	214
73	Midi-Pyrénées	46	2	24	339	Saint-Jean-Lagineste	318	9	327
73	Midi-Pyrénées	46	2	24	271	Saint-Jean-Lespinasse	434	26	460
73	Midi-Pyrénées	46	2	08	272	Saint-Jean-Mirabel	236	3	239
73	Midi-Pyrénées	46	2	24	273	Saint-Laurent-les-Tours	913	36	949
73	Midi-Pyrénées	46	1	21	274	Saint-Laurent-Lolmie	195	3	198
73	Midi-Pyrénées	46	1	16	275	Saint-Martin-de-Vers	122	6	128
73	Midi-Pyrénées	46	1	17	276	Saint-Martin-Labouval	178	4	182
73	Midi-Pyrénées	46	1	23	277	Saint-Martin-le-Redon	209	1	210
73	Midi-Pyrénées	46	1	21	278	Saint-Matré	117	1	118
73	Midi-Pyrénées	46	2	13	279	Saint-Maurice-en-Quercy	230	6	236
73	Midi-Pyrénées	46	1	06	280	Saint-Médard	164	3	167
73	Midi-Pyrénées	46	2	24	281	Saint-Médard-de-Presque	200	12	212
73	Midi-Pyrénées	46	2	15	282	Saint-Médard-Nicourby	88	0	88
73	Midi-Pyrénées	46	3	29	283	Saint-Michel-de-Bannières	303	7	310
73	Midi-Pyrénées	46	2	01	284	Saint-Michel-Loubéjou	383	17	400
73	Midi-Pyrénées	46	1	21	285	Saint-Pantaléon	246	3	249
73	Midi-Pyrénées	46	1	05	287	Saint-Paul-de-Loubressac	562	9	571
73	Midi-Pyrénées	46	2	24	286	Saint-Paul-de-Vern	194	2	196
73	Midi-Pyrénées	46	2	08	288	Saint-Perdoux	199	9	208
73	Midi-Pyrénées	46	1	06	340	Saint-Pierre-Lafeuille	355	4	359
73	Midi-Pyrénées	46	2	04	289	Saint-Pierre-Toirac	149	0	149
73	Midi-Pyrénées	46	3	10	290	Saint-Projet	397	9	406
73	Midi-Pyrénées	46	3	12	291	Saint-Sauveur-la-Vallée	47	1	48
73	Midi-Pyrénées	46	2	18	292	Saint-Simon	160	0	160
73	Midi-Pyrénées	46	3	28	293	Saint-Sozy	503	18	521
73	Midi-Pyrénées	46	2	04	294	Saint-Sulpice	132	6	138
73	Midi-Pyrénées	46	2	24	295	Saint-Vincent-du-Pendit	164	10	174
73	Midi-Pyrénées	46	1	19	296	Saint-Vincent-Rive-d;Olt	491	9	500
73	Midi-Pyrénées	46	1	05	248	Sainte-Alauzie	137	2	139
73	Midi-Pyrénées	46	2	13	260	Sainte-Colombe	191	3	194
73	Midi-Pyrénées	46	1	21	261	Sainte-Croix	85	1	86
73	Midi-Pyrénées	46	3	27	297	Salviac	1263	20	1283
73	Midi-Pyrénées	46	3	20	298	Sarrazac	571	12	583
73	Midi-Pyrénées	46	1	16	299	Sauliac-sur-Célé	110	3	113
73	Midi-Pyrénées	46	1	21	300	Saux	121	9	130
73	Midi-Pyrénées	46	1	19	301	Sauzet	516	20	536
73	Midi-Pyrénées	46	2	15	302	Sénaillac-Latronquière	141	4	145
73	Midi-Pyrénées	46	1	16	303	Sénaillac-Lauzès	133	4	137
73	Midi-Pyrénées	46	3	12	304	Séniergues	133	3	136
73	Midi-Pyrénées	46	1	23	305	Sérignac	302	6	308
73	Midi-Pyrénées	46	2	18	306	Sonac	79	2	81
73	Midi-Pyrénées	46	1	23	307	Soturac	661	19	680
73	Midi-Pyrénées	46	3	25	308	Soucirac	103	6	109
73	Midi-Pyrénées	46	3	28	309	Souillac	3817	403	4220
73	Midi-Pyrénées	46	3	12	310	Soulomès	120	2	122
73	Midi-Pyrénées	46	2	30	311	Sousceyrac	907	24	931
73	Midi-Pyrénées	46	3	29	312	Strenquels	273	10	283
73	Midi-Pyrénées	46	2	01	313	Tauriac	387	5	392
73	Midi-Pyrénées	46	2	15	314	Terrou	189	54	243
73	Midi-Pyrénées	46	2	01	315	Teyssieu	187	3	190
73	Midi-Pyrénées	46	3	27	316	Thédirac	310	0	310
73	Midi-Pyrénées	46	3	11	317	Thégra	496	15	511
73	Midi-Pyrénées	46	2	13	318	Thémines	222	13	235
73	Midi-Pyrénées	46	2	13	319	Théminettes	169	4	173
73	Midi-Pyrénées	46	1	26	320	Tour-de-Faure	400	3	403
73	Midi-Pyrénées	46	1	23	321	Touzac	355	6	361
73	Midi-Pyrénées	46	1	03	322	Trespoux-Rassiels	765	37	802
73	Midi-Pyrénées	46	3	25	323	Ussel	76	0	76
73	Midi-Pyrénées	46	3	25	324	Uzech	220	4	224
73	Midi-Pyrénées	46	3	12	325	Vaillac	96	2	98
73	Midi-Pyrénées	46	1	21	326	Valprionde	129	9	138
73	Midi-Pyrénées	46	1	02	327	Valroufié	425	14	439
73	Midi-Pyrénées	46	1	17	328	Varaire	306	6	312
73	Midi-Pyrénées	46	1	14	329	Vaylats	270	4	274
73	Midi-Pyrénées	46	3	29	330	Vayrac	1333	28	1361
73	Midi-Pyrénées	46	1	26	331	Vers	422	10	432
73	Midi-Pyrénées	46	2	08	332	Viazac	300	42	342
73	Midi-Pyrénées	46	1	17	333	Vidaillac	167	2	169
73	Midi-Pyrénées	46	3	10	334	Le Vigan	1476	35	1511
73	Midi-Pyrénées	46	1	19	335	Villesèque	392	11	403
73	Midi-Pyrénées	46	1	23	336	Vire-sur-Lot	380	30	410
72	Aquitaine	47	1	99	001	Agen	33981	1312	35293
72	Aquitaine	47	2	19	002	Agmé	141	2	143
72	Aquitaine	47	2	17	003	Agnac	441	18	459
72	Aquitaine	47	1	27	004	Aiguillon	4320	205	4525
72	Aquitaine	47	2	17	005	Allemans-du-Dropt	481	15	496
72	Aquitaine	47	3	30	006	Allez-et-Cazeneuve	666	24	690
72	Aquitaine	47	4	14	007	Allons	176	1	177
72	Aquitaine	47	4	10	008	Ambrus	99	3	102
72	Aquitaine	47	4	25	009	Andiran	223	13	236
72	Aquitaine	47	2	05	010	Antagnac	221	4	225
72	Aquitaine	47	3	33	011	Anthé	189	6	195
72	Aquitaine	47	4	07	012	Anzex	285	7	292
72	Aquitaine	47	2	05	013	Argenton	335	7	342
72	Aquitaine	47	2	17	014	Armillac	193	3	196
72	Aquitaine	47	1	03	015	Astaffort	2077	69	2146
72	Aquitaine	47	1	15	016	Aubiac	1014	29	1043
72	Aquitaine	47	3	26	017	Auradou	383	22	405
72	Aquitaine	47	2	11	018	Auriac-sur-Dropt	208	4	212
72	Aquitaine	47	1	02	019	Bajamont	929	50	979
72	Aquitaine	47	2	11	020	Baleyssagues	182	4	186
72	Aquitaine	47	4	18	021	Barbaste	1500	76	1576
72	Aquitaine	47	1	27	022	Bazens	530	16	546
72	Aquitaine	47	3	06	023	Beaugas	345	12	357
72	Aquitaine	47	2	38	024	Beaupuy	1480	36	1516
72	Aquitaine	47	1	04	025	Beauville	578	12	590
72	Aquitaine	47	4	07	026	Beauziac	254	4	258
72	Aquitaine	47	3	39	027	Bias	3186	135	3321
72	Aquitaine	47	2	19	028	Birac-sur-Trec	801	21	822
72	Aquitaine	47	3	13	029	Blanquefort-sur-Briolance	515	15	530
72	Aquitaine	47	1	04	030	Blaymont	226	5	231
72	Aquitaine	47	1	40	031	Boé	5421	131	5552
72	Aquitaine	47	1	40	032	Bon-Encontre	6093	166	6259
72	Aquitaine	47	3	06	033	Boudy-de-Beauregard	402	3	405
72	Aquitaine	47	2	05	034	Bouglon	613	6	619
72	Aquitaine	47	2	17	035	Bourgougnague	277	59	336
72	Aquitaine	47	3	33	036	Bourlens	357	7	364
72	Aquitaine	47	3	35	037	Bournel	261	5	266
72	Aquitaine	47	1	27	038	Bourran	591	15	606
72	Aquitaine	47	4	14	039	Boussès	42	0	42
72	Aquitaine	47	1	15	040	Brax	1827	48	1875
72	Aquitaine	47	4	18	041	Bruch	773	14	787
72	Aquitaine	47	2	08	042	Brugnac	203	7	210
72	Aquitaine	47	4	10	043	Buzet-sur-Baïse	1276	24	1300
72	Aquitaine	47	3	09	044	Cahuzac	294	6	300
72	Aquitaine	47	4	25	045	Calignac	480	16	496
72	Aquitaine	47	2	20	046	Calonges	589	15	604
72	Aquitaine	47	2	31	047	Cambes	166	1	167
72	Aquitaine	47	3	06	048	Cancon	1334	31	1365
72	Aquitaine	47	3	06	049	Casseneuil	2335	80	2415
72	Aquitaine	47	1	16	050	Cassignas	120	5	125
72	Aquitaine	47	1	29	051	Castelculier	2315	48	2363
72	Aquitaine	47	4	07	052	Casteljaloux	4761	68	4829
72	Aquitaine	47	1	16	053	Castella	334	10	344
72	Aquitaine	47	2	08	054	Castelmoron-sur-Lot	1754	46	1800
72	Aquitaine	47	2	31	056	Castelnau-sur-Gupie	827	19	846
72	Aquitaine	47	3	06	055	Castelnaud-de-Gratecambe	554	13	567
72	Aquitaine	47	3	09	057	Castillonnès	1404	34	1438
72	Aquitaine	47	4	10	058	Caubeyres	222	3	225
72	Aquitaine	47	2	31	059	Caubon-Saint-Sauveur	234	2	236
72	Aquitaine	47	1	03	060	Caudecoste	933	24	957
72	Aquitaine	47	2	20	061	Caumont-sur-Garonne	627	20	647
72	Aquitaine	47	1	04	062	Cauzac	385	10	395
72	Aquitaine	47	3	09	063	Cavarc	137	2	139
72	Aquitaine	47	3	33	064	Cazideroque	239	2	241
72	Aquitaine	47	2	32	065	Clairac	2451	196	2647
72	Aquitaine	47	1	27	066	Clermont-Dessous	797	21	818
72	Aquitaine	47	1	29	067	Clermont-Soubiran	367	12	379
72	Aquitaine	47	2	21	068	Cocumont	974	13	987
72	Aquitaine	47	1	36	069	Colayrac-Saint-Cirq	2863	109	2972
72	Aquitaine	47	3	13	070	Condezaygues	857	22	879
72	Aquitaine	47	2	08	071	Coulx	243	4	247
72	Aquitaine	47	3	33	072	Courbiac	110	1	111
72	Aquitaine	47	1	28	073	Cours	206	5	211
72	Aquitaine	47	2	21	074	Couthures-sur-Garonne	390	21	411
72	Aquitaine	47	1	16	075	La Croix-Blanche	843	25	868
72	Aquitaine	47	1	03	076	Cuq	283	6	289
72	Aquitaine	47	3	13	077	Cuzorn	878	21	899
72	Aquitaine	47	4	10	078	Damazan	1281	71	1352
72	Aquitaine	47	3	26	079	Dausse	501	5	506
72	Aquitaine	47	3	35	080	Dévillac	133	6	139
72	Aquitaine	47	3	30	081	Dolmayrac	647	14	661
72	Aquitaine	47	1	04	082	Dondas	207	3	210
72	Aquitaine	47	3	35	083	Doudrac	104	2	106
72	Aquitaine	47	3	09	084	Douzains	279	10	289
72	Aquitaine	47	4	14	085	Durance	281	5	286
72	Aquitaine	47	2	11	086	Duras	1316	21	1337
72	Aquitaine	47	1	04	087	Engayrac	144	3	147
72	Aquitaine	47	2	31	088	Escassefort	632	26	658
72	Aquitaine	47	2	11	089	Esclottes	156	4	160
72	Aquitaine	47	4	25	090	Espiens	393	7	400
72	Aquitaine	47	1	15	091	Estillac	1904	61	1965
72	Aquitaine	47	1	03	092	Fals	355	6	361
72	Aquitaine	47	4	10	093	Fargues-sur-Ourbise	366	12	378
72	Aquitaine	47	2	19	094	Fauguerolles	653	18	671
72	Aquitaine	47	2	32	095	Fauillet	859	29	888
72	Aquitaine	47	3	09	096	Ferrensac	222	11	233
72	Aquitaine	47	4	18	097	Feugarolles	926	18	944
72	Aquitaine	47	4	12	098	Fieux	339	9	348
72	Aquitaine	47	3	23	099	Fongrave	612	16	628
72	Aquitaine	47	1	36	100	Foulayronnes	5024	295	5319
72	Aquitaine	47	2	20	101	Fourques-sur-Garonne	1238	34	1272
72	Aquitaine	47	4	12	102	Francescas	695	24	719
72	Aquitaine	47	4	25	103	Fréchou	207	7	214
72	Aquitaine	47	1	27	104	Frégimont	270	1	271
72	Aquitaine	47	3	26	105	Frespech	290	6	296
72	Aquitaine	47	3	13	106	Fumel	5162	136	5298
72	Aquitaine	47	1	27	107	Galapian	326	7	333
72	Aquitaine	47	2	21	108	Gaujac	283	10	293
72	Aquitaine	47	3	24	109	Gavaudun	305	3	308
72	Aquitaine	47	2	19	110	Gontaud-de-Nogaret	1634	34	1668
72	Aquitaine	47	1	28	111	Granges-sur-Lot	580	8	588
72	Aquitaine	47	2	08	112	Grateloup-Saint-Gayrand	439	20	459
72	Aquitaine	47	1	29	113	Grayssas	127	3	130
72	Aquitaine	47	2	05	114	Grézet-Cavagnan	352	8	360
72	Aquitaine	47	2	05	115	Guérin	246	7	253
72	Aquitaine	47	3	26	117	Hautefage-la-Tour	812	20	832
72	Aquitaine	47	2	19	118	Hautesvignes	163	5	168
72	Aquitaine	47	4	14	119	Houeillès	633	16	649
72	Aquitaine	47	2	21	120	Jusix	113	4	117
72	Aquitaine	47	2	05	121	Labastide-Castel-Amouroux	321	3	324
72	Aquitaine	47	2	08	122	Labretonie	175	1	176
72	Aquitaine	47	3	24	123	Lacapelle-Biron	457	12	469
72	Aquitaine	47	3	24	124	Lacaussade	211	6	217
72	Aquitaine	47	1	28	125	Lacépède	295	6	301
72	Aquitaine	47	2	31	126	Lachapelle	87	3	90
72	Aquitaine	47	2	32	127	Lafitte-sur-Lot	791	27	818
72	Aquitaine	47	1	29	128	Lafox	1163	28	1191
72	Aquitaine	47	1	27	129	Lagarrigue	282	6	288
72	Aquitaine	47	2	20	130	Lagruère	341	5	346
72	Aquitaine	47	2	31	131	Lagupie	655	6	661
72	Aquitaine	47	3	09	132	Lalandusse	197	3	200
72	Aquitaine	47	4	12	133	Lamontjoie	501	11	512
72	Aquitaine	47	4	22	134	Lannes	409	13	422
72	Aquitaine	47	2	08	135	Laparade	445	9	454
72	Aquitaine	47	2	17	136	Laperche	133	6	139
72	Aquitaine	47	1	15	137	Laplume	1402	27	1429
72	Aquitaine	47	1	16	138	Laroque-Timbaut	1516	36	1552
72	Aquitaine	47	4	12	139	Lasserre	77	2	79
72	Aquitaine	47	1	28	140	Laugnac	633	7	640
72	Aquitaine	47	3	24	141	Laussou	278	2	280
72	Aquitaine	47	2	17	142	Lauzun	729	20	749
72	Aquitaine	47	4	18	143	Lavardac	2285	59	2344
72	Aquitaine	47	2	17	144	Lavergne	603	18	621
72	Aquitaine	47	1	03	145	Layrac	3552	135	3687
72	Aquitaine	47	3	34	146	Lédat	1260	40	1300
72	Aquitaine	47	2	31	147	Lévignac-de-Guyenne	609	18	627
72	Aquitaine	47	4	07	148	Leyritz-Moncassin	217	5	222
72	Aquitaine	47	2	19	150	Longueville	351	5	356
72	Aquitaine	47	2	11	151	Loubès-Bernac	369	7	376
72	Aquitaine	47	3	09	152	Lougratte	449	2	451
72	Aquitaine	47	1	28	154	Lusignan-Petit	370	13	383
72	Aquitaine	47	1	28	155	Madaillan	614	16	630
72	Aquitaine	47	2	21	156	Marcellus	802	27	829
72	Aquitaine	47	2	98	157	Marmande	18400	713	19113
72	Aquitaine	47	1	15	158	Marmont-Pachas	130	5	135
72	Aquitaine	47	2	20	159	Le Mas-d;Agenais	1427	19	1446
72	Aquitaine	47	3	33	160	Masquières	185	5	190
72	Aquitaine	47	3	26	161	Massels	112	1	113
72	Aquitaine	47	3	26	162	Massoulès	208	1	209
72	Aquitaine	47	2	38	163	Mauvezin-sur-Gupie	504	15	519
72	Aquitaine	47	3	35	164	Mazières-Naresse	133	5	138
72	Aquitaine	47	2	21	165	Meilhan-sur-Garonne	1327	158	1485
72	Aquitaine	47	4	22	167	Mézin	1504	45	1549
72	Aquitaine	47	2	17	168	Miramont-de-Guyenne	3276	177	3453
72	Aquitaine	47	1	15	169	Moirax	1147	33	1180
72	Aquitaine	47	3	06	170	Monbahus	629	56	685
72	Aquitaine	47	1	16	171	Monbalen	412	12	424
72	Aquitaine	47	4	25	172	Moncaut	558	15	573
72	Aquitaine	47	3	23	173	Monclar	838	19	857
72	Aquitaine	47	4	12	174	Moncrabeau	825	8	833
72	Aquitaine	47	3	24	175	Monflanquin	2373	56	2429
72	Aquitaine	47	4	18	176	Mongaillard	187	2	189
72	Aquitaine	47	4	10	177	Monheurt	223	4	227
72	Aquitaine	47	3	24	178	Monségur	379	6	385
72	Aquitaine	47	3	13	179	Monsempron-Libos	2051	55	2106
72	Aquitaine	47	4	25	180	Montagnac-sur-Auvignon	599	10	609
72	Aquitaine	47	3	24	181	Montagnac-sur-Lède	252	2	254
72	Aquitaine	47	3	23	182	Montastruc	277	8	285
72	Aquitaine	47	3	09	183	Montauriol	202	12	214
72	Aquitaine	47	3	35	184	Montaut	237	5	242
72	Aquitaine	47	3	33	185	Montayral	2876	80	2956
72	Aquitaine	47	4	18	186	Montesquieu	780	15	795
72	Aquitaine	47	2	31	187	Monteton	277	6	283
72	Aquitaine	47	2	17	188	Montignac-de-Lauzun	281	10	291
72	Aquitaine	47	2	31	189	Montignac-Toupinerie	138	1	139
72	Aquitaine	47	1	28	190	Montpezat	582	66	648
72	Aquitaine	47	2	21	191	Montpouillan	672	14	686
72	Aquitaine	47	3	06	192	Monviel	85	1	86
72	Aquitaine	47	3	06	193	Moulinet	195	9	204
72	Aquitaine	47	2	11	194	Moustier	336	12	348
72	Aquitaine	47	4	25	195	Nérac	7125	559	7684
72	Aquitaine	47	1	27	196	Nicole	273	20	293
72	Aquitaine	47	4	12	197	Nomdieu	221	11	232
72	Aquitaine	47	3	06	198	Pailloles	338	4	342
72	Aquitaine	47	2	11	199	Pardaillan	331	4	335
72	Aquitaine	47	3	35	200	Parranquet	123	3	126
72	Aquitaine	47	1	37	201	Le Passage	9395	234	9629
72	Aquitaine	47	3	24	202	Paulhiac	318	9	327
72	Aquitaine	47	3	26	203	Penne-d;Agenais	2402	73	2475
72	Aquitaine	47	2	17	204	Peyrière	279	3	282
72	Aquitaine	47	4	14	205	Pindères	231	4	235
72	Aquitaine	47	3	23	206	Pinel-Hauterive	525	19	544
72	Aquitaine	47	4	18	207	Pompiey	227	4	231
72	Aquitaine	47	4	14	208	Pompogne	194	4	198
72	Aquitaine	47	1	02	209	Pont-du-Casse	4351	156	4507
72	Aquitaine	47	1	27	210	Port-Sainte-Marie	1963	35	1998
72	Aquitaine	47	4	22	211	Poudenas	247	3	250
72	Aquitaine	47	2	05	212	Poussignac	294	4	298
72	Aquitaine	47	1	28	213	Prayssas	948	35	983
72	Aquitaine	47	4	10	214	Puch-d;Agenais	719	5	724
72	Aquitaine	47	3	39	215	Pujols	3626	160	3786
72	Aquitaine	47	2	31	216	Puymiclan	570	27	597
72	Aquitaine	47	1	29	217	Puymirol	965	10	975
72	Aquitaine	47	2	17	218	Puysserampion	246	1	247
72	Aquitaine	47	3	35	219	Rayet	168	2	170
72	Aquitaine	47	4	10	220	Razimet	243	10	253
72	Aquitaine	47	4	22	221	Réaup-Lisse	587	19	606
72	Aquitaine	47	4	07	222	La Réunion	457	5	462
72	Aquitaine	47	3	35	223	Rives	240	1	241
72	Aquitaine	47	2	05	224	Romestaing	147	4	151
72	Aquitaine	47	1	15	225	Roquefort	1767	40	1807
72	Aquitaine	47	2	17	226	Roumagne	553	17	570
72	Aquitaine	47	2	05	227	Ruffiac	176	4	180
72	Aquitaine	47	3	39	228	Saint-Antoine-de-Ficalba	674	17	691
72	Aquitaine	47	2	11	229	Saint-Astier	198	2	200
72	Aquitaine	47	3	24	230	Saint-Aubin	429	7	436
72	Aquitaine	47	2	31	231	Saint-Avit	167	1	168
72	Aquitaine	47	2	31	232	Saint-Barthélemy-d;Agenais	517	14	531
72	Aquitaine	47	1	29	234	Saint-Caprais-de-Lerm	602	16	618
72	Aquitaine	47	2	17	235	Saint-Colomb-de-Lauzun	502	23	525
72	Aquitaine	47	3	23	239	Saint-Étienne-de-Fougères	843	23	866
72	Aquitaine	47	3	35	240	Saint-Étienne-de-Villeréal	292	11	303
72	Aquitaine	47	3	35	241	Saint-Eutrope-de-Born	694	19	713
72	Aquitaine	47	3	13	242	Saint-Front-sur-Lémance	562	14	576
72	Aquitaine	47	3	33	328	Saint-Georges	533	14	547
72	Aquitaine	47	2	31	245	Saint-Géraud	80	0	80
72	Aquitaine	47	1	36	246	Saint-Hilaire-de-Lusignan	1404	34	1438
72	Aquitaine	47	2	11	247	Saint-Jean-de-Duras	243	7	250
72	Aquitaine	47	1	29	248	Saint-Jean-de-Thurac	502	6	508
72	Aquitaine	47	4	18	249	Saint-Laurent	486	8	494
72	Aquitaine	47	4	10	250	Saint-Léger	169	3	172
72	Aquitaine	47	4	10	251	Saint-Léon	298	9	307
72	Aquitaine	47	4	07	254	Saint-Martin-Curton	298	11	309
72	Aquitaine	47	1	04	255	Saint-Martin-de-Beauville	173	5	178
72	Aquitaine	47	3	35	256	Saint-Martin-de-Villeréal	126	4	130
72	Aquitaine	47	2	38	257	Saint-Martin-Petit	433	16	449
72	Aquitaine	47	3	06	259	Saint-Maurice-de-Lestapel	112	4	116
72	Aquitaine	47	1	04	260	Saint-Maurin	465	11	476
72	Aquitaine	47	1	03	262	Saint-Nicolas-de-la-Balerme	397	10	407
72	Aquitaine	47	2	19	263	Saint-Pardoux-du-Breuil	591	38	629
72	Aquitaine	47	2	17	264	Saint-Pardoux-Isaac	1183	26	1209
72	Aquitaine	47	3	23	265	Saint-Pastour	393	15	408
72	Aquitaine	47	4	22	266	Saint-Pé-Saint-Simon	222	1	223
72	Aquitaine	47	4	10	267	Saint-Pierre-de-Buzet	270	4	274
72	Aquitaine	47	1	29	269	Saint-Pierre-de-Clairac	831	20	851
72	Aquitaine	47	2	31	271	Saint-Pierre-sur-Dropt	278	21	299
72	Aquitaine	47	3	09	272	Saint-Quentin-du-Dropt	174	9	183
72	Aquitaine	47	1	16	273	Saint-Robert	188	6	194
72	Aquitaine	47	1	29	274	Saint-Romain-le-Noble	394	12	406
72	Aquitaine	47	1	27	275	Saint-Salvy	176	0	176
72	Aquitaine	47	1	28	276	Saint-Sardos	334	14	348
72	Aquitaine	47	2	21	277	Saint-Sauveur-de-Meilhan	314	8	322
72	Aquitaine	47	2	11	278	Saint-Sernin	429	9	438
72	Aquitaine	47	1	03	279	Saint-Sixte	329	1	330
72	Aquitaine	47	3	26	280	Saint-Sylvestre-sur-Lot	2269	66	2335
72	Aquitaine	47	1	29	281	Saint-Urcisse	230	10	240
72	Aquitaine	47	4	12	282	Saint-Vincent-de-Lamontjoie	257	6	263
72	Aquitaine	47	3	33	283	Saint-Vite	1219	31	1250
72	Aquitaine	47	2	38	233	Sainte-Bazeille	3044	171	3215
72	Aquitaine	47	2	11	236	Sainte-Colombe-de-Duras	99	5	104
72	Aquitaine	47	3	39	237	Sainte-Colombe-de-Villeneuve	452	9	461
72	Aquitaine	47	1	15	238	Sainte-Colombe-en-Bruilhois	1656	46	1702
72	Aquitaine	47	2	05	244	Sainte-Gemme-Martaillac	343	9	352
72	Aquitaine	47	3	30	252	Sainte-Livrade-sur-Lot	6290	213	6503
72	Aquitaine	47	2	20	253	Sainte-Marthe	498	11	509
72	Aquitaine	47	4	22	258	Sainte-Maure-de-Peyriac	337	11	348
72	Aquitaine	47	3	24	284	Salles	318	8	326
72	Aquitaine	47	2	20	285	Samazan	852	23	875
72	Aquitaine	47	4	14	286	Sauméjan	80	1	81
72	Aquitaine	47	4	25	287	Saumont	235	2	237
72	Aquitaine	47	1	16	288	Sauvagnas	471	5	476
72	Aquitaine	47	1	16	289	La Sauvetat-de-Savères	527	5	532
72	Aquitaine	47	2	11	290	La Sauvetat-du-Dropt	566	18	584
72	Aquitaine	47	3	24	291	La Sauvetat-sur-Lède	646	22	668
72	Aquitaine	47	3	13	292	Sauveterre-la-Lémance	586	10	596
72	Aquitaine	47	1	03	293	Sauveterre-Saint-Denis	450	23	473
72	Aquitaine	47	2	11	294	Savignac-de-Duras	227	7	234
72	Aquitaine	47	3	24	295	Savignac-sur-Leyze	279	9	288
72	Aquitaine	47	2	17	296	Ségalas	167	1	168
72	Aquitaine	47	3	39	297	Sembas	134	3	137
72	Aquitaine	47	2	20	298	Sénestis	201	3	204
72	Aquitaine	47	3	09	299	Sérignac-Péboudou	175	3	178
72	Aquitaine	47	1	15	300	Sérignac-sur-Garonne	1122	21	1143
72	Aquitaine	47	2	31	301	Seyches	1017	44	1061
72	Aquitaine	47	4	22	302	Sos	713	16	729
72	Aquitaine	47	2	11	303	Soumensac	244	3	247
72	Aquitaine	47	2	19	304	Taillebourg	85	7	92
72	Aquitaine	47	1	04	305	Tayrac	329	4	333
72	Aquitaine	47	3	30	306	Le Temple-sur-Lot	971	36	1007
72	Aquitaine	47	3	33	307	Thézac	196	9	205
72	Aquitaine	47	4	18	308	Thouars-sur-Garonne	210	3	213
72	Aquitaine	47	3	23	309	Tombeboeuf	453	5	458
72	Aquitaine	47	2	32	310	Tonneins	8965	295	9260
72	Aquitaine	47	3	35	311	Tourliac	146	5	151
72	Aquitaine	47	3	33	312	Tournon-d;Agenais	771	18	789
72	Aquitaine	47	3	23	313	Tourtrès	142	2	144
72	Aquitaine	47	3	26	314	Trémons	377	9	386
72	Aquitaine	47	3	26	315	Trentels	820	27	847
72	Aquitaine	47	2	32	316	Varès	647	15	662
72	Aquitaine	47	2	08	317	Verteuil-d;Agenais	558	13	571
72	Aquitaine	47	4	18	318	Vianne	1128	25	1153
72	Aquitaine	47	3	23	319	Villebramar	103	5	108
72	Aquitaine	47	4	07	320	Villefranche-du-Queyran	405	8	413
72	Aquitaine	47	2	11	321	Villeneuve-de-Duras	317	3	320
72	Aquitaine	47	3	97	323	Villeneuve-sur-Lot	23513	1187	24700
72	Aquitaine	47	3	35	324	Villeréal	1314	82	1396
72	Aquitaine	47	2	20	325	Villeton	527	14	541
72	Aquitaine	47	2	19	326	Virazeil	1669	50	1719
72	Aquitaine	47	4	18	327	Xaintrailles	413	2	415
91	Languedoc-Roussillon	48	2	08	001	Albaret-le-Comtal	194	6	200
91	Languedoc-Roussillon	48	2	20	002	Albaret-Sainte-Marie	564	17	581
91	Languedoc-Roussillon	48	2	03	003	Allenc	253	4	257
91	Languedoc-Roussillon	48	2	24	004	Altier	207	8	215
91	Languedoc-Roussillon	48	2	12	005	Antrenas	325	16	341
91	Languedoc-Roussillon	48	2	08	007	Arzenc-d;Apcher	49	2	51
91	Languedoc-Roussillon	48	2	06	008	Arzenc-de-Randon	201	5	206
91	Languedoc-Roussillon	48	2	01	009	Aumont-Aubrac	1111	35	1146
91	Languedoc-Roussillon	48	2	10	010	Auroux	420	10	430
91	Languedoc-Roussillon	48	2	14	013	Badaroux	907	26	933
91	Languedoc-Roussillon	48	2	03	014	Bagnols-les-Bains	238	7	245
91	Languedoc-Roussillon	48	2	25	016	Balsièges	517	27	544
91	Languedoc-Roussillon	48	2	04	017	Banassac	866	29	895
91	Languedoc-Roussillon	48	2	05	018	Barjac	660	14	674
91	Languedoc-Roussillon	48	1	02	019	Barre-des-Cévennes	204	4	208
91	Languedoc-Roussillon	48	1	02	020	Bassurels	43	2	45
91	Languedoc-Roussillon	48	2	24	021	La Bastide-Puylaurent	172	7	179
91	Languedoc-Roussillon	48	1	07	022	Bédouès	289	11	300
91	Languedoc-Roussillon	48	2	03	023	Belvezet	92	2	94
91	Languedoc-Roussillon	48	2	20	025	Les Bessons	449	16	465
91	Languedoc-Roussillon	48	2	20	026	Blavignac	236	7	243
91	Languedoc-Roussillon	48	2	03	027	Le Bleymard	356	32	388
91	Languedoc-Roussillon	48	1	07	028	Les Bondons	142	2	144
91	Languedoc-Roussillon	48	2	14	029	Le Born	150	3	153
91	Languedoc-Roussillon	48	2	25	030	Brenoux	361	13	374
91	Languedoc-Roussillon	48	2	08	031	Brion	98	2	100
91	Languedoc-Roussillon	48	2	12	032	Le Buisson	225	10	235
91	Languedoc-Roussillon	48	2	04	033	Canilhac	139	7	146
91	Languedoc-Roussillon	48	2	04	034	La Canourgue	2120	92	2212
91	Languedoc-Roussillon	48	1	02	036	Cassagnas	118	4	122
91	Languedoc-Roussillon	48	2	03	037	Chadenet	120	2	122
91	Languedoc-Roussillon	48	2	09	038	Chambon-le-Château	292	10	302
91	Languedoc-Roussillon	48	2	05	039	Chanac	1399	50	1449
91	Languedoc-Roussillon	48	2	03	040	Chasseradès	158	1	159
91	Languedoc-Roussillon	48	2	10	041	Chastanier	92	1	93
91	Languedoc-Roussillon	48	2	14	042	Chastel-Nouvel	736	30	766
91	Languedoc-Roussillon	48	2	06	043	Châteauneuf-de-Randon	531	32	563
91	Languedoc-Roussillon	48	2	08	044	Chauchailles	97	3	100
91	Languedoc-Roussillon	48	2	06	045	Chaudeyrac	308	4	312
91	Languedoc-Roussillon	48	2	11	046	Chaulhac	72	2	74
91	Languedoc-Roussillon	48	2	01	047	La Chaze-de-Peyre	269	9	278
91	Languedoc-Roussillon	48	2	10	048	Cheylard-l;Évêque	63	2	65
91	Languedoc-Roussillon	48	2	23	049	Chirac	1172	35	1207
91	Languedoc-Roussillon	48	1	07	050	Cocurès	196	4	200
91	Languedoc-Roussillon	48	1	22	051	Le Collet-de-Dèze	668	24	692
91	Languedoc-Roussillon	48	2	03	053	Cubières	175	7	182
91	Languedoc-Roussillon	48	2	03	054	Cubiérettes	54	0	54
91	Languedoc-Roussillon	48	2	05	055	Cultures	133	5	138
91	Languedoc-Roussillon	48	2	05	056	Esclanèdes	319	12	331
91	Languedoc-Roussillon	48	2	19	057	Estables	174	4	178
91	Languedoc-Roussillon	48	2	08	058	La Fage-Montivernoux	168	2	170
91	Languedoc-Roussillon	48	2	20	059	La Fage-Saint-Julien	284	8	292
91	Languedoc-Roussillon	48	2	01	060	Fau-de-Peyre	182	5	187
91	Languedoc-Roussillon	48	1	07	061	Florac	1942	69	2011
91	Languedoc-Roussillon	48	2	10	062	Fontanes	118	7	125
91	Languedoc-Roussillon	48	2	18	063	Fontans	212	5	217
91	Languedoc-Roussillon	48	2	08	064	Fournels	368	8	376
91	Languedoc-Roussillon	48	1	15	065	Fraissinet-de-Fourques	63	1	64
91	Languedoc-Roussillon	48	1	17	066	Fraissinet-de-Lozère	226	5	231
91	Languedoc-Roussillon	48	1	02	067	Gabriac	109	5	114
91	Languedoc-Roussillon	48	2	12	068	Gabrias	138	10	148
91	Languedoc-Roussillon	48	1	15	069	Gatuzières	42	1	43
91	Languedoc-Roussillon	48	2	09	070	Grandrieu	760	25	785
91	Languedoc-Roussillon	48	2	16	071	Grandvals	83	3	86
91	Languedoc-Roussillon	48	2	12	072	Grèzes	225	10	235
91	Languedoc-Roussillon	48	2	23	073	Les Hermaux	115	4	119
91	Languedoc-Roussillon	48	1	15	074	Hures-la-Parade	234	9	243
91	Languedoc-Roussillon	48	1	07	075	Ispagnac	856	15	871
91	Languedoc-Roussillon	48	2	01	076	Javols	331	19	350
91	Languedoc-Roussillon	48	2	11	077	Julianges	73	0	73
91	Languedoc-Roussillon	48	2	19	078	Lachamp	177	1	178
91	Languedoc-Roussillon	48	2	18	079	Lajo	108	3	111
91	Languedoc-Roussillon	48	2	10	080	Langogne	3014	221	3235
91	Languedoc-Roussillon	48	2	25	081	Lanuéjols	317	10	327
91	Languedoc-Roussillon	48	2	06	082	Laubert	102	9	111
91	Languedoc-Roussillon	48	2	19	083	Les Laubies	171	1	172
91	Languedoc-Roussillon	48	2	09	084	Laval-Atger	166	1	167
91	Languedoc-Roussillon	48	2	04	085	Laval-du-Tarn	108	3	111
91	Languedoc-Roussillon	48	2	10	086	Luc	227	5	232
91	Languedoc-Roussillon	48	2	16	087	Malbouzon	146	3	149
91	Languedoc-Roussillon	48	1	21	088	La Malène	166	3	169
91	Languedoc-Roussillon	48	2	11	089	Le Malzieu-Forain	470	16	486
91	Languedoc-Roussillon	48	2	11	090	Le Malzieu-Ville	881	28	909
91	Languedoc-Roussillon	48	2	16	091	Marchastel	77	1	78
91	Languedoc-Roussillon	48	2	12	092	Marvejols	5053	304	5357
91	Languedoc-Roussillon	48	2	03	093	Mas-d;Orcières	124	1	125
91	Languedoc-Roussillon	48	1	21	141	Mas-Saint-Chély	140	5	145
91	Languedoc-Roussillon	48	1	13	094	Le Massegros	350	8	358
91	Languedoc-Roussillon	48	2	99	095	Mende	12140	1073	13213
91	Languedoc-Roussillon	48	1	15	096	Meyrueis	825	148	973
91	Languedoc-Roussillon	48	1	22	097	Moissac-Vallée-Française	223	5	228
91	Languedoc-Roussillon	48	1	02	098	Molezon	90	6	96
91	Languedoc-Roussillon	48	2	23	099	Le Monastier-Pin-Moriès	904	25	929
91	Languedoc-Roussillon	48	2	06	100	Montbel	132	2	134
91	Languedoc-Roussillon	48	1	21	101	Montbrun	86	3	89
91	Languedoc-Roussillon	48	2	12	103	Montrodat	1134	64	1198
91	Languedoc-Roussillon	48	2	20	012	Les Monts-Verts	341	11	352
91	Languedoc-Roussillon	48	2	16	104	Nasbinals	500	14	514
91	Languedoc-Roussillon	48	2	10	105	Naussac	205	12	217
91	Languedoc-Roussillon	48	2	08	106	Noalhac	98	1	99
91	Languedoc-Roussillon	48	2	12	107	Palhers	200	5	205
91	Languedoc-Roussillon	48	2	09	108	La Panouse	77	6	83
91	Languedoc-Roussillon	48	2	11	110	Paulhac-en-Margeride	105	2	107
91	Languedoc-Roussillon	48	2	14	111	Pelouse	225	6	231
91	Languedoc-Roussillon	48	2	24	015	Pied-de-Borne	217	5	222
91	Languedoc-Roussillon	48	2	06	112	Pierrefiche	164	5	169
91	Languedoc-Roussillon	48	1	02	115	Le Pompidou	183	12	195
91	Languedoc-Roussillon	48	1	17	116	Le Pont-de-Montvert	276	14	290
91	Languedoc-Roussillon	48	2	24	117	Pourcharesses	121	11	132
91	Languedoc-Roussillon	48	2	24	119	Prévenchères	260	11	271
91	Languedoc-Roussillon	48	2	16	120	Prinsuéjols	158	1	159
91	Languedoc-Roussillon	48	2	11	121	Prunières	253	5	258
91	Languedoc-Roussillon	48	1	21	122	Quézac	348	8	356
91	Languedoc-Roussillon	48	2	16	123	Recoules-d;Aubrac	241	3	244
91	Languedoc-Roussillon	48	2	12	124	Recoules-de-Fumas	95	1	96
91	Languedoc-Roussillon	48	1	13	125	Le Recoux	125	3	128
91	Languedoc-Roussillon	48	2	19	126	Ribennes	166	6	172
91	Languedoc-Roussillon	48	2	19	127	Rieutort-de-Randon	756	13	769
91	Languedoc-Roussillon	48	2	20	128	Rimeize	605	18	623
91	Languedoc-Roussillon	48	2	10	129	Rocles	216	7	223
91	Languedoc-Roussillon	48	1	07	130	Rousses	102	3	105
91	Languedoc-Roussillon	48	1	15	131	Le Rozier	150	1	151
91	Languedoc-Roussillon	48	2	18	132	Saint-Alban-sur-Limagnole	1505	57	1562
91	Languedoc-Roussillon	48	2	19	133	Saint-Amans	147	1	148
91	Languedoc-Roussillon	48	1	17	134	Saint-Andéol-de-Clerguemort	103	1	104
91	Languedoc-Roussillon	48	2	24	135	Saint-André-Capcèze	168	2	170
91	Languedoc-Roussillon	48	1	22	136	Saint-André-de-Lancize	126	2	128
91	Languedoc-Roussillon	48	2	25	137	Saint-Bauzile	609	23	632
91	Languedoc-Roussillon	48	2	12	138	Saint-Bonnet-de-Chirac	53	2	55
91	Languedoc-Roussillon	48	2	09	139	Saint-Bonnet-de-Montauroux	124	4	128
91	Languedoc-Roussillon	48	2	20	140	Saint-Chély-d;Apcher	4323	690	5013
91	Languedoc-Roussillon	48	2	19	145	Saint-Denis-en-Margeride	182	1	183
91	Languedoc-Roussillon	48	2	25	147	Saint-Étienne-du-Valdonnez	638	36	674
91	Languedoc-Roussillon	48	1	22	148	Saint-Étienne-Vallée-Française	534	40	574
91	Languedoc-Roussillon	48	2	10	150	Saint-Flour-de-Mercoire	184	1	185
91	Languedoc-Roussillon	48	2	03	151	Saint-Frézal-d;Albuges	53	2	55
91	Languedoc-Roussillon	48	1	17	152	Saint-Frézal-de-Ventalon	158	4	162
91	Languedoc-Roussillon	48	2	19	153	Saint-Gal	111	2	113
91	Languedoc-Roussillon	48	1	13	154	Saint-Georges-de-Lévéjac	259	5	264
91	Languedoc-Roussillon	48	1	22	155	Saint-Germain-de-Calberte	455	11	466
91	Languedoc-Roussillon	48	2	23	156	Saint-Germain-du-Teil	798	15	813
91	Languedoc-Roussillon	48	1	22	158	Saint-Hilaire-de-Lavit	108	4	112
91	Languedoc-Roussillon	48	2	06	160	Saint-Jean-la-Fouillouse	166	2	168
91	Languedoc-Roussillon	48	2	08	161	Saint-Juéry	67	0	67
91	Languedoc-Roussillon	48	1	02	162	Saint-Julien-d;Arpaon	119	2	121
91	Languedoc-Roussillon	48	1	22	163	Saint-Julien-des-Points	111	2	113
91	Languedoc-Roussillon	48	2	03	164	Saint-Julien-du-Tournel	110	5	115
91	Languedoc-Roussillon	48	2	12	165	Saint-Laurent-de-Muret	177	8	185
91	Languedoc-Roussillon	48	1	07	166	Saint-Laurent-de-Trèves	179	0	179
91	Languedoc-Roussillon	48	2	08	167	Saint-Laurent-de-Veyrès	43	0	43
91	Languedoc-Roussillon	48	2	12	168	Saint-Léger-de-Peyre	169	6	175
91	Languedoc-Roussillon	48	2	11	169	Saint-Léger-du-Malzieu	207	8	215
91	Languedoc-Roussillon	48	1	22	170	Saint-Martin-de-Boubaux	172	7	179
91	Languedoc-Roussillon	48	1	22	171	Saint-Martin-de-Lansuscle	186	3	189
91	Languedoc-Roussillon	48	1	17	172	Saint-Maurice-de-Ventalon	75	3	78
91	Languedoc-Roussillon	48	1	22	173	Saint-Michel-de-Dèze	209	1	210
91	Languedoc-Roussillon	48	2	09	174	Saint-Paul-le-Froid	146	2	148
91	Languedoc-Roussillon	48	2	23	175	Saint-Pierre-de-Nogaret	164	2	166
91	Languedoc-Roussillon	48	1	15	176	Saint-Pierre-des-Tripiers	77	4	81
91	Languedoc-Roussillon	48	2	11	177	Saint-Pierre-le-Vieux	286	12	298
91	Languedoc-Roussillon	48	1	22	178	Saint-Privat-de-Vallongue	272	5	277
91	Languedoc-Roussillon	48	2	11	179	Saint-Privat-du-Fau	133	5	138
91	Languedoc-Roussillon	48	1	13	180	Saint-Rome-de-Dolan	80	5	85
91	Languedoc-Roussillon	48	2	04	181	Saint-Saturnin	63	6	69
91	Languedoc-Roussillon	48	2	06	182	Saint-Sauveur-de-Ginestoux	62	5	67
91	Languedoc-Roussillon	48	2	01	183	Saint-Sauveur-de-Peyre	276	9	285
91	Languedoc-Roussillon	48	2	09	184	Saint-Symphorien	249	4	253
91	Languedoc-Roussillon	48	2	01	142	Sainte-Colombe-de-Peyre	199	6	205
91	Languedoc-Roussillon	48	1	02	144	Sainte-Croix-Vallée-Française	319	20	339
91	Languedoc-Roussillon	48	1	21	146	Sainte-Enimie	527	27	554
91	Languedoc-Roussillon	48	2	18	149	Sainte-Eulalie	46	1	47
91	Languedoc-Roussillon	48	2	03	157	Sainte-Hélène	71	4	75
91	Languedoc-Roussillon	48	2	23	187	Les Salces	95	4	99
91	Languedoc-Roussillon	48	2	05	185	Les Salelles	150	5	155
91	Languedoc-Roussillon	48	1	07	186	La Salle-Prunet	179	1	180
91	Languedoc-Roussillon	48	2	18	188	Serverette	284	3	287
91	Languedoc-Roussillon	48	2	19	189	Servières	182	1	183
91	Languedoc-Roussillon	48	2	08	190	Termes	217	5	222
91	Languedoc-Roussillon	48	2	04	191	La Tieule	106	6	112
91	Languedoc-Roussillon	48	2	23	192	Trélans	101	4	105
91	Languedoc-Roussillon	48	1	07	193	Vebron	201	8	209
91	Languedoc-Roussillon	48	1	17	194	Vialas	433	63	496
91	Languedoc-Roussillon	48	1	13	195	Les Vignes	107	3	110
91	Languedoc-Roussillon	48	2	19	197	La Villedieu	40	0	40
91	Languedoc-Roussillon	48	2	24	198	Villefort	608	28	636
52	Pays de la Loire	49	1	32	001	Les Alleuds	890	18	908
52	Pays de la Loire	49	3	27	002	Allonnes	3013	111	3124
52	Pays de la Loire	49	3	15	003	Ambillou-Château	958	25	983
52	Pays de la Loire	49	1	36	004	Andard	2504	60	2564
52	Pays de la Loire	49	4	16	005	Andigné	357	4	361
52	Pays de la Loire	49	2	06	006	Andrezé	1830	55	1885
52	Pays de la Loire	49	1	98	007	Angers	147571	4386	151957
52	Pays de la Loire	49	4	07	008	Angrie	951	14	965
52	Pays de la Loire	49	3	20	009	Antoigné	485	6	491
52	Pays de la Loire	49	4	24	010	Armaillé	284	9	293
52	Pays de la Loire	49	3	29	011	Artannes-sur-Thouet	434	18	452
52	Pays de la Loire	49	3	34	012	Aubigné-sur-Layon	359	13	372
52	Pays de la Loire	49	3	22	013	Auverse	450	12	462
52	Pays de la Loire	49	4	30	014	Aviré	454	21	475
52	Pays de la Loire	49	1	41	015	Avrillé	12639	312	12951
52	Pays de la Loire	49	1	14	017	Baracé	471	7	478
52	Pays de la Loire	49	3	04	018	Baugé	3681	98	3779
52	Pays de la Loire	49	1	31	019	Bauné	1596	52	1648
52	Pays de la Loire	49	1	38	020	Beaucouzé	4938	128	5066
52	Pays de la Loire	49	1	05	021	Beaufort-en-Vallée	6380	143	6523
52	Pays de la Loire	49	1	32	022	Beaulieu-sur-Layon	1449	32	1481
52	Pays de la Loire	49	2	06	023	Beaupréau	6784	389	7173
52	Pays de la Loire	49	2	25	024	Beausse	392	12	404
52	Pays de la Loire	49	1	31	025	Beauvau	253	2	255
52	Pays de la Loire	49	1	18	026	Bécon-les-Granits	2687	134	2821
52	Pays de la Loire	49	2	06	027	Bégrolles-en-Mauges	1877	39	1916
52	Pays de la Loire	49	1	26	028	Béhuard	127	3	130
52	Pays de la Loire	49	1	23	029	Blaison-Gohier	1096	36	1132
52	Pays de la Loire	49	3	17	030	Blou	1022	31	1053
52	Pays de la Loire	49	3	04	031	Bocé	603	9	612
52	Pays de la Loire	49	1	23	032	La Bohalle	1208	35	1243
52	Pays de la Loire	49	2	21	033	La Boissière-sur-Èvre	418	8	426
52	Pays de la Loire	49	2	25	034	Botz-en-Mauges	811	17	828
52	Pays de la Loire	49	1	38	035	Bouchemaine	6175	229	6404
52	Pays de la Loire	49	4	24	036	Bouillé-Ménard	738	15	753
52	Pays de la Loire	49	4	30	037	Le Bourg-d;Iré	830	16	846
52	Pays de la Loire	49	4	24	038	Bourg-l;Évêque	221	10	231
52	Pays de la Loire	49	2	25	039	Bourgneuf-en-Mauges	679	24	703
52	Pays de la Loire	49	2	09	040	Bouzillé	1473	21	1494
52	Pays de la Loire	49	3	27	041	Brain-sur-Allonnes	2012	50	2062
52	Pays de la Loire	49	1	36	042	Brain-sur-l;Authion	3291	260	3551
52	Pays de la Loire	49	4	16	043	Brain-sur-Longuenée	1008	21	1029
52	Pays de la Loire	49	3	22	044	Breil	277	13	290
52	Pays de la Loire	49	3	27	045	La Breille-les-Pins	595	16	611
52	Pays de la Loire	49	3	20	046	Brézé	1308	26	1334
52	Pays de la Loire	49	3	13	047	Brigné	407	12	419
52	Pays de la Loire	49	1	33	048	Briollay	2668	60	2728
52	Pays de la Loire	49	1	05	049	Brion	1115	37	1152
52	Pays de la Loire	49	1	32	050	Brissac-Quincé	2931	171	3102
52	Pays de la Loire	49	4	10	051	Brissarthe	630	21	651
52	Pays de la Loire	49	3	22	052	Broc	336	4	340
52	Pays de la Loire	49	3	20	053	Brossay	324	3	327
52	Pays de la Loire	49	4	07	054	Candé	2861	76	2937
52	Pays de la Loire	49	1	39	055	Cantenay-Épinard	2070	70	2140
52	Pays de la Loire	49	4	24	056	Carbay	244	3	247
52	Pays de la Loire	49	3	34	057	Cernusson	310	10	320
52	Pays de la Loire	49	2	12	058	Les Cerqueux	821	12	833
52	Pays de la Loire	49	3	34	059	Les Cerqueux-sous-Passavant	496	14	510
52	Pays de la Loire	49	3	29	060	Chacé	1266	27	1293
52	Pays de la Loire	49	4	07	061	Challain-la-Potherie	827	20	847
52	Pays de la Loire	49	3	22	062	Chalonnes-sous-le-Lude	137	4	141
52	Pays de la Loire	49	1	08	063	Chalonnes-sur-Loire	6492	191	6683
52	Pays de la Loire	49	4	16	064	Chambellay	344	1	345
52	Pays de la Loire	49	1	32	066	Champ-sur-Layon	989	23	1012
52	Pays de la Loire	49	4	10	065	Champigné	2068	91	2159
52	Pays de la Loire	49	4	10	067	Champteussé-sur-Baconne	227	6	233
52	Pays de la Loire	49	1	26	068	Champtocé-sur-Loire	1792	30	1822
52	Pays de la Loire	49	2	09	069	Champtoceaux	2373	61	2434
52	Pays de la Loire	49	2	12	070	Chanteloup-les-Bois	681	22	703
52	Pays de la Loire	49	1	32	071	Chanzeaux	1160	17	1177
52	Pays de la Loire	49	2	06	072	La Chapelle-du-Genêt	1196	16	1212
52	Pays de la Loire	49	4	24	073	La Chapelle-Hullin	136	6	142
52	Pays de la Loire	49	2	11	074	La Chapelle-Rousselin	729	22	751
52	Pays de la Loire	49	2	25	075	La Chapelle-Saint-Florent	1314	27	1341
52	Pays de la Loire	49	1	31	076	La Chapelle-Saint-Laud	646	9	655
52	Pays de la Loire	49	4	30	077	La Chapelle-sur-Oudon	586	13	599
52	Pays de la Loire	49	1	32	078	Charcé-Saint-Ellier-sur-Aubance	776	20	796
52	Pays de la Loire	49	3	04	079	Chartrené	54	0	54
52	Pays de la Loire	49	4	10	080	Châteauneuf-sur-Sarthe	3016	45	3061
52	Pays de la Loire	49	4	30	081	Châtelais	634	23	657
52	Pays de la Loire	49	1	08	082	Chaudefonds-sur-Layon	957	22	979
52	Pays de la Loire	49	2	21	083	Chaudron-en-Mauges	1446	31	1477
52	Pays de la Loire	49	1	31	084	Chaumont-d;Anjou	289	4	293
52	Pays de la Loire	49	2	21	085	La Chaussaire	786	13	799
52	Pays de la Loire	49	1	32	086	Chavagnes	1057	23	1080
52	Pays de la Loire	49	3	22	087	Chavaignes	101	6	107
52	Pays de la Loire	49	4	24	088	Chazé-Henry	858	18	876
52	Pays de la Loire	49	4	07	089	Chazé-sur-Argos	1023	22	1045
52	Pays de la Loire	49	1	33	090	Cheffes	912	17	929
52	Pays de la Loire	49	3	15	091	Chemellier	728	12	740
52	Pays de la Loire	49	2	11	092	Chemillé	7028	243	7271
52	Pays de la Loire	49	4	10	093	Chemiré-sur-Sarthe	272	4	276
52	Pays de la Loire	49	3	15	094	Chênehutte-Trèves-Cunault	1038	26	1064
52	Pays de la Loire	49	4	10	095	Chenillé-Changé	149	1	150
52	Pays de la Loire	49	4	10	096	Cherré	532	5	537
52	Pays de la Loire	49	3	04	097	Cheviré-le-Rouge	923	11	934
52	Pays de la Loire	49	3	22	098	Chigné	303	5	308
52	Pays de la Loire	49	2	97	099	Cholet	54098	2039	56137
52	Pays de la Loire	49	3	20	100	Cizay-la-Madeleine	498	7	505
52	Pays de la Loire	49	3	04	101	Clefs	979	33	1012
52	Pays de la Loire	49	3	34	102	Cléré-sur-Layon	326	13	339
52	Pays de la Loire	49	4	24	103	Combrée	2767	61	2828
52	Pays de la Loire	49	3	13	104	Concourson-sur-Layon	543	16	559
52	Pays de la Loire	49	4	10	105	Contigné	761	20	781
52	Pays de la Loire	49	1	05	106	Corné	2866	72	2938
52	Pays de la Loire	49	1	31	107	Cornillé-les-Caves	431	5	436
52	Pays de la Loire	49	1	18	108	La Cornuaille	985	25	1010
52	Pays de la Loire	49	3	34	109	Coron	1550	26	1576
52	Pays de la Loire	49	1	31	110	Corzé	1672	26	1698
52	Pays de la Loire	49	2	11	111	Cossé-d;Anjou	431	14	445
52	Pays de la Loire	49	3	20	112	Le Coudray-Macouard	906	25	931
52	Pays de la Loire	49	3	20	113	Courchamps	464	14	478
52	Pays de la Loire	49	3	17	114	Courléon	167	7	174
52	Pays de la Loire	49	3	15	115	Coutures	532	9	541
52	Pays de la Loire	49	3	04	116	Cuon	608	10	618
52	Pays de la Loire	49	1	23	117	La Daguenière	1282	19	1301
52	Pays de la Loire	49	1	14	119	Daumeray	1529	40	1569
52	Pays de la Loire	49	1	08	120	Denée	1403	35	1438
52	Pays de la Loire	49	3	13	121	Dénezé-sous-Doué	452	13	465
52	Pays de la Loire	49	3	22	122	Dénezé-sous-le-Lude	310	3	313
52	Pays de la Loire	49	3	29	123	Distré	1673	62	1735
52	Pays de la Loire	49	3	13	125	Doué-la-Fontaine	7518	299	7817
52	Pays de la Loire	49	2	09	126	Drain	1938	33	1971
52	Pays de la Loire	49	1	14	127	Durtal	3349	56	3405
52	Pays de la Loire	49	3	04	128	Échemiré	604	11	615
52	Pays de la Loire	49	1	01	129	Écouflant	3748	64	3812
52	Pays de la Loire	49	1	33	130	Écuillé	600	7	607
52	Pays de la Loire	49	3	20	131	Épieds	709	9	718
52	Pays de la Loire	49	1	14	132	Étriché	1541	25	1566
52	Pays de la Loire	49	1	32	133	Faveraye-Mâchelles	647	28	675
52	Pays de la Loire	49	1	32	134	Faye-d;Anjou	1289	30	1319
52	Pays de la Loire	49	1	33	135	Feneu	2159	50	2209
52	Pays de la Loire	49	4	30	136	La Ferrière-de-Flée	358	6	364
52	Pays de la Loire	49	2	21	137	Le Fief-Sauvin	1656	17	1673
52	Pays de la Loire	49	1	05	138	Fontaine-Guérin	955	26	981
52	Pays de la Loire	49	1	31	139	Fontaine-Milon	487	12	499
52	Pays de la Loire	49	3	29	140	Fontevraud-l;Abbaye	1554	27	1581
52	Pays de la Loire	49	3	13	141	Forges	258	7	265
52	Pays de la Loire	49	3	34	142	La Fosse-de-Tigné	210	3	213
52	Pays de la Loire	49	3	04	143	Fougeré	756	16	772
52	Pays de la Loire	49	4	07	144	Freigné	1149	21	1170
52	Pays de la Loire	49	2	21	145	Le Fuilet	1865	54	1919
52	Pays de la Loire	49	1	05	147	Gée	405	47	452
52	Pays de la Loire	49	4	16	148	Gené	456	4	460
52	Pays de la Loire	49	3	15	149	Gennes	2086	45	2131
52	Pays de la Loire	49	3	22	150	Genneteil	348	4	352
52	Pays de la Loire	49	2	06	151	Gesté	2579	47	2626
52	Pays de la Loire	49	4	16	155	Grez-Neuville	1491	28	1519
52	Pays de la Loire	49	3	15	154	Grézillé	551	9	560
52	Pays de la Loire	49	4	24	156	Grugé-l;Hôpital	299	9	308
52	Pays de la Loire	49	3	04	157	Le Guédeniau	340	9	349
52	Pays de la Loire	49	4	30	158	L; Hôtellerie-de-Flée	487	8	495
52	Pays de la Loire	49	1	14	159	Huillé	524	8	532
52	Pays de la Loire	49	1	26	160	Ingrandes	1645	22	1667
52	Pays de la Loire	49	4	16	161	La Jaille-Yvon	309	10	319
52	Pays de la Loire	49	2	06	162	Jallais	3208	108	3316
52	Pays de la Loire	49	1	31	163	Jarzé	1691	34	1725
52	Pays de la Loire	49	2	06	165	La Jubaudière	1218	46	1264
52	Pays de la Loire	49	1	23	167	Juigné-sur-Loire	2499	71	2570
52	Pays de la Loire	49	2	11	169	La Jumellière	1368	28	1396
52	Pays de la Loire	49	4	10	170	Juvardeil	811	23	834
52	Pays de la Loire	49	3	17	171	La Lande-Chasles	105	1	106
52	Pays de la Loire	49	2	09	172	Landemont	1635	35	1670
52	Pays de la Loire	49	3	22	173	Lasse	281	9	290
52	Pays de la Loire	49	1	31	174	Lézigné	719	12	731
52	Pays de la Loire	49	3	22	175	Linières-Bouton	86	5	91
52	Pays de la Loire	49	4	16	176	Le Lion-d;Angers	3687	81	3768
52	Pays de la Loire	49	2	09	177	Liré	2427	89	2516
52	Pays de la Loire	49	4	07	178	Loiré	881	20	901
52	Pays de la Loire	49	2	19	179	Le Longeron	2078	94	2172
52	Pays de la Loire	49	3	17	180	Longué-Jumelles	6826	193	7019
52	Pays de la Loire	49	3	15	181	Louerre	438	11	449
52	Pays de la Loire	49	3	13	182	Louresse-Rochemenier	837	19	856
52	Pays de la Loire	49	1	18	183	Le Louroux-Béconnais	2861	38	2899
52	Pays de la Loire	49	4	30	184	Louvaines	539	11	550
52	Pays de la Loire	49	1	31	185	Lué-en-Baugeois	342	2	344
52	Pays de la Loire	49	1	32	186	Luigné	265	3	268
52	Pays de la Loire	49	4	30	187	Marans	523	10	533
52	Pays de la Loire	49	1	31	188	Marcé	859	9	868
52	Pays de la Loire	49	4	10	189	Marigné	640	17	657
52	Pays de la Loire	49	2	25	190	Le Marillais	1084	17	1101
52	Pays de la Loire	49	3	13	191	Martigné-Briand	1872	63	1935
52	Pays de la Loire	49	2	12	192	Maulévrier	3180	73	3253
52	Pays de la Loire	49	2	06	193	Le May-sur-Èvre	3970	96	4066
52	Pays de la Loire	49	1	05	194	Mazé	4811	102	4913
52	Pays de la Loire	49	2	12	195	Mazières-en-Mauges	1000	30	1030
52	Pays de la Loire	49	1	39	196	La Meignanne	2129	87	2216
52	Pays de la Loire	49	3	13	198	Meigné	354	5	359
52	Pays de la Loire	49	3	22	197	Meigné-le-Vicomte	301	7	308
52	Pays de la Loire	49	2	11	199	Melay	1608	69	1677
52	Pays de la Loire	49	1	39	200	La Membrolle-sur-Longuenée	1872	36	1908
52	Pays de la Loire	49	1	05	201	La Ménitré	2194	33	2227
52	Pays de la Loire	49	3	22	202	Méon	264	10	274
52	Pays de la Loire	49	2	25	204	Le Mesnil-en-Vallée	1468	35	1503
52	Pays de la Loire	49	4	10	205	Miré	1024	19	1043
52	Pays de la Loire	49	2	19	206	Montfaucon-Montigné	1970	36	2006
52	Pays de la Loire	49	3	13	207	Montfort	111	3	114
52	Pays de la Loire	49	4	30	208	Montguillon	196	8	204
52	Pays de la Loire	49	1	14	209	Montigné-lès-Rairies	366	9	375
52	Pays de la Loire	49	3	34	211	Montilliers	1153	68	1221
52	Pays de la Loire	49	2	25	212	Montjean-sur-Loire	2939	54	2993
52	Pays de la Loire	49	3	04	213	Montpollin	214	1	215
52	Pays de la Loire	49	3	20	215	Montreuil-Bellay	4014	281	4295
52	Pays de la Loire	49	1	39	214	Montreuil-Juigné	7107	142	7249
52	Pays de la Loire	49	1	33	216	Montreuil-sur-Loir	494	7	501
52	Pays de la Loire	49	4	16	217	Montreuil-sur-Maine	689	19	708
52	Pays de la Loire	49	2	21	218	Montrevault	1281	20	1301
52	Pays de la Loire	49	3	29	219	Montsoreau	480	14	494
52	Pays de la Loire	49	1	14	220	Morannes	1790	42	1832
52	Pays de la Loire	49	3	17	221	Mouliherne	917	14	931
52	Pays de la Loire	49	1	23	222	Mozé-sur-Louet	2063	38	2101
52	Pays de la Loire	49	1	23	223	Mûrs-Erigné	5326	149	5475
52	Pays de la Loire	49	3	27	224	Neuillé	945	19	964
52	Pays de la Loire	49	2	11	225	Neuvy-en-Mauges	822	16	838
52	Pays de la Loire	49	4	24	226	Noëllet	445	9	454
52	Pays de la Loire	49	1	32	227	Notre-Dame-d;Allençon	608	9	617
52	Pays de la Loire	49	3	22	228	Noyant	1896	86	1982
52	Pays de la Loire	49	4	30	229	Noyant-la-Gravoyère	1836	36	1872
52	Pays de la Loire	49	3	15	230	Noyant-la-Plaine	324	5	329
52	Pays de la Loire	49	2	12	231	Nuaillé	1379	33	1412
52	Pays de la Loire	49	3	34	232	Nueil-sur-Layon	1357	49	1406
52	Pays de la Loire	49	4	30	233	Nyoiseau	1281	264	1545
52	Pays de la Loire	49	3	29	235	Parnay	482	17	499
52	Pays de la Loire	49	3	22	234	Parçay-les-Pins	915	20	935
52	Pays de la Loire	49	3	34	236	Passavant-sur-Layon	130	4	134
52	Pays de la Loire	49	3	22	237	La Pellerine	160	7	167
52	Pays de la Loire	49	1	01	238	Pellouailles-les-Vignes	2486	56	2542
52	Pays de la Loire	49	2	06	239	Le Pin-en-Mauges	1332	25	1357
52	Pays de la Loire	49	3	34	240	La Plaine	964	28	992
52	Pays de la Loire	49	1	02	241	Le Plessis-Grammoire	2283	56	2339
52	Pays de la Loire	49	1	39	242	Le Plessis-Macé	1259	23	1282
52	Pays de la Loire	49	2	06	243	La Poitevinière	1065	18	1083
52	Pays de la Loire	49	2	25	244	La Pommeraye	3966	129	4095
52	Pays de la Loire	49	3	04	245	Pontigné	257	12	269
52	Pays de la Loire	49	1	23	246	Les Ponts-de-Cé	11696	544	12240
52	Pays de la Loire	49	1	26	247	La Possonnière	2342	43	2385
52	Pays de la Loire	49	4	24	248	Pouancé	3110	138	3248
52	Pays de la Loire	49	4	16	249	La Pouëze	1804	34	1838
52	Pays de la Loire	49	4	24	250	La Prévière	254	5	259
52	Pays de la Loire	49	4	16	251	Pruillé	635	8	643
52	Pays de la Loire	49	2	21	252	Le Puiset-Doré	1143	9	1152
52	Pays de la Loire	49	3	20	253	Le Puy-Notre-Dame	1267	40	1307
52	Pays de la Loire	49	4	10	254	Querré	319	5	324
52	Pays de la Loire	49	1	32	256	Rablay-sur-Layon	732	23	755
52	Pays de la Loire	49	1	14	257	Les Rairies	970	21	991
52	Pays de la Loire	49	2	19	258	La Renaudière	924	11	935
52	Pays de la Loire	49	1	08	259	Rochefort-sur-Loire	2232	48	2280
52	Pays de la Loire	49	2	19	260	La Romagne	1763	80	1843
52	Pays de la Loire	49	3	28	261	Les Rosiers-sur-Loire	2357	39	2396
52	Pays de la Loire	49	3	29	262	Rou-Marson	683	19	702
52	Pays de la Loire	49	2	19	263	Roussay	1167	22	1189
52	Pays de la Loire	49	2	19	264	Saint-André-de-la-Marche	2817	81	2898
52	Pays de la Loire	49	1	08	265	Saint-Aubin-de-Luigné	1190	18	1208
52	Pays de la Loire	49	1	18	266	Saint-Augustin-des-Bois	1020	17	1037
52	Pays de la Loire	49	1	02	267	Saint-Barthélemy-d;Anjou	8702	346	9048
52	Pays de la Loire	49	2	40	269	Saint-Christophe-du-Bois	2624	100	2724
52	Pays de la Loire	49	2	09	270	Saint-Christophe-la-Couperie	783	8	791
52	Pays de la Loire	49	1	18	271	Saint-Clément-de-la-Place	1911	31	1942
52	Pays de la Loire	49	3	28	272	Saint-Clément-des-Levées	1149	31	1180
52	Pays de la Loire	49	2	19	273	Saint-Crespin-sur-Moine	1565	17	1582
52	Pays de la Loire	49	3	20	274	Saint-Cyr-en-Bourg	982	33	1015
52	Pays de la Loire	49	2	25	276	Saint-Florent-le-Vieil	2677	84	2761
52	Pays de la Loire	49	2	11	281	Saint-Georges-des-Gardes	1590	34	1624
52	Pays de la Loire	49	3	15	279	Saint-Georges-des-Sept-Voies	695	19	714
52	Pays de la Loire	49	1	05	280	Saint-Georges-du-Bois	412	11	423
52	Pays de la Loire	49	3	13	282	Saint-Georges-sur-Layon	785	13	798
52	Pays de la Loire	49	1	26	283	Saint-Georges-sur-Loire	3335	76	3411
52	Pays de la Loire	49	1	26	284	Saint-Germain-des-Prés	1364	32	1396
52	Pays de la Loire	49	2	19	285	Saint-Germain-sur-Moine	2789	43	2832
52	Pays de la Loire	49	1	23	288	Saint-Jean-de-la-Croix	239	5	244
52	Pays de la Loire	49	1	26	289	Saint-Jean-de-Linières	1734	39	1773
52	Pays de la Loire	49	1	23	290	Saint-Jean-des-Mauvrets	1744	38	1782
52	Pays de la Loire	49	3	20	291	Saint-Just-sur-Dive	404	1	405
52	Pays de la Loire	49	1	32	292	Saint-Lambert-du-Lattay	1894	46	1940
52	Pays de la Loire	49	1	39	294	Saint-Lambert-la-Potherie	2472	80	2552
52	Pays de la Loire	49	2	25	295	Saint-Laurent-de-la-Plaine	1699	48	1747
52	Pays de la Loire	49	2	09	296	Saint-Laurent-des-Autels	2152	21	2173
52	Pays de la Loire	49	2	25	297	Saint-Laurent-du-Mottay	779	21	800
52	Pays de la Loire	49	1	26	298	Saint-Léger-des-Bois	1527	37	1564
52	Pays de la Loire	49	2	35	299	Saint-Léger-sous-Cholet	2492	105	2597
52	Pays de la Loire	49	2	11	300	Saint-Lézin	765	15	780
52	Pays de la Loire	49	3	20	302	Saint-Macaire-du-Bois	436	4	440
52	Pays de la Loire	49	2	19	301	Saint-Macaire-en-Mauges	6829	154	6983
52	Pays de la Loire	49	3	04	303	Saint-Martin-d;Arcé	794	17	811
52	Pays de la Loire	49	3	28	304	Saint-Martin-de-la-Place	1156	31	1187
52	Pays de la Loire	49	4	30	305	Saint-Martin-du-Bois	896	16	912
52	Pays de la Loire	49	1	26	306	Saint-Martin-du-Fouilloux	1621	44	1665
52	Pays de la Loire	49	1	23	307	Saint-Mathurin-sur-Loire	2374	61	2435
52	Pays de la Loire	49	1	23	308	Saint-Melaine-sur-Aubance	2100	51	2151
52	Pays de la Loire	49	4	24	309	Saint-Michel-et-Chanveaux	368	7	375
52	Pays de la Loire	49	3	34	310	Saint-Paul-du-Bois	612	18	630
52	Pays de la Loire	49	3	17	311	Saint-Philbert-du-Peuple	1313	25	1338
52	Pays de la Loire	49	2	06	312	Saint-Philbert-en-Mauges	376	8	384
52	Pays de la Loire	49	2	21	313	Saint-Pierre-Montlimart	3299	77	3376
52	Pays de la Loire	49	2	21	314	Saint-Quentin-en-Mauges	1036	29	1065
52	Pays de la Loire	49	3	04	315	Saint-Quentin-lès-Beaurepaire	300	4	304
52	Pays de la Loire	49	2	21	316	Saint-Rémy-en-Mauges	1436	33	1469
52	Pays de la Loire	49	1	23	317	Saint-Rémy-la-Varenne	976	25	1001
52	Pays de la Loire	49	1	23	318	Saint-Saturnin-sur-Loire	1323	31	1354
52	Pays de la Loire	49	4	30	319	Saint-Sauveur-de-Flée	287	5	292
52	Pays de la Loire	49	2	09	320	Saint-Sauveur-de-Landemont	870	15	885
52	Pays de la Loire	49	1	18	321	Saint-Sigismond	374	17	391
52	Pays de la Loire	49	1	23	322	Saint-Sulpice	179	12	191
52	Pays de la Loire	49	1	01	323	Saint-Sylvain-d;Anjou	4440	235	4675
52	Pays de la Loire	49	2	11	268	Sainte-Christine	784	9	793
52	Pays de la Loire	49	4	30	277	Sainte-Gemmes-d;Andigné	1486	45	1531
52	Pays de la Loire	49	1	23	278	Sainte-Gemmes-sur-Loire	3957	258	4215
52	Pays de la Loire	49	3	34	325	La Salle-de-Vihiers	1063	46	1109
52	Pays de la Loire	49	2	21	324	La Salle-et-Chapelle-Aubry	1266	18	1284
52	Pays de la Loire	49	1	36	326	Sarrigné	818	15	833
52	Pays de la Loire	49	1	32	327	Saulgé-l;Hôpital	550	12	562
52	Pays de la Loire	49	3	99	328	Saumur	27283	1489	28772
52	Pays de la Loire	49	1	26	329	Savennières	1375	22	1397
52	Pays de la Loire	49	4	10	330	Sceaux-d;Anjou	972	15	987
52	Pays de la Loire	49	4	30	331	Segré	6801	423	7224
52	Pays de la Loire	49	2	35	332	La Séguinière	3765	109	3874
52	Pays de la Loire	49	1	31	333	Seiches-sur-le-Loir	2960	31	2991
52	Pays de la Loire	49	1	31	334	Sermaise	331	1	332
52	Pays de la Loire	49	4	10	335	Soeurdres	342	10	352
52	Pays de la Loire	49	3	34	336	Somloire	940	11	951
52	Pays de la Loire	49	1	33	337	Soucelles	2620	46	2666
52	Pays de la Loire	49	1	23	338	Soulaines-sur-Aubance	1156	40	1196
52	Pays de la Loire	49	1	33	339	Soulaire-et-Bourg	1408	25	1433
52	Pays de la Loire	49	3	29	341	Souzay-Champigny	753	25	778
52	Pays de la Loire	49	3	34	342	Tancoigné	338	5	343
52	Pays de la Loire	49	2	40	343	La Tessoualle	3059	78	3137
52	Pays de la Loire	49	4	10	344	Thorigné-d;Anjou	1138	18	1156
52	Pays de la Loire	49	1	32	345	Thouarcé	1838	65	1903
52	Pays de la Loire	49	3	15	346	Le Thoureil	436	17	453
52	Pays de la Loire	49	1	33	347	Tiercé	4254	68	4322
52	Pays de la Loire	49	3	34	348	Tigné	765	30	795
52	Pays de la Loire	49	2	19	349	Tillières	1738	29	1767
52	Pays de la Loire	49	2	19	350	Torfou	2090	48	2138
52	Pays de la Loire	49	2	11	351	La Tourlandry	1286	43	1329
52	Pays de la Loire	49	2	12	352	Toutlemonde	1138	17	1155
52	Pays de la Loire	49	1	36	353	Trélazé	12384	187	12571
52	Pays de la Loire	49	4	24	354	Le Tremblay	349	10	359
52	Pays de la Loire	49	2	12	355	Trémentines	2813	65	2878
52	Pays de la Loire	49	3	34	356	Trémont	397	12	409
52	Pays de la Loire	49	3	29	358	Turquant	563	25	588
52	Pays de la Loire	49	3	13	359	Les Ulmes	571	17	588
52	Pays de la Loire	49	1	32	153	Valanjou	2228	62	2290
52	Pays de la Loire	49	2	09	360	La Varenne	1762	51	1813
52	Pays de la Loire	49	3	27	361	Varennes-sur-Loire	1891	47	1938
52	Pays de la Loire	49	3	29	362	Varrains	1207	29	1236
52	Pays de la Loire	49	1	32	363	Vauchrétien	1478	54	1532
52	Pays de la Loire	49	3	20	364	Vaudelnay	1228	35	1263
52	Pays de la Loire	49	3	04	380	Vaulandry	313	6	319
52	Pays de la Loire	49	3	13	365	Les Verchers-sur-Layon	902	24	926
52	Pays de la Loire	49	4	24	366	Vergonnes	319	6	325
52	Pays de la Loire	49	4	16	367	Vern-d;Anjou	2219	41	2260
52	Pays de la Loire	49	3	17	368	Vernantes	1982	31	2013
52	Pays de la Loire	49	3	17	369	Vernoil-le-Fourrier	1251	28	1279
52	Pays de la Loire	49	3	29	370	Verrie	436	11	447
52	Pays de la Loire	49	2	12	371	Vezins	1634	37	1671
52	Pays de la Loire	49	3	04	372	Le Vieil-Baugé	1266	83	1349
52	Pays de la Loire	49	3	34	373	Vihiers	4271	144	4415
52	Pays de la Loire	49	3	27	374	Villebernier	1449	24	1473
52	Pays de la Loire	49	2	06	375	Villedieu-la-Blouère	2432	36	2468
52	Pays de la Loire	49	1	18	376	Villemoisan	619	16	635
52	Pays de la Loire	49	1	01	377	Villevêque	2851	44	2895
52	Pays de la Loire	49	3	27	378	Vivy	2413	94	2507
52	Pays de la Loire	49	2	12	381	Yzernay	1791	51	1842
25	Basse-Normandie	50	2	04	001	Acqueville	650	26	676
25	Basse-Normandie	50	4	52	002	Agneaux	4020	491	4511
25	Basse-Normandie	50	3	36	003	Agon-Coutainville	2834	112	2946
25	Basse-Normandie	50	4	31	004	Airel	531	10	541
25	Basse-Normandie	50	2	37	005	Amfreville	293	11	304
25	Basse-Normandie	50	4	34	006	Amigny	144	3	147
25	Basse-Normandie	50	3	36	007	Ancteville	246	1	247
25	Basse-Normandie	50	3	06	008	Anctoville-sur-Boscq	498	20	518
25	Basse-Normandie	50	1	42	009	Angey	238	4	242
25	Basse-Normandie	50	2	37	010	Angoville-au-Plain	51	2	53
25	Basse-Normandie	50	3	20	012	Angoville-sur-Ay	256	8	264
25	Basse-Normandie	50	2	30	013	Anneville-en-Saire	386	6	392
25	Basse-Normandie	50	3	20	014	Anneville-sur-Mer	238	7	245
25	Basse-Normandie	50	3	23	015	Annoville	632	13	645
25	Basse-Normandie	50	3	16	016	Appeville	205	9	214
25	Basse-Normandie	50	1	33	018	Argouges	549	14	563
25	Basse-Normandie	50	1	29	019	Aucey-la-Plaine	456	6	462
25	Basse-Normandie	50	2	04	020	Auderville	267	5	272
25	Basse-Normandie	50	2	37	021	Audouville-la-Hubert	57	5	62
25	Basse-Normandie	50	2	30	022	Aumeville-Lestre	142	1	143
25	Basse-Normandie	50	4	09	023	Auvers	671	7	678
25	Basse-Normandie	50	4	09	024	Auxais	180	4	184
25	Basse-Normandie	50	1	01	025	Avranches	8020	649	8669
25	Basse-Normandie	50	2	22	026	Azeville	77	1	78
25	Basse-Normandie	50	1	42	027	Bacilly	872	26	898
25	Basse-Normandie	50	3	14	028	La Baleine	94	0	94
25	Basse-Normandie	50	1	02	029	Barenton	1255	40	1295
25	Basse-Normandie	50	2	30	030	Barfleur	643	14	657
25	Basse-Normandie	50	2	03	031	Barneville-Carteret	2283	60	2343
25	Basse-Normandie	50	4	35	032	La Barre-de-Semilly	945	37	982
25	Basse-Normandie	50	2	03	033	Baubigny	156	4	160
25	Basse-Normandie	50	4	35	034	Baudre	536	12	548
25	Basse-Normandie	50	3	16	035	Baudreville	82	0	82
25	Basse-Normandie	50	3	27	036	Baupte	458	6	464
25	Basse-Normandie	50	1	19	037	La Bazoge	163	3	166
25	Basse-Normandie	50	1	17	038	Beauchamps	382	15	397
25	Basse-Normandie	50	4	45	039	Beaucoudray	154	2	156
25	Basse-Normandie	50	1	43	040	Beauficel	167	6	173
25	Basse-Normandie	50	2	04	041	Beaumont-Hague	1484	47	1531
25	Basse-Normandie	50	1	29	042	Beauvoir	423	19	442
25	Basse-Normandie	50	1	19	043	Bellefontaine	159	6	165
25	Basse-Normandie	50	3	10	044	Belval	301	3	304
25	Basse-Normandie	50	2	28	045	Benoîtville	592	12	604
25	Basse-Normandie	50	4	31	046	Bérigny	387	10	397
25	Basse-Normandie	50	4	26	048	Beslon	536	10	546
25	Basse-Normandie	50	2	41	049	Besneville	668	10	678
25	Basse-Normandie	50	4	45	050	Beuvrigny	139	2	141
25	Basse-Normandie	50	2	37	051	Beuzeville-au-Plain	47	2	49
25	Basse-Normandie	50	2	37	052	Beuzeville-la-Bastille	150	4	154
25	Basse-Normandie	50	4	46	054	Biéville	173	2	175
25	Basse-Normandie	50	2	41	055	Biniville	103	2	105
25	Basse-Normandie	50	1	24	056	Bion	401	12	413
25	Basse-Normandie	50	2	04	057	Biville	553	15	568
25	Basse-Normandie	50	3	36	058	Blainville-sur-Mer	1576	48	1624
25	Basse-Normandie	50	2	37	059	Blosville	268	6	274
25	Basse-Normandie	50	4	48	060	La Bloutière	402	2	404
25	Basse-Normandie	50	3	36	061	Boisroger	194	3	197
25	Basse-Normandie	50	1	39	062	Boisyvon	110	1	111
25	Basse-Normandie	50	3	16	063	Bolleville	380	15	395
25	Basse-Normandie	50	2	41	064	La Bonneville	173	6	179
25	Basse-Normandie	50	4	48	069	Bourguenolles	324	2	326
25	Basse-Normandie	50	2	37	070	Boutteville	57	2	59
25	Basse-Normandie	50	1	05	071	Braffais	190	1	191
25	Basse-Normandie	50	3	36	072	Brainville	208	6	214
25	Basse-Normandie	50	2	04	073	Branville-Hague	178	1	179
25	Basse-Normandie	50	1	05	074	Brécey	2177	173	2350
25	Basse-Normandie	50	4	46	075	Brectouville	167	10	177
25	Basse-Normandie	50	3	06	076	Bréhal	3045	85	3130
25	Basse-Normandie	50	2	51	077	Bretteville	1067	44	1111
25	Basse-Normandie	50	3	20	078	Bretteville-sur-Ay	385	2	387
25	Basse-Normandie	50	2	07	079	Breuville	378	9	387
25	Basse-Normandie	50	4	09	080	Brévands	347	6	353
25	Basse-Normandie	50	3	06	081	Bréville-sur-Mer	819	40	859
25	Basse-Normandie	50	2	07	082	Bricquebec	4256	118	4374
25	Basse-Normandie	50	2	28	083	Bricquebosq	510	9	519
25	Basse-Normandie	50	3	12	084	Bricqueville-la-Blouette	547	28	575
25	Basse-Normandie	50	3	06	085	Bricqueville-sur-Mer	1165	24	1189
25	Basse-Normandie	50	2	38	086	Brillevast	323	8	331
25	Basse-Normandie	50	2	47	087	Brix	2067	69	2136
25	Basse-Normandie	50	1	43	088	Brouains	194	3	197
25	Basse-Normandie	50	2	37	089	Brucheville	143	9	152
25	Basse-Normandie	50	1	44	090	Buais	559	16	575
25	Basse-Normandie	50	3	12	092	Cambernon	719	19	738
25	Basse-Normandie	50	3	10	093	Cametours	414	3	417
25	Basse-Normandie	50	3	40	094	Camprond	386	4	390
25	Basse-Normandie	50	4	08	095	Canisy	1028	24	1052
25	Basse-Normandie	50	2	38	096	Canteloup	195	6	201
25	Basse-Normandie	50	3	16	097	Canville-la-Rocque	130	1	131
25	Basse-Normandie	50	4	21	098	Carantilly	609	8	617
25	Basse-Normandie	50	4	09	099	Carentan	6063	503	6566
25	Basse-Normandie	50	1	33	100	Carnet	476	6	482
25	Basse-Normandie	50	2	38	101	Carneville	228	5	233
25	Basse-Normandie	50	1	42	102	Carolles	788	33	821
25	Basse-Normandie	50	2	37	103	Carquebut	301	6	307
25	Basse-Normandie	50	2	41	105	Catteville	118	1	119
25	Basse-Normandie	50	4	09	107	Catz	121	1	122
25	Basse-Normandie	50	4	34	106	Cavigny	204	8	212
25	Basse-Normandie	50	1	13	108	Céaux	444	8	452
25	Basse-Normandie	50	3	06	109	Cérences	1804	40	1844
25	Basse-Normandie	50	4	31	110	Cerisy-la-Forêt	937	22	959
25	Basse-Normandie	50	3	10	111	Cerisy-la-Salle	1018	33	1051
25	Basse-Normandie	50	1	05	112	La Chaise-Baudouin	448	5	453
25	Basse-Normandie	50	1	17	114	Les Chambres	121	3	124
25	Basse-Normandie	50	1	17	115	Champcervon	217	4	221
25	Basse-Normandie	50	1	42	116	Champcey	205	6	211
25	Basse-Normandie	50	1	42	117	Champeaux	358	6	364
25	Basse-Normandie	50	4	48	118	Champrepus	303	2	305
25	Basse-Normandie	50	4	34	119	Les Champs-de-Losque	199	5	204
25	Basse-Normandie	50	3	06	120	Chanteloup	331	2	333
25	Basse-Normandie	50	1	39	121	La Chapelle-Cécelin	214	4	218
25	Basse-Normandie	50	4	21	123	La Chapelle-en-Juger	655	21	676
25	Basse-Normandie	50	1	05	124	La Chapelle-Urée	128	2	130
25	Basse-Normandie	50	1	19	125	Chasseguey	77	1	78
25	Basse-Normandie	50	1	43	514	Chaulieu	284	3	287
25	Basse-Normandie	50	1	01	126	Chavoy	152	0	152
25	Basse-Normandie	50	2	37	127	Chef-du-Pont	743	14	757
25	Basse-Normandie	50	4	26	128	Le Chefresne	311	7	318
25	Basse-Normandie	50	2	96	129	Cherbourg-Octeville	38433	1339	39772
25	Basse-Normandie	50	4	48	130	Chérencé-le-Héron	378	6	384
25	Basse-Normandie	50	1	19	131	Chérencé-le-Roussel	307	2	309
25	Basse-Normandie	50	1	13	132	Les Chéris	266	4	270
25	Basse-Normandie	50	1	32	133	Chèvreville	203	10	213
25	Basse-Normandie	50	4	45	134	Chevry	79	0	79
25	Basse-Normandie	50	2	38	135	Clitourps	201	4	205
25	Basse-Normandie	50	3	16	136	Coigny	206	3	209
25	Basse-Normandie	50	4	26	137	La Colombe	633	21	654
25	Basse-Normandie	50	2	41	138	Colomby	482	2	484
25	Basse-Normandie	50	4	46	139	Condé-sur-Vire	3331	130	3461
25	Basse-Normandie	50	3	23	140	Contrières	392	7	399
25	Basse-Normandie	50	2	38	142	Cosqueville	580	15	595
25	Basse-Normandie	50	3	06	143	Coudeville-sur-Mer	878	18	896
25	Basse-Normandie	50	1	39	144	Coulouvray-Boisbenâtre	540	5	545
25	Basse-Normandie	50	3	12	145	Courcy	568	8	576
25	Basse-Normandie	50	1	13	146	Courtils	237	8	245
25	Basse-Normandie	50	3	12	147	Coutances	9355	1305	10660
25	Basse-Normandie	50	4	31	148	Couvains	444	9	453
25	Basse-Normandie	50	2	25	149	Couville	970	23	993
25	Basse-Normandie	50	2	30	150	Crasville	250	5	255
25	Basse-Normandie	50	3	20	151	Créances	2182	45	2227
25	Basse-Normandie	50	1	05	152	Les Cresnays	254	4	258
25	Basse-Normandie	50	3	16	153	Cretteville	230	2	232
25	Basse-Normandie	50	1	33	154	La Croix-Avranchin	477	13	490
25	Basse-Normandie	50	1	13	155	Crollon	242	4	246
25	Basse-Normandie	50	2	41	156	Crosville-sur-Douve	62	0	62
25	Basse-Normandie	50	1	05	158	Cuves	349	12	361
25	Basse-Normandie	50	4	08	159	Dangy	651	23	674
25	Basse-Normandie	50	3	16	160	Denneville	553	11	564
25	Basse-Normandie	50	4	34	161	Le Dézert	548	12	560
25	Basse-Normandie	50	2	51	162	Digosville	1532	43	1575
25	Basse-Normandie	50	2	04	163	Digulleville	291	4	295
25	Basse-Normandie	50	4	45	164	Domjean	1023	14	1037
25	Basse-Normandie	50	1	15	165	Donville-les-Bains	3242	153	3395
25	Basse-Normandie	50	3	16	166	Doville	293	6	299
25	Basse-Normandie	50	1	42	167	Dragey-Ronthon	799	11	810
25	Basse-Normandie	50	1	13	168	Ducey	2478	60	2538
25	Basse-Normandie	50	2	22	169	Écausseville	101	3	104
25	Basse-Normandie	50	2	37	170	Écoquenéauville	69	1	70
25	Basse-Normandie	50	2	04	171	Éculleville	37	0	37
25	Basse-Normandie	50	2	22	172	Émondeville	359	5	364
25	Basse-Normandie	50	2	50	173	Équeurdreville-Hainneville	17339	603	17942
25	Basse-Normandie	50	1	17	174	Équilly	162	6	168
25	Basse-Normandie	50	2	22	175	Éroudeville	243	6	249
25	Basse-Normandie	50	2	07	176	L; Étang-Bertrand	365	6	371
25	Basse-Normandie	50	2	41	177	Étienville	330	13	343
25	Basse-Normandie	50	2	38	178	Fermanville	1401	31	1432
25	Basse-Normandie	50	1	44	179	Ferrières	57	0	57
25	Basse-Normandie	50	4	45	180	Fervaches	383	6	389
25	Basse-Normandie	50	3	27	181	Feugères	339	10	349
25	Basse-Normandie	50	3	20	182	La Feuillie	296	6	302
25	Basse-Normandie	50	2	03	183	Fierville-les-Mines	311	5	316
25	Basse-Normandie	50	2	28	184	Flamanville	1725	34	1759
25	Basse-Normandie	50	4	48	185	Fleury	921	18	939
25	Basse-Normandie	50	2	22	186	Flottemanville	200	8	208
25	Basse-Normandie	50	2	04	187	Flottemanville-Hague	885	39	924
25	Basse-Normandie	50	1	17	188	Folligny	1005	28	1033
25	Basse-Normandie	50	1	24	189	Fontenay	316	2	318
25	Basse-Normandie	50	2	22	190	Fontenay-sur-Mer	168	3	171
25	Basse-Normandie	50	2	37	191	Foucarville	130	4	134
25	Basse-Normandie	50	4	45	192	Fourneaux	96	1	97
25	Basse-Normandie	50	1	43	193	Le Fresne-Poret	228	7	235
25	Basse-Normandie	50	2	22	194	Fresville	373	16	389
25	Basse-Normandie	50	1	43	195	Gathemo	287	7	294
25	Basse-Normandie	50	2	38	196	Gatteville-le-Phare	497	17	514
25	Basse-Normandie	50	3	14	197	Gavray	1388	28	1416
25	Basse-Normandie	50	3	20	198	Geffosses	417	5	422
25	Basse-Normandie	50	1	42	199	Genêts	417	11	428
25	Basse-Normandie	50	1	02	200	Ger	851	20	871
25	Basse-Normandie	50	4	46	202	Giéville	683	10	693
25	Basse-Normandie	50	2	51	203	La Glacerie	5501	137	5638
25	Basse-Normandie	50	3	16	204	Glatigny	144	4	148
25	Basse-Normandie	50	1	01	205	La Godefroy	224	3	227
25	Basse-Normandie	50	1	01	206	La Gohannière	127	2	129
25	Basse-Normandie	50	2	41	207	Golleville	179	3	182
25	Basse-Normandie	50	3	27	208	Gonfreville	160	4	164
25	Basse-Normandie	50	2	38	209	Gonneville	874	27	901
25	Basse-Normandie	50	3	27	210	Gorges	360	10	370
25	Basse-Normandie	50	2	38	211	Gouberville	115	4	119
25	Basse-Normandie	50	2	37	212	Gourbesville	173	1	174
25	Basse-Normandie	50	4	08	213	Gourfaleur	452	13	465
25	Basse-Normandie	50	4	45	214	Gouvets	268	7	275
25	Basse-Normandie	50	3	36	215	Gouville-sur-Mer	2042	40	2082
25	Basse-Normandie	50	4	34	216	Graignes-Mesnil-Angot	793	93	886
25	Basse-Normandie	50	1	05	217	Le Grand-Celland	568	10	578
25	Basse-Normandie	50	1	15	218	Granville	12969	754	13723
25	Basse-Normandie	50	3	36	219	Gratot	663	35	698
25	Basse-Normandie	50	2	04	220	Gréville-Hague	767	34	801
25	Basse-Normandie	50	3	14	221	Grimesnil	63	0	63
25	Basse-Normandie	50	2	28	222	Grosville	711	11	722
25	Basse-Normandie	50	3	10	223	Guéhébert	115	5	120
25	Basse-Normandie	50	4	46	224	Guilberville	994	17	1011
25	Basse-Normandie	50	4	26	225	Le Guislain	117	1	118
25	Basse-Normandie	50	2	22	227	Le Ham	346	5	351
25	Basse-Normandie	50	3	14	228	Hambye	1192	32	1224
25	Basse-Normandie	50	1	33	229	Hamelin	111	3	114
25	Basse-Normandie	50	2	25	230	Hardinvast	896	36	932
25	Basse-Normandie	50	3	40	232	Hauteville-la-Guichard	454	12	466
25	Basse-Normandie	50	3	23	231	Hauteville-sur-Mer	656	18	674
25	Basse-Normandie	50	2	41	233	Hautteville-Bocage	130	2	132
25	Basse-Normandie	50	4	26	234	La Haye-Bellefond	78	0	78
25	Basse-Normandie	50	2	03	235	La Haye-d;Ectot	245	10	255
25	Basse-Normandie	50	3	16	236	La Haye-du-Puits	1662	91	1753
25	Basse-Normandie	50	1	17	237	La Haye-Pesnel	1367	33	1400
25	Basse-Normandie	50	2	28	238	Héauville	500	6	506
25	Basse-Normandie	50	4	21	239	Hébécrevon	1138	31	1169
25	Basse-Normandie	50	2	28	240	Helleville	438	10	448
25	Basse-Normandie	50	2	22	241	Hémevez	173	2	175
25	Basse-Normandie	50	3	23	244	Hérenguerville	182	7	189
25	Basse-Normandie	50	2	04	242	Herqueville	159	4	163
25	Basse-Normandie	50	3	36	243	Heugueville-sur-Sienne	535	14	549
25	Basse-Normandie	50	1	44	245	Heussé	237	1	238
25	Basse-Normandie	50	2	37	246	Hiesville	74	4	78
25	Basse-Normandie	50	1	17	247	Hocquigny	192	3	195
25	Basse-Normandie	50	4	34	248	Le Hommet-d;Arthenay	433	127	560
25	Basse-Normandie	50	2	37	249	Houesville	310	1	311
25	Basse-Normandie	50	3	16	250	Houtteville	93	1	94
25	Basse-Normandie	50	2	47	251	Huberville	354	11	365
25	Basse-Normandie	50	3	06	252	Hudimesnil	866	13	879
25	Basse-Normandie	50	1	29	253	Huisnes-sur-Mer	208	5	213
25	Basse-Normandie	50	1	44	254	Husson	231	17	248
25	Basse-Normandie	50	3	23	255	Hyenville	321	9	330
25	Basse-Normandie	50	1	18	256	Isigny-le-Buat	3282	93	3375
25	Basse-Normandie	50	2	04	257	Jobourg	501	15	516
25	Basse-Normandie	50	2	22	258	Joganville	89	3	92
25	Basse-Normandie	50	1	13	259	Juilley	598	13	611
25	Basse-Normandie	50	1	97	066	Jullouville	2345	57	2402
25	Basse-Normandie	50	1	19	260	Juvigny-le-Tertre	610	17	627
25	Basse-Normandie	50	4	46	261	Lamberville	171	2	173
25	Basse-Normandie	50	4	48	262	La Lande-d;Airou	500	11	511
25	Basse-Normandie	50	1	32	263	Lapenty	429	17	446
25	Basse-Normandie	50	3	20	265	Laulne	157	1	158
25	Basse-Normandie	50	3	14	266	Lengronne	449	16	465
25	Basse-Normandie	50	3	20	267	Lessay	2025	39	2064
25	Basse-Normandie	50	2	22	268	Lestre	259	5	264
25	Basse-Normandie	50	2	37	269	Liesville-sur-Douve	224	8	232
25	Basse-Normandie	50	2	47	270	Lieusaint	376	7	383
25	Basse-Normandie	50	1	39	271	Lingeard	85	1	86
25	Basse-Normandie	50	3	23	272	Lingreville	920	19	939
25	Basse-Normandie	50	3	16	273	Lithaire	551	6	557
25	Basse-Normandie	50	1	32	274	Les Loges-Marchis	1022	143	1165
25	Basse-Normandie	50	1	05	275	Les Loges-sur-Brécey	156	8	164
25	Basse-Normandie	50	1	42	276	Lolif	546	15	561
25	Basse-Normandie	50	3	06	277	Longueville	620	19	639
25	Basse-Normandie	50	3	06	278	Le Loreur	228	1	229
25	Basse-Normandie	50	3	40	279	Le Lorey	605	17	622
25	Basse-Normandie	50	4	21	280	Lozon	307	5	312
25	Basse-Normandie	50	1	17	281	La Lucerne-d;Outremer	833	12	845
25	Basse-Normandie	50	1	17	282	Le Luot	224	1	225
25	Basse-Normandie	50	4	35	283	La Luzerne	48	6	54
25	Basse-Normandie	50	1	29	284	Macey	114	3	117
25	Basse-Normandie	50	2	07	285	Magneville	293	6	299
25	Basse-Normandie	50	4	08	287	La Mancellière-sur-Vire	487	12	499
25	Basse-Normandie	50	1	01	288	Marcey-les-Grèves	1271	37	1308
25	Basse-Normandie	50	3	27	289	Marchésieux	716	19	735
25	Basse-Normandie	50	1	13	290	Marcilly	372	4	376
25	Basse-Normandie	50	4	26	291	Margueray	135	1	136
25	Basse-Normandie	50	4	21	292	Marigny	2141	81	2222
25	Basse-Normandie	50	1	32	293	Martigny	317	8	325
25	Basse-Normandie	50	2	25	294	Martinvast	1189	31	1220
25	Basse-Normandie	50	4	26	295	Maupertuis	135	4	139
25	Basse-Normandie	50	2	38	296	Maupertus-sur-Mer	256	4	260
25	Basse-Normandie	50	4	31	297	La Meauffe	1081	30	1111
25	Basse-Normandie	50	4	09	298	Méautis	651	27	678
25	Basse-Normandie	50	2	03	299	Le Mesnil	198	8	206
25	Basse-Normandie	50	1	19	300	Le Mesnil-Adelée	189	5	194
25	Basse-Normandie	50	3	14	301	Le Mesnil-Amand	162	1	163
25	Basse-Normandie	50	4	21	302	Le Mesnil-Amey	272	15	287
25	Basse-Normandie	50	2	51	305	Le Mesnil-au-Val	676	21	697
25	Basse-Normandie	50	3	06	304	Le Mesnil-Aubert	155	3	158
25	Basse-Normandie	50	4	21	310	Le Mesnil-Eury	187	1	188
25	Basse-Normandie	50	3	14	311	Le Mesnil-Garnier	230	9	239
25	Basse-Normandie	50	1	39	312	Le Mesnil-Gilbert	150	4	154
25	Basse-Normandie	50	4	08	313	Le Mesnil-Herman	148	7	155
25	Basse-Normandie	50	4	45	316	Le Mesnil-Opac	266	6	272
25	Basse-Normandie	50	1	13	317	Le Mesnil-Ozenne	245	1	246
25	Basse-Normandie	50	1	19	318	Le Mesnil-Rainfray	244	8	252
25	Basse-Normandie	50	4	45	319	Le Mesnil-Raoult	386	10	396
25	Basse-Normandie	50	3	14	320	Le Mesnil-Rogues	168	5	173
25	Basse-Normandie	50	4	52	321	Le Mesnil-Rouxelin	506	19	525
25	Basse-Normandie	50	1	19	323	Le Mesnil-Tôve	234	0	234
25	Basse-Normandie	50	4	34	324	Le Mesnil-Véneron	109	1	110
25	Basse-Normandie	50	4	21	325	Le Mesnil-Vigot	261	5	266
25	Basse-Normandie	50	3	14	326	Le Mesnil-Villeman	224	3	227
25	Basse-Normandie	50	3	40	308	Le Mesnilbus	286	6	292
25	Basse-Normandie	50	1	32	315	Le Mesnillard	281	8	289
25	Basse-Normandie	50	3	06	327	La Meurdraquière	157	0	157
25	Basse-Normandie	50	3	20	328	Millières	736	12	748
25	Basse-Normandie	50	1	32	329	Milly	342	14	356
25	Basse-Normandie	50	3	16	330	Mobecq	251	3	254
25	Basse-Normandie	50	2	03	332	Les Moitiers-d;Allonne	685	17	702
25	Basse-Normandie	50	2	41	333	Les Moitiers-en-Bauptois	334	4	338
25	Basse-Normandie	50	1	29	353	Le Mont-Saint-Michel	43	1	44
25	Basse-Normandie	50	4	26	334	Montabot	291	3	294
25	Basse-Normandie	50	2	47	335	Montaigu-la-Brisette	506	12	518
25	Basse-Normandie	50	3	14	336	Montaigu-les-Bois	238	2	240
25	Basse-Normandie	50	1	33	337	Montanel	369	10	379
25	Basse-Normandie	50	4	26	338	Montbray	362	6	368
25	Basse-Normandie	50	3	23	339	Montchaton	333	15	348
25	Basse-Normandie	50	3	40	340	Montcuit	197	5	202
25	Basse-Normandie	50	2	22	341	Montebourg	2105	110	2215
25	Basse-Normandie	50	2	30	342	Montfarville	800	22	822
25	Basse-Normandie	50	3	16	343	Montgardon	414	16	430
25	Basse-Normandie	50	3	40	345	Monthuchon	607	21	628
25	Basse-Normandie	50	1	33	347	Montjoie-Saint-Martin	272	7	279
25	Basse-Normandie	50	4	34	348	Montmartin-en-Graignes	560	14	574
25	Basse-Normandie	50	3	23	349	Montmartin-sur-Mer	1309	37	1346
25	Basse-Normandie	50	3	10	350	Montpinchon	560	10	570
25	Basse-Normandie	50	4	46	351	Montrabot	80	1	81
25	Basse-Normandie	50	4	21	352	Montreuil-sur-Lozon	306	6	312
25	Basse-Normandie	50	3	36	354	Montsurvent	344	5	349
25	Basse-Normandie	50	1	42	355	Montviron	344	4	348
25	Basse-Normandie	50	4	31	356	Moon-sur-Elle	835	19	854
25	Basse-Normandie	50	4	26	357	Morigny	87	2	89
25	Basse-Normandie	50	2	30	358	Morsalines	204	7	211
25	Basse-Normandie	50	1	24	359	Mortain	1733	194	1927
25	Basse-Normandie	50	2	07	360	Morville	260	8	268
25	Basse-Normandie	50	1	17	361	La Mouche	200	0	200
25	Basse-Normandie	50	1	32	362	Moulines	302	7	309
25	Basse-Normandie	50	4	45	363	Moyon	1129	22	1151
25	Basse-Normandie	50	3	40	364	Muneville-le-Bingard	684	14	698
25	Basse-Normandie	50	3	06	365	Muneville-sur-Mer	392	8	400
25	Basse-Normandie	50	3	27	368	Nay	80	2	82
25	Basse-Normandie	50	2	07	369	Négreville	829	23	852
25	Basse-Normandie	50	2	41	370	Néhou	553	8	561
25	Basse-Normandie	50	1	24	371	Le Neufbourg	488	18	506
25	Basse-Normandie	50	3	16	372	Neufmesnil	190	4	194
25	Basse-Normandie	50	2	37	373	Neuville-au-Plain	108	1	109
25	Basse-Normandie	50	2	41	374	Neuville-en-Beaumont	38	0	38
25	Basse-Normandie	50	2	38	375	Néville-sur-Mer	187	1	188
25	Basse-Normandie	50	3	12	376	Nicorps	422	21	443
25	Basse-Normandie	50	4	31	380	Notre-Dame-d;Elle	130	2	132
25	Basse-Normandie	50	3	10	378	Notre-Dame-de-Cenilly	704	9	713
25	Basse-Normandie	50	1	05	379	Notre-Dame-de-Livoye	127	4	131
25	Basse-Normandie	50	1	24	381	Notre-Dame-du-Touchet	641	31	672
25	Basse-Normandie	50	2	50	382	Nouainville	448	25	473
25	Basse-Normandie	50	2	30	384	Octeville-l;Avenel	193	5	198
25	Basse-Normandie	50	2	04	385	Omonville-la-Petite	137	2	139
25	Basse-Normandie	50	2	04	386	Omonville-la-Rogue	524	15	539
25	Basse-Normandie	50	2	41	387	Orglandes	338	9	347
25	Basse-Normandie	50	3	23	388	Orval	864	20	884
25	Basse-Normandie	50	3	10	389	Ouville	463	15	478
25	Basse-Normandie	50	2	22	390	Ozeville	148	1	149
25	Basse-Normandie	50	1	32	391	Parigny	1832	75	1907
25	Basse-Normandie	50	4	26	393	Percy	2281	82	2363
25	Basse-Normandie	50	3	27	394	Périers	2390	72	2462
25	Basse-Normandie	50	2	30	395	La Pernelle	249	6	255
25	Basse-Normandie	50	2	07	396	Les Perques	161	5	166
25	Basse-Normandie	50	1	43	397	Perriers-en-Beauficel	226	7	233
25	Basse-Normandie	50	4	46	398	Le Perron	188	1	189
25	Basse-Normandie	50	1	05	399	Le Petit-Celland	183	6	189
25	Basse-Normandie	50	2	37	400	Picauville	1934	35	1969
25	Basse-Normandie	50	2	28	401	Pierreville	702	15	717
25	Basse-Normandie	50	2	28	402	Les Pieux	3558	105	3663
25	Basse-Normandie	50	3	20	403	Pirou	1589	43	1632
25	Basse-Normandie	50	4	46	404	Placy-Montaigu	219	6	225
25	Basse-Normandie	50	3	27	405	Le Plessis-Lastelle	258	4	262
25	Basse-Normandie	50	1	01	406	Plomb	403	15	418
25	Basse-Normandie	50	1	13	407	Poilley	869	26	895
25	Basse-Normandie	50	4	34	409	Pont-Hébert	1780	47	1827
25	Basse-Normandie	50	1	01	408	Pontaubault	472	11	483
25	Basse-Normandie	50	1	29	410	Pontorson	4114	74	4188
25	Basse-Normandie	50	1	01	411	Ponts	592	15	607
25	Basse-Normandie	50	2	03	412	Portbail	1656	73	1729
25	Basse-Normandie	50	1	13	413	Précey	488	7	495
25	Basse-Normandie	50	4	46	414	Précorbin	522	10	532
25	Basse-Normandie	50	3	16	415	Prétot-Sainte-Suzanne	315	9	324
25	Basse-Normandie	50	2	50	416	Querqueville	5244	140	5384
25	Basse-Normandie	50	2	30	417	Quettehou	1586	36	1622
25	Basse-Normandie	50	2	07	418	Quettetot	728	19	747
25	Basse-Normandie	50	3	23	419	Quettreville-sur-Sienne	1438	37	1475
25	Basse-Normandie	50	4	08	420	Quibou	918	15	933
25	Basse-Normandie	50	2	22	421	Quinéville	298	2	300
25	Basse-Normandie	50	4	09	422	Raids	192	5	197
25	Basse-Normandie	50	4	52	423	Rampan	218	8	226
25	Basse-Normandie	50	2	07	425	Rauville-la-Bigot	1188	19	1207
25	Basse-Normandie	50	2	41	426	Rauville-la-Place	388	3	391
25	Basse-Normandie	50	2	37	427	Ravenoville	263	9	272
25	Basse-Normandie	50	1	19	428	Reffuveille	476	4	480
25	Basse-Normandie	50	3	23	429	Regnéville-sur-Mer	831	30	861
25	Basse-Normandie	50	2	41	430	Reigneville-Bocage	30	0	30
25	Basse-Normandie	50	4	21	431	Remilly-sur-Lozon	660	6	666
25	Basse-Normandie	50	2	38	432	Réthoville	134	3	137
25	Basse-Normandie	50	2	30	433	Réville	1179	32	1211
25	Basse-Normandie	50	1	17	434	La Rochelle-Normande	316	10	326
25	Basse-Normandie	50	2	07	435	Rocheville	649	20	669
25	Basse-Normandie	50	1	24	436	Romagny	1030	40	1070
25	Basse-Normandie	50	3	10	437	Roncey	826	13	839
25	Basse-Normandie	50	3	40	438	La Ronde-Haye	347	7	354
25	Basse-Normandie	50	4	48	440	Rouffigny	320	6	326
25	Basse-Normandie	50	4	46	441	Rouxeville	337	2	339
25	Basse-Normandie	50	2	28	442	Le Rozel	282	12	294
25	Basse-Normandie	50	1	29	443	Sacey	545	9	554
25	Basse-Normandie	50	4	46	444	Saint-Amand	2257	62	2319
25	Basse-Normandie	50	4	09	445	Saint-André-de-Bohon	313	6	319
25	Basse-Normandie	50	4	31	446	Saint-André-de-l;Épine	538	18	556
25	Basse-Normandie	50	1	33	448	Saint-Aubin-de-Terregatte	711	9	720
25	Basse-Normandie	50	1	15	447	Saint-Aubin-des-Préaux	413	18	431
25	Basse-Normandie	50	3	40	449	Saint-Aubin-du-Perron	238	9	247
25	Basse-Normandie	50	1	24	450	Saint-Barthélemy	348	13	361
25	Basse-Normandie	50	1	01	451	Saint-Brice	136	5	141
25	Basse-Normandie	50	1	32	452	Saint-Brice-de-Landelles	664	13	677
25	Basse-Normandie	50	2	28	454	Saint-Christophe-du-Foc	398	9	407
25	Basse-Normandie	50	4	31	455	Saint-Clair-sur-l;Elle	911	20	931
25	Basse-Normandie	50	1	24	456	Saint-Clément-Rancoudray	536	6	542
25	Basse-Normandie	50	4	09	458	Saint-Côme-du-Mont	534	21	555
25	Basse-Normandie	50	2	22	461	Saint-Cyr	210	2	212
25	Basse-Normandie	50	1	02	462	Saint-Cyr-du-Bailleul	406	8	414
25	Basse-Normandie	50	3	14	463	Saint-Denis-le-Gast	557	10	567
25	Basse-Normandie	50	3	10	464	Saint-Denis-le-Vêtu	608	14	622
25	Basse-Normandie	50	4	08	465	Saint-Ébremond-de-Bonfossé	768	23	791
25	Basse-Normandie	50	2	22	467	Saint-Floxel	473	15	488
25	Basse-Normandie	50	4	34	468	Saint-Fromond	763	17	780
25	Basse-Normandie	50	4	31	473	Saint-Georges-d;Elle	384	9	393
25	Basse-Normandie	50	4	09	470	Saint-Georges-de-Bohon	407	11	418
25	Basse-Normandie	50	2	03	471	Saint-Georges-de-la-Rivière	280	9	289
25	Basse-Normandie	50	1	05	472	Saint-Georges-de-Livoye	209	2	211
25	Basse-Normandie	50	1	02	474	Saint-Georges-de-Rouelley	542	4	546
25	Basse-Normandie	50	4	52	475	Saint-Georges-Montcocq	829	54	883
25	Basse-Normandie	50	4	31	476	Saint-Germain-d;Elle	204	2	206
25	Basse-Normandie	50	2	22	478	Saint-Germain-de-Tournebut	394	6	400
25	Basse-Normandie	50	2	37	479	Saint-Germain-de-Varreville	119	2	121
25	Basse-Normandie	50	2	04	477	Saint-Germain-des-Vaux	414	6	420
25	Basse-Normandie	50	2	28	480	Saint-Germain-le-Gaillard	703	28	731
25	Basse-Normandie	50	3	20	481	Saint-Germain-sur-Ay	897	23	920
25	Basse-Normandie	50	3	27	482	Saint-Germain-sur-Sèves	199	3	202
25	Basse-Normandie	50	4	21	483	Saint-Gilles	903	29	932
25	Basse-Normandie	50	1	32	484	Saint-Hilaire-du-Harcouët	3959	250	4209
25	Basse-Normandie	50	4	09	485	Saint-Hilaire-Petitville	1362	50	1412
25	Basse-Normandie	50	2	41	486	Saint-Jacques-de-Néhou	534	12	546
25	Basse-Normandie	50	1	33	487	Saint-James	2678	101	2779
25	Basse-Normandie	50	4	34	488	Saint-Jean-de-Daye	601	15	616
25	Basse-Normandie	50	1	01	489	Saint-Jean-de-la-Haize	500	18	518
25	Basse-Normandie	50	2	03	490	Saint-Jean-de-la-Rivière	355	12	367
25	Basse-Normandie	50	4	31	491	Saint-Jean-de-Savigny	381	13	394
25	Basse-Normandie	50	4	46	492	Saint-Jean-des-Baisants	1203	30	1233
25	Basse-Normandie	50	1	17	493	Saint-Jean-des-Champs	1328	42	1370
25	Basse-Normandie	50	1	24	494	Saint-Jean-du-Corail	265	7	272
25	Basse-Normandie	50	1	05	495	Saint-Jean-du-Corail-des-Bois	77	0	77
25	Basse-Normandie	50	1	42	496	Saint-Jean-le-Thomas	430	11	441
25	Basse-Normandie	50	3	27	497	Saint-Jores	361	4	365
25	Basse-Normandie	50	2	47	498	Saint-Joseph	805	23	828
25	Basse-Normandie	50	1	39	499	Saint-Laurent-de-Cuves	488	10	498
25	Basse-Normandie	50	1	33	500	Saint-Laurent-de-Terregatte	566	13	579
25	Basse-Normandie	50	4	95	502	Saint-Lô	18718	1226	19944
25	Basse-Normandie	50	2	03	503	Saint-Lô-d;Ourville	530	21	551
25	Basse-Normandie	50	4	45	504	Saint-Louet-sur-Vire	199	4	203
25	Basse-Normandie	50	1	01	505	Saint-Loup	697	21	718
25	Basse-Normandie	50	3	36	506	Saint-Malo-de-la-Lande	461	4	465
25	Basse-Normandie	50	2	22	507	Saint-Marcouf	331	5	336
25	Basse-Normandie	50	3	27	510	Saint-Martin-d;Aubigny	538	18	556
25	Basse-Normandie	50	2	22	511	Saint-Martin-d;Audouville	125	1	126
25	Basse-Normandie	50	4	08	512	Saint-Martin-de-Bonfossé	543	17	560
25	Basse-Normandie	50	3	10	513	Saint-Martin-de-Cenilly	202	9	211
25	Basse-Normandie	50	1	32	515	Saint-Martin-de-Landelles	1190	32	1222
25	Basse-Normandie	50	2	37	517	Saint-Martin-de-Varreville	217	0	217
25	Basse-Normandie	50	1	01	516	Saint-Martin-des-Champs	2223	133	2356
25	Basse-Normandie	50	1	39	518	Saint-Martin-le-Bouillant	291	2	293
25	Basse-Normandie	50	2	25	519	Saint-Martin-le-Gréard	434	9	443
25	Basse-Normandie	50	2	07	520	Saint-Martin-le-Hébert	136	2	138
25	Basse-Normandie	50	1	39	521	Saint-Maur-des-Bois	131	4	135
25	Basse-Normandie	50	2	03	522	Saint-Maurice-en-Cotentin	288	10	298
25	Basse-Normandie	50	3	40	524	Saint-Michel-de-la-Pierre	205	7	212
25	Basse-Normandie	50	1	39	525	Saint-Michel-de-Montjoie	313	3	316
25	Basse-Normandie	50	3	16	528	Saint-Nicolas-de-Pierrepont	262	3	265
25	Basse-Normandie	50	1	05	529	Saint-Nicolas-des-Bois	111	0	111
25	Basse-Normandie	50	1	99	531	Saint-Ovin	769	14	783
25	Basse-Normandie	50	1	15	532	Saint-Pair-sur-Mer	3842	147	3989
25	Basse-Normandie	50	3	20	533	Saint-Patrice-de-Claids	157	2	159
25	Basse-Normandie	50	4	09	534	Saint-Pellerin	394	6	400
25	Basse-Normandie	50	2	03	536	Saint-Pierre-d;Arthéglise	151	2	153
25	Basse-Normandie	50	3	12	537	Saint-Pierre-de-Coutances	410	12	422
25	Basse-Normandie	50	4	31	538	Saint-Pierre-de-Semilly	420	20	440
25	Basse-Normandie	50	2	38	539	Saint-Pierre-Église	1785	34	1819
25	Basse-Normandie	50	1	42	540	Saint-Pierre-Langers	552	22	574
25	Basse-Normandie	50	1	15	541	Saint-Planchers	1347	47	1394
25	Basse-Normandie	50	1	39	542	Saint-Pois	494	29	523
25	Basse-Normandie	50	1	13	543	Saint-Quentin-sur-le-Homme	1251	40	1291
25	Basse-Normandie	50	3	16	544	Saint-Rémy-des-Landes	208	7	215
25	Basse-Normandie	50	4	08	545	Saint-Romphaire	744	9	753
25	Basse-Normandie	50	4	08	546	Saint-Samson-de-Bonfossé	901	32	933
25	Basse-Normandie	50	3	16	548	Saint-Sauveur-de-Pierrepont	132	2	134
25	Basse-Normandie	50	3	06	549	Saint-Sauveur-la-Pommeraye	308	11	319
25	Basse-Normandie	50	2	41	551	Saint-Sauveur-le-Vicomte	2082	36	2118
25	Basse-Normandie	50	3	40	550	Saint-Sauveur-Lendelin	1692	89	1781
25	Basse-Normandie	50	3	27	552	Saint-Sébastien-de-Raids	362	4	366
25	Basse-Normandie	50	1	33	553	Saint-Senier-de-Beuvron	309	6	315
25	Basse-Normandie	50	1	01	554	Saint-Senier-sous-Avranches	1282	73	1355
25	Basse-Normandie	50	1	44	557	Saint-Symphorien-des-Monts	142	1	143
25	Basse-Normandie	50	3	16	558	Saint-Symphorien-le-Valois	822	28	850
25	Basse-Normandie	50	2	30	562	Saint-Vaast-la-Hougue	2028	51	2079
25	Basse-Normandie	50	4	45	563	Saint-Vigor-des-Monts	295	5	300
25	Basse-Normandie	50	4	48	453	Sainte-Cécile	814	31	845
25	Basse-Normandie	50	2	41	457	Sainte-Colombe	215	1	216
25	Basse-Normandie	50	2	04	460	Sainte-Croix-Hague	752	20	772
25	Basse-Normandie	50	2	30	469	Sainte-Geneviève	313	13	326
25	Basse-Normandie	50	1	44	508	Sainte-Marie-du-Bois	58	2	60
25	Basse-Normandie	50	2	37	509	Sainte-Marie-du-Mont	750	21	771
25	Basse-Normandie	50	2	37	523	Sainte-Mère-Église	1632	34	1666
25	Basse-Normandie	50	1	17	535	Sainte-Pience	298	6	304
25	Basse-Normandie	50	4	35	556	Sainte-Suzanne-sur-Vire	552	43	595
25	Basse-Normandie	50	4	09	564	Sainteny	811	28	839
25	Basse-Normandie	50	1	42	565	Sartilly	1535	21	1556
25	Basse-Normandie	50	2	47	567	Saussemesnil	920	16	936
25	Basse-Normandie	50	3	12	568	Saussey	502	25	527
25	Basse-Normandie	50	3	10	569	Savigny	412	4	416
25	Basse-Normandie	50	1	44	570	Savigny-le-Vieux	422	9	431
25	Basse-Normandie	50	2	37	571	Sébeville	32	1	33
25	Basse-Normandie	50	2	03	572	Sénoville	214	8	222
25	Basse-Normandie	50	3	36	573	Servigny	211	3	214
25	Basse-Normandie	50	1	29	574	Servon	255	2	257
25	Basse-Normandie	50	2	50	575	Sideville	566	15	581
25	Basse-Normandie	50	2	28	576	Siouville-Hague	1104	42	1146
25	Basse-Normandie	50	2	22	578	Sortosville	103	6	109
25	Basse-Normandie	50	2	03	577	Sortosville-en-Beaumont	312	4	316
25	Basse-Normandie	50	2	07	579	Sottevast	1353	33	1386
25	Basse-Normandie	50	2	28	580	Sotteville	464	6	470
25	Basse-Normandie	50	4	08	581	Soulles	468	5	473
25	Basse-Normandie	50	1	43	582	Sourdeval	2782	65	2847
25	Basse-Normandie	50	3	14	583	Sourdeval-les-Bois	176	7	183
25	Basse-Normandie	50	1	17	584	Subligny	344	8	352
25	Basse-Normandie	50	2	28	585	Surtainville	1235	33	1268
25	Basse-Normandie	50	3	16	586	Surville	196	5	201
25	Basse-Normandie	50	2	41	587	Taillepied	29	1	30
25	Basse-Normandie	50	2	47	588	Tamerville	644	19	663
25	Basse-Normandie	50	1	29	589	Tanis	315	13	328
25	Basse-Normandie	50	1	17	590	Le Tanu	353	6	359
25	Basse-Normandie	50	1	44	591	Le Teilleul	1284	38	1322
25	Basse-Normandie	50	4	45	592	Tessy-sur-Vire	1454	32	1486
25	Basse-Normandie	50	2	30	593	Teurthéville-Bocage	615	10	625
25	Basse-Normandie	50	2	50	594	Teurthéville-Hague	915	25	940
25	Basse-Normandie	50	2	38	595	Le Theil	671	7	678
25	Basse-Normandie	50	2	38	596	Théville	304	12	316
25	Basse-Normandie	50	1	05	597	Tirepied	777	32	809
25	Basse-Normandie	50	2	38	598	Tocqueville	260	10	270
25	Basse-Normandie	50	2	25	599	Tollevast	1198	54	1252
25	Basse-Normandie	50	2	04	600	Tonneville	658	29	687
25	Basse-Normandie	50	4	46	601	Torigni-sur-Vire	2377	43	2420
25	Basse-Normandie	50	2	51	602	Tourlaville	15910	467	16377
25	Basse-Normandie	50	3	36	603	Tourville-sur-Sienne	776	23	799
25	Basse-Normandie	50	2	28	604	Tréauville	723	27	750
25	Basse-Normandie	50	3	23	605	Trelly	668	12	680
25	Basse-Normandie	50	4	34	606	Tribehou	496	16	512
25	Basse-Normandie	50	4	48	607	La Trinité	398	5	403
25	Basse-Normandie	50	4	45	608	Troisgots	283	30	313
25	Basse-Normandie	50	2	37	609	Turqueville	144	5	149
25	Basse-Normandie	50	2	22	610	Urville	194	6	200
25	Basse-Normandie	50	2	04	611	Urville-Nacqueville	2183	125	2308
25	Basse-Normandie	50	1	01	612	Vains	724	43	767
25	Basse-Normandie	50	1	01	616	Le Val-Saint-Père	1853	106	1959
25	Basse-Normandie	50	2	30	613	Valcanville	372	8	380
25	Basse-Normandie	50	2	07	614	Le Valdécie	118	6	124
25	Basse-Normandie	50	2	47	615	Valognes	7190	370	7560
25	Basse-Normandie	50	3	16	617	Varenguebec	361	2	363
25	Basse-Normandie	50	2	38	618	Varouville	267	8	275
25	Basse-Normandie	50	2	38	619	Le Vast	304	4	308
25	Basse-Normandie	50	2	04	620	Vasteville	1108	34	1142
25	Basse-Normandie	50	2	22	621	Vaudreville	80	1	81
25	Basse-Normandie	50	3	40	622	Vaudrimesnil	393	12	405
25	Basse-Normandie	50	2	04	623	Vauville	383	13	396
25	Basse-Normandie	50	3	36	624	La Vendelée	431	7	438
25	Basse-Normandie	50	1	43	625	Vengeons	481	9	490
25	Basse-Normandie	50	3	14	626	Ver	375	7	382
25	Basse-Normandie	50	1	33	627	Vergoncey	211	2	213
25	Basse-Normandie	50	1	05	628	Vernix	171	10	181
25	Basse-Normandie	50	3	98	629	Vesly	659	11	670
25	Basse-Normandie	50	1	29	630	Vessey	411	6	417
25	Basse-Normandie	50	4	09	631	Les Veys	401	10	411
25	Basse-Normandie	50	2	30	633	Le Vicel	146	1	147
25	Basse-Normandie	50	2	30	634	Videcosville	87	3	90
25	Basse-Normandie	50	4	46	635	Vidouville	130	4	134
25	Basse-Normandie	50	2	37	636	Vierville	39	3	42
25	Basse-Normandie	50	4	26	637	Villebaudon	299	4	303
25	Basse-Normandie	50	1	24	638	Villechien	192	4	196
25	Basse-Normandie	50	4	48	639	Villedieu-les-Poêles	3871	137	4008
25	Basse-Normandie	50	4	31	641	Villiers-Fossard	558	15	573
25	Basse-Normandie	50	1	33	640	Villiers-le-Pré	192	9	201
25	Basse-Normandie	50	3	16	642	Vindefontaine	312	10	322
25	Basse-Normandie	50	2	50	643	Virandeville	804	30	834
25	Basse-Normandie	50	1	32	644	Virey	1028	23	1051
25	Basse-Normandie	50	2	07	646	Le Vrétot	585	17	602
25	Basse-Normandie	50	1	15	647	Yquelon	1014	44	1058
25	Basse-Normandie	50	2	47	648	Yvetot-Bocage	1139	39	1178
21	Champagne-Ardenne	51	4	33	001	Ablancourt	151	6	157
21	Champagne-Ardenne	51	1	35	003	Aigny	239	4	243
21	Champagne-Ardenne	51	2	01	004	Allemanche-Launay-et-Soyer	113	2	115
21	Champagne-Ardenne	51	2	25	005	Allemant	176	2	178
21	Champagne-Ardenne	51	4	15	006	Alliancelles	143	5	148
21	Champagne-Ardenne	51	2	03	007	Ambonnay	919	16	935
21	Champagne-Ardenne	51	4	24	008	Ambrières	220	3	223
21	Champagne-Ardenne	51	2	01	009	Anglure	848	19	867
21	Champagne-Ardenne	51	2	13	010	Angluzelles-et-Courcelles	138	2	140
21	Champagne-Ardenne	51	3	07	012	Anthenay	76	1	77
21	Champagne-Ardenne	51	3	31	013	Aougny	101	3	104
21	Champagne-Ardenne	51	3	14	014	Arcis-le-Ponsart	271	4	275
21	Champagne-Ardenne	51	5	23	015	Argers	112	3	115
21	Champagne-Ardenne	51	4	24	016	Arrigny	266	5	271
21	Champagne-Ardenne	51	4	24	017	Arzillières-Neuville	364	8	372
21	Champagne-Ardenne	51	1	10	018	Athis	823	9	832
21	Champagne-Ardenne	51	3	04	019	Aubérive	232	5	237
21	Champagne-Ardenne	51	3	31	020	Aubilly	49	1	50
21	Champagne-Ardenne	51	4	33	022	Aulnay-l;Aître	139	3	142
21	Champagne-Ardenne	51	1	10	023	Aulnay-sur-Marne	228	1	229
21	Champagne-Ardenne	51	3	05	025	Auménancourt	941	20	961
21	Champagne-Ardenne	51	5	08	027	Auve	253	28	281
21	Champagne-Ardenne	51	2	03	028	Avenay-Val-d;Or	911	14	925
21	Champagne-Ardenne	51	2	02	029	Avize	1719	160	1879
21	Champagne-Ardenne	51	2	03	030	Ay	4079	54	4133
21	Champagne-Ardenne	51	3	30	031	Baconnes	292	7	299
21	Champagne-Ardenne	51	2	01	032	Bagneux	492	6	498
21	Champagne-Ardenne	51	2	18	033	Le Baizil	267	6	273
21	Champagne-Ardenne	51	2	18	034	Bannay	18	2	20
21	Champagne-Ardenne	51	2	13	035	Bannes	268	5	273
21	Champagne-Ardenne	51	2	25	036	Barbonne-Fayel	490	8	498
21	Champagne-Ardenne	51	3	14	037	Baslieux-lès-Fismes	297	11	308
21	Champagne-Ardenne	51	3	07	038	Baslieux-sous-Châtillon	187	4	191
21	Champagne-Ardenne	51	4	15	039	Bassu	127	1	128
21	Champagne-Ardenne	51	4	15	040	Bassuet	265	9	274
21	Champagne-Ardenne	51	2	01	041	Baudement	120	1	121
21	Champagne-Ardenne	51	2	18	042	Baye	393	11	404
21	Champagne-Ardenne	51	3	05	043	Bazancourt	1958	21	1979
21	Champagne-Ardenne	51	3	30	044	Beaumont-sur-Vesle	713	18	731
21	Champagne-Ardenne	51	2	18	045	Beaunay	95	2	97
21	Champagne-Ardenne	51	3	04	046	Beine-Nauroy	1047	13	1060
21	Champagne-Ardenne	51	5	08	047	Belval-en-Argonne	50	0	50
21	Champagne-Ardenne	51	3	07	048	Belval-sous-Châtillon	176	4	180
21	Champagne-Ardenne	51	1	29	049	Bergères-lès-Vertus	569	19	588
21	Champagne-Ardenne	51	2	17	050	Bergères-sous-Montmirail	135	1	136
21	Champagne-Ardenne	51	3	05	051	Berméricourt	153	3	156
21	Champagne-Ardenne	51	3	04	052	Berru	501	8	509
21	Champagne-Ardenne	51	5	32	053	Berzieux	72	3	75
21	Champagne-Ardenne	51	3	04	054	Bétheniville	1161	19	1180
21	Champagne-Ardenne	51	3	22	055	Bétheny	6445	83	6528
21	Champagne-Ardenne	51	2	12	056	Bethon	280	6	286
21	Champagne-Ardenne	51	4	15	057	Bettancourt-la-Longue	87	4	91
21	Champagne-Ardenne	51	3	38	058	Bezannes	1425	84	1509
21	Champagne-Ardenne	51	4	33	059	Bignicourt-sur-Marne	374	8	382
21	Champagne-Ardenne	51	4	28	060	Bignicourt-sur-Saulx	176	1	177
21	Champagne-Ardenne	51	1	27	061	Billy-le-Grand	110	1	111
21	Champagne-Ardenne	51	5	32	062	Binarville	106	2	108
21	Champagne-Ardenne	51	3	07	063	Binson-et-Orquigny	185	0	185
21	Champagne-Ardenne	51	2	03	064	Bisseuil	647	12	659
21	Champagne-Ardenne	51	4	34	065	Blacy	664	18	682
21	Champagne-Ardenne	51	4	24	066	Blaise-sous-Arzillières	336	31	367
21	Champagne-Ardenne	51	4	28	068	Blesme	198	2	200
21	Champagne-Ardenne	51	3	31	069	Bligny	109	3	112
21	Champagne-Ardenne	51	2	17	070	Boissy-le-Repos	203	3	206
21	Champagne-Ardenne	51	2	12	071	Bouchy-Saint-Genest	176	4	180
21	Champagne-Ardenne	51	3	31	072	Bouilly	169	3	172
21	Champagne-Ardenne	51	3	31	073	Bouleuse	173	1	174
21	Champagne-Ardenne	51	3	05	074	Boult-sur-Suippe	1645	21	1666
21	Champagne-Ardenne	51	3	05	075	Bourgogne	1032	15	1047
21	Champagne-Ardenne	51	2	09	076	Boursault	461	14	475
21	Champagne-Ardenne	51	3	14	077	Bouvancourt	198	5	203
21	Champagne-Ardenne	51	1	27	078	Bouy	502	11	513
21	Champagne-Ardenne	51	2	03	079	Bouzy	945	16	961
21	Champagne-Ardenne	51	4	24	080	Brandonvillers	159	3	162
21	Champagne-Ardenne	51	3	31	081	Branscourt	252	3	255
21	Champagne-Ardenne	51	5	23	083	Braux-Saint-Remy	93	1	94
21	Champagne-Ardenne	51	5	23	082	Braux-Sainte-Cohière	88	3	91
21	Champagne-Ardenne	51	4	26	084	Bréban	90	2	92
21	Champagne-Ardenne	51	2	09	085	Le Breuil	407	7	414
21	Champagne-Ardenne	51	3	14	086	Breuil	326	3	329
21	Champagne-Ardenne	51	1	10	087	Breuvery-sur-Coole	204	10	214
21	Champagne-Ardenne	51	3	05	088	Brimont	443	8	451
21	Champagne-Ardenne	51	3	31	089	Brouillet	93	0	93
21	Champagne-Ardenne	51	2	13	090	Broussy-le-Grand	309	9	318
21	Champagne-Ardenne	51	2	25	091	Broussy-le-Petit	130	1	131
21	Champagne-Ardenne	51	2	25	092	Broyes	373	7	380
21	Champagne-Ardenne	51	2	02	093	Brugny-Vaudancourt	450	13	463
21	Champagne-Ardenne	51	4	28	094	Brusson	213	3	216
21	Champagne-Ardenne	51	4	28	095	Le Buisson	86	6	92
21	Champagne-Ardenne	51	1	27	097	Bussy-le-Château	164	7	171
21	Champagne-Ardenne	51	4	15	098	Bussy-le-Repos	127	2	129
21	Champagne-Ardenne	51	1	10	099	Bussy-Lettrée	324	8	332
21	Champagne-Ardenne	51	2	18	100	La Caure	91	4	95
21	Champagne-Ardenne	51	3	05	101	Caurel	645	13	658
21	Champagne-Ardenne	51	3	05	102	Cauroy-lès-Hermonville	474	6	480
21	Champagne-Ardenne	51	2	01	103	La Celle-sous-Chantemerle	164	4	168
21	Champagne-Ardenne	51	5	32	104	Cernay-en-Dormois	148	0	148
21	Champagne-Ardenne	51	3	04	105	Cernay-lès-Reims	1316	28	1344
21	Champagne-Ardenne	51	1	10	106	Cernon	137	3	140
21	Champagne-Ardenne	51	1	29	107	Chaintrix-Bierges	288	6	294
21	Champagne-Ardenne	51	1	96	108	Châlons-en-Champagne	45299	1369	46668
21	Champagne-Ardenne	51	3	14	109	Châlons-sur-Vesle	160	7	167
21	Champagne-Ardenne	51	2	18	110	Chaltrait	74	2	76
21	Champagne-Ardenne	51	3	31	111	Chambrecy	142	1	143
21	Champagne-Ardenne	51	3	30	112	Chamery	389	11	400
21	Champagne-Ardenne	51	2	18	113	Champaubert	135	3	138
21	Champagne-Ardenne	51	3	30	115	Champfleury	534	10	544
21	Champagne-Ardenne	51	2	12	116	Champguyon	264	7	271
21	Champagne-Ardenne	51	1	10	117	Champigneul-Champagne	286	6	292
21	Champagne-Ardenne	51	3	41	118	Champigny	1345	23	1368
21	Champagne-Ardenne	51	2	03	119	Champillon	521	14	535
21	Champagne-Ardenne	51	3	07	120	Champlat-et-Boujacourt	148	2	150
21	Champagne-Ardenne	51	2	09	121	Champvoisy	264	7	271
21	Champagne-Ardenne	51	4	15	122	Changy	111	7	118
21	Champagne-Ardenne	51	2	12	124	Chantemerle	53	2	55
21	Champagne-Ardenne	51	4	26	125	Chapelaine	56	2	58
21	Champagne-Ardenne	51	5	23	126	La Chapelle-Felcourt	63	1	64
21	Champagne-Ardenne	51	2	01	127	La Chapelle-Lasson	87	6	93
21	Champagne-Ardenne	51	2	18	128	La Chapelle-sous-Orbais	52	2	54
21	Champagne-Ardenne	51	2	17	129	Charleville	272	8	280
21	Champagne-Ardenne	51	4	15	130	Charmont	222	6	228
21	Champagne-Ardenne	51	5	08	132	Les Charmontois	127	5	132
21	Champagne-Ardenne	51	5	08	133	Le Châtelier	56	2	58
21	Champagne-Ardenne	51	4	24	134	Châtelraould-Saint-Louvent	241	10	251
21	Champagne-Ardenne	51	4	24	135	Châtillon-sur-Broué	68	2	70
21	Champagne-Ardenne	51	3	07	136	Châtillon-sur-Marne	713	139	852
21	Champagne-Ardenne	51	2	12	137	Châtillon-sur-Morin	190	9	199
21	Champagne-Ardenne	51	5	23	138	Châtrices	33	1	34
21	Champagne-Ardenne	51	5	23	139	Chaudefontaine	327	10	337
21	Champagne-Ardenne	51	3	31	140	Chaumuzy	357	1	358
21	Champagne-Ardenne	51	4	33	141	La Chaussée-sur-Marne	713	17	730
21	Champagne-Ardenne	51	2	02	142	Chavot-Courcourt	378	10	388
21	Champagne-Ardenne	51	5	08	143	Le Chemin	56	2	58
21	Champagne-Ardenne	51	4	28	144	Cheminon	633	16	649
21	Champagne-Ardenne	51	3	14	145	Chenay	268	16	284
21	Champagne-Ardenne	51	1	10	146	Cheniers	116	0	116
21	Champagne-Ardenne	51	1	27	147	La Cheppe	332	15	347
21	Champagne-Ardenne	51	1	10	148	Cheppes-la-Prairie	178	2	180
21	Champagne-Ardenne	51	1	16	149	Chepy	413	15	428
21	Champagne-Ardenne	51	1	10	150	Cherville	93	3	96
21	Champagne-Ardenne	51	2	25	151	Chichey	161	4	165
21	Champagne-Ardenne	51	3	30	152	Chigny-les-Roses	522	7	529
21	Champagne-Ardenne	51	2	37	153	Chouilly	999	16	1015
21	Champagne-Ardenne	51	1	29	154	Clamanges	232	5	237
21	Champagne-Ardenne	51	2	01	155	Clesles	588	6	594
21	Champagne-Ardenne	51	4	28	156	Cloyes-sur-Marne	122	5	127
21	Champagne-Ardenne	51	2	18	157	Coizard-Joches	84	1	85
21	Champagne-Ardenne	51	1	36	160	Compertrix	1338	45	1383
21	Champagne-Ardenne	51	1	35	161	Condé-sur-Marne	713	7	720
21	Champagne-Ardenne	51	2	01	162	Conflans-sur-Seine	678	13	691
21	Champagne-Ardenne	51	2	18	163	Congy	259	4	263
21	Champagne-Ardenne	51	2	13	164	Connantray-Vaurefroy	187	5	192
21	Champagne-Ardenne	51	2	13	165	Connantre	1053	40	1093
21	Champagne-Ardenne	51	5	08	166	Contault	71	3	74
21	Champagne-Ardenne	51	4	26	167	Coole	141	3	144
21	Champagne-Ardenne	51	1	36	168	Coolus	213	8	221
21	Champagne-Ardenne	51	4	26	169	Corbeil	97	2	99
21	Champagne-Ardenne	51	2	17	170	Corfélix	105	1	106
21	Champagne-Ardenne	51	3	05	171	Cormicy	1415	31	1446
21	Champagne-Ardenne	51	3	40	172	Cormontreuil	6082	113	6195
21	Champagne-Ardenne	51	2	03	173	Cormoyeux	118	4	122
21	Champagne-Ardenne	51	2	18	174	Corribert	56	1	57
21	Champagne-Ardenne	51	2	17	175	Corrobert	185	9	194
21	Champagne-Ardenne	51	2	13	176	Corroy	149	2	151
21	Champagne-Ardenne	51	3	31	177	Coulommes-la-Montagne	223	10	233
21	Champagne-Ardenne	51	1	10	178	Coupetz	83	3	86
21	Champagne-Ardenne	51	1	16	179	Coupéville	187	3	190
21	Champagne-Ardenne	51	3	31	181	Courcelles-Sapicourt	345	3	348
21	Champagne-Ardenne	51	2	13	182	Courcemain	128	1	129
21	Champagne-Ardenne	51	3	05	183	Courcy	1286	19	1305
21	Champagne-Ardenne	51	4	34	184	Courdemanges	403	13	416
21	Champagne-Ardenne	51	2	12	185	Courgivaux	283	7	290
21	Champagne-Ardenne	51	2	18	186	Courjeonnet	56	1	57
21	Champagne-Ardenne	51	3	14	187	Courlandon	288	2	290
21	Champagne-Ardenne	51	3	31	188	Courmas	170	4	174
21	Champagne-Ardenne	51	3	07	190	Courtagnon	56	3	59
21	Champagne-Ardenne	51	5	23	191	Courtémont	66	2	68
21	Champagne-Ardenne	51	2	09	192	Courthiézy	330	13	343
21	Champagne-Ardenne	51	1	16	193	Courtisols	2552	107	2659
21	Champagne-Ardenne	51	3	14	194	Courville	464	8	472
21	Champagne-Ardenne	51	4	33	195	Couvrot	833	20	853
21	Champagne-Ardenne	51	2	02	196	Cramant	893	14	907
21	Champagne-Ardenne	51	5	23	197	La Croix-en-Champagne	71	3	74
21	Champagne-Ardenne	51	3	14	198	Crugny	594	10	604
21	Champagne-Ardenne	51	3	07	199	Cuchery	421	5	426
21	Champagne-Ardenne	51	2	02	200	Cuis	409	10	419
21	Champagne-Ardenne	51	3	07	201	Cuisles	141	1	142
21	Champagne-Ardenne	51	2	03	202	Cumières	833	12	845
21	Champagne-Ardenne	51	1	27	203	Cuperly	217	6	223
21	Champagne-Ardenne	51	2	37	204	Damery	1507	19	1526
21	Champagne-Ardenne	51	1	27	205	Dampierre-au-Temple	262	12	274
21	Champagne-Ardenne	51	5	08	206	Dampierre-le-Château	99	5	104
21	Champagne-Ardenne	51	1	16	208	Dampierre-sur-Moivre	117	2	119
21	Champagne-Ardenne	51	2	03	210	Dizy	1621	44	1665
21	Champagne-Ardenne	51	5	23	211	Dommartin-Dampierre	73	0	73
21	Champagne-Ardenne	51	4	26	212	Dommartin-Lettrée	155	2	157
21	Champagne-Ardenne	51	5	23	213	Dommartin-sous-Hans	51	3	54
21	Champagne-Ardenne	51	5	08	214	Dommartin-Varimont	140	6	146
21	Champagne-Ardenne	51	4	28	215	Dompremy	135	3	138
21	Champagne-Ardenne	51	3	04	216	Dontrien	207	5	212
21	Champagne-Ardenne	51	2	09	217	Dormans	2906	76	2982
21	Champagne-Ardenne	51	4	24	219	Drosnay	181	6	187
21	Champagne-Ardenne	51	4	34	220	Drouilly	132	5	137
21	Champagne-Ardenne	51	5	08	222	Éclaires	94	2	96
21	Champagne-Ardenne	51	4	24	223	Écollemont	65	1	66
21	Champagne-Ardenne	51	4	28	224	Écriennes	158	7	165
21	Champagne-Ardenne	51	3	31	225	Écueil	317	4	321
21	Champagne-Ardenne	51	1	29	226	Écury-le-Repos	67	0	67
21	Champagne-Ardenne	51	1	10	227	Écury-sur-Coole	460	13	473
21	Champagne-Ardenne	51	5	23	228	Élise-Daucourt	107	2	109
21	Champagne-Ardenne	51	5	08	229	Épense	110	4	114
21	Champagne-Ardenne	51	2	97	230	Épernay	24035	698	24733
21	Champagne-Ardenne	51	1	16	231	L; Épine	621	21	642
21	Champagne-Ardenne	51	3	04	232	Époye	450	4	454
21	Champagne-Ardenne	51	2	12	233	Escardes	85	5	90
21	Champagne-Ardenne	51	2	01	234	Esclavolles-Lurey	575	15	590
21	Champagne-Ardenne	51	2	12	236	Les Essarts-le-Vicomte	148	10	158
21	Champagne-Ardenne	51	2	12	235	Les Essarts-lès-Sézanne	283	6	289
21	Champagne-Ardenne	51	2	12	237	Esternay	1806	34	1840
21	Champagne-Ardenne	51	2	18	238	Étoges	367	2	369
21	Champagne-Ardenne	51	1	29	239	Étréchy	123	2	125
21	Champagne-Ardenne	51	4	28	240	Étrepy	136	10	146
21	Champagne-Ardenne	51	2	13	241	Euvy	77	2	79
21	Champagne-Ardenne	51	1	36	242	Fagnières	4420	138	4558
21	Champagne-Ardenne	51	2	13	243	Faux-Fresnay	341	10	351
21	Champagne-Ardenne	51	1	10	244	Faux-Vésigneul	238	6	244
21	Champagne-Ardenne	51	3	31	245	Faverolles-et-Coëmy	521	5	526
21	Champagne-Ardenne	51	4	28	246	Favresse	186	3	189
21	Champagne-Ardenne	51	2	13	248	Fère-Champenoise	2305	55	2360
21	Champagne-Ardenne	51	2	18	247	Fèrebrianges	184	4	188
21	Champagne-Ardenne	51	2	09	249	Festigny	389	12	401
21	Champagne-Ardenne	51	3	14	250	Fismes	5391	109	5500
21	Champagne-Ardenne	51	2	02	251	Flavigny	188	8	196
21	Champagne-Ardenne	51	2	37	252	Fleury-la-Rivière	496	9	505
21	Champagne-Ardenne	51	5	23	253	Florent-en-Argonne	250	5	255
21	Champagne-Ardenne	51	2	25	254	Fontaine-Denis-Nuisy	243	8	251
21	Champagne-Ardenne	51	5	32	255	Fontaine-en-Dormois	23	0	23
21	Champagne-Ardenne	51	2	03	256	Fontaine-sur-Ay	339	8	347
21	Champagne-Ardenne	51	2	12	258	La Forestière	246	7	253
21	Champagne-Ardenne	51	1	16	259	Francheville	219	4	223
21	Champagne-Ardenne	51	1	16	260	Le Fresne	70	2	72
21	Champagne-Ardenne	51	3	05	261	Fresne-lès-Reims	431	13	444
21	Champagne-Ardenne	51	4	33	262	Frignicourt	1803	80	1883
21	Champagne-Ardenne	51	2	17	263	Fromentières	393	7	400
21	Champagne-Ardenne	51	2	17	264	Le Gault-Soigny	524	10	534
21	Champagne-Ardenne	51	2	25	265	Gaye	568	18	586
21	Champagne-Ardenne	51	2	03	266	Germaine	527	22	549
21	Champagne-Ardenne	51	3	31	267	Germigny	189	3	192
21	Champagne-Ardenne	51	1	29	268	Germinon	135	0	135
21	Champagne-Ardenne	51	4	24	269	Giffaumont-Champaubert	257	5	262
21	Champagne-Ardenne	51	4	24	270	Gigny-Bussy	242	4	246
21	Champagne-Ardenne	51	2	02	271	Gionges	168	107	275
21	Champagne-Ardenne	51	5	08	272	Givry-en-Argonne	457	8	465
21	Champagne-Ardenne	51	1	29	273	Givry-lès-Loisy	84	2	86
21	Champagne-Ardenne	51	5	23	274	Gizaucourt	104	3	107
21	Champagne-Ardenne	51	4	34	275	Glannes	167	5	172
21	Champagne-Ardenne	51	2	13	276	Gourgançon	165	6	171
21	Champagne-Ardenne	51	1	35	278	Les Grandes-Loges	273	8	281
21	Champagne-Ardenne	51	2	01	279	Granges-sur-Aube	187	0	187
21	Champagne-Ardenne	51	5	32	280	Gratreuil	28	0	28
21	Champagne-Ardenne	51	2	02	281	Grauves	673	18	691
21	Champagne-Ardenne	51	3	31	282	Gueux	1745	56	1801
21	Champagne-Ardenne	51	5	23	283	Hans	150	1	151
21	Champagne-Ardenne	51	4	28	284	Haussignémont	312	5	317
21	Champagne-Ardenne	51	2	13	285	Haussimont	155	7	162
21	Champagne-Ardenne	51	4	24	286	Hauteville	228	6	234
21	Champagne-Ardenne	51	2	03	287	Hautvillers	775	23	798
21	Champagne-Ardenne	51	4	15	290	Heiltz-l;Évêque	298	6	304
21	Champagne-Ardenne	51	4	28	288	Heiltz-le-Hutier	228	4	232
21	Champagne-Ardenne	51	4	15	289	Heiltz-le-Maurupt	402	17	419
21	Champagne-Ardenne	51	3	14	291	Hermonville	1351	25	1376
21	Champagne-Ardenne	51	5	08	292	Herpont	121	0	121
21	Champagne-Ardenne	51	3	05	293	Heutrégiville	414	9	423
21	Champagne-Ardenne	51	3	14	294	Hourges	87	1	88
21	Champagne-Ardenne	51	4	34	295	Huiron	322	10	332
21	Champagne-Ardenne	51	4	26	296	Humbauville	76	0	76
21	Champagne-Ardenne	51	2	09	298	Igny-Comblizy	443	14	457
21	Champagne-Ardenne	51	4	28	300	Isle-sur-Marne	111	2	113
21	Champagne-Ardenne	51	3	05	299	Isles-sur-Suippe	797	12	809
21	Champagne-Ardenne	51	1	35	301	Isse	129	0	129
21	Champagne-Ardenne	51	2	02	302	Les Istres-et-Bury	93	7	100
21	Champagne-Ardenne	51	1	10	303	Jâlons	576	10	586
21	Champagne-Ardenne	51	2	17	304	Janvilliers	134	2	136
21	Champagne-Ardenne	51	3	31	305	Janvry	128	2	130
21	Champagne-Ardenne	51	2	12	306	Joiselle	82	5	87
21	Champagne-Ardenne	51	1	27	307	Jonchery-sur-Suippe	169	5	174
21	Champagne-Ardenne	51	3	14	308	Jonchery-sur-Vesle	1970	30	2000
21	Champagne-Ardenne	51	3	07	309	Jonquery	93	4	97
21	Champagne-Ardenne	51	3	31	310	Jouy-lès-Reims	198	5	203
21	Champagne-Ardenne	51	4	15	311	Jussecourt-Minecourt	205	2	207
21	Champagne-Ardenne	51	1	35	312	Juvigny	1000	31	1031
21	Champagne-Ardenne	51	2	25	313	Lachy	319	11	330
21	Champagne-Ardenne	51	3	31	314	Lagery	191	5	196
21	Champagne-Ardenne	51	4	24	315	Landricourt	150	2	152
21	Champagne-Ardenne	51	4	28	316	Larzicourt	303	8	311
21	Champagne-Ardenne	51	5	23	317	Laval-sur-Tourbe	56	3	59
21	Champagne-Ardenne	51	3	05	318	Lavannes	603	10	613
21	Champagne-Ardenne	51	2	13	319	Lenharrée	103	4	107
21	Champagne-Ardenne	51	2	09	320	Leuvrigny	321	7	328
21	Champagne-Ardenne	51	3	31	321	Lhéry	79	1	80
21	Champagne-Ardenne	51	4	24	322	Lignon	103	5	108
21	Champagne-Ardenne	51	2	25	323	Linthelles	115	5	120
21	Champagne-Ardenne	51	2	25	324	Linthes	119	6	125
21	Champagne-Ardenne	51	4	33	325	Lisse-en-Champagne	124	1	125
21	Champagne-Ardenne	51	1	27	326	Livry-Louvercy	952	35	987
21	Champagne-Ardenne	51	1	29	327	Loisy-en-Brie	192	3	195
21	Champagne-Ardenne	51	4	34	328	Loisy-sur-Marne	956	14	970
21	Champagne-Ardenne	51	3	05	329	Loivre	1143	11	1154
21	Champagne-Ardenne	51	2	03	331	Louvois	331	5	336
21	Champagne-Ardenne	51	3	30	333	Ludes	629	6	635
21	Champagne-Ardenne	51	4	33	334	Luxémont-et-Villotte	450	15	465
21	Champagne-Ardenne	51	5	23	336	Maffrécourt	59	3	62
21	Champagne-Ardenne	51	2	03	663	Magenta	1749	29	1778
21	Champagne-Ardenne	51	3	14	337	Magneux	265	2	267
21	Champagne-Ardenne	51	3	30	338	Mailly-Champagne	724	19	743
21	Champagne-Ardenne	51	1	10	339	Mairy-sur-Marne	565	25	590
21	Champagne-Ardenne	51	4	34	340	Maisons-en-Champagne	500	13	513
21	Champagne-Ardenne	51	5	32	341	Malmy	27	1	28
21	Champagne-Ardenne	51	2	02	342	Mancy	279	3	282
21	Champagne-Ardenne	51	2	01	343	Marcilly-sur-Seine	630	23	653
21	Champagne-Ardenne	51	2	37	344	Mardeuil	1536	20	1556
21	Champagne-Ardenne	51	2	18	345	Mareuil-en-Brie	248	5	253
21	Champagne-Ardenne	51	2	09	346	Mareuil-le-Port	1198	18	1216
21	Champagne-Ardenne	51	2	03	347	Mareuil-sur-Ay	1225	26	1251
21	Champagne-Ardenne	51	3	31	348	Marfaux	155	3	158
21	Champagne-Ardenne	51	4	24	349	Margerie-Hancourt	204	2	206
21	Champagne-Ardenne	51	2	18	350	Margny	107	4	111
21	Champagne-Ardenne	51	2	13	351	Marigny	104	1	105
21	Champagne-Ardenne	51	4	33	352	Marolles	883	25	908
21	Champagne-Ardenne	51	2	01	353	Marsangis	53	2	55
21	Champagne-Ardenne	51	1	16	354	Marson	285	7	292
21	Champagne-Ardenne	51	5	32	355	Massiges	50	0	50
21	Champagne-Ardenne	51	4	28	356	Matignicourt-Goncourt	120	1	121
21	Champagne-Ardenne	51	1	10	357	Matougues	668	17	685
21	Champagne-Ardenne	51	4	28	358	Maurupt-le-Montois	572	12	584
21	Champagne-Ardenne	51	2	17	359	Mécringes	155	3	158
21	Champagne-Ardenne	51	2	12	360	Le Meix-Saint-Epoing	251	11	262
21	Champagne-Ardenne	51	4	26	361	Le Meix-Tiercelin	194	3	197
21	Champagne-Ardenne	51	3	05	362	Merfy	641	11	652
21	Champagne-Ardenne	51	4	33	363	Merlaut	248	8	256
21	Champagne-Ardenne	51	3	31	364	Méry-Prémecy	62	2	64
21	Champagne-Ardenne	51	3	31	365	Les Mesneux	839	29	868
21	Champagne-Ardenne	51	2	02	367	Le Mesnil-sur-Oger	1208	14	1222
21	Champagne-Ardenne	51	5	32	368	Minaucourt-le-Mesnil-lès-Hurlus	70	3	73
21	Champagne-Ardenne	51	2	25	369	Moeurs-Verdey	318	11	329
21	Champagne-Ardenne	51	5	23	370	Moiremont	212	1	213
21	Champagne-Ardenne	51	1	16	371	Moivre	50	0	50
21	Champagne-Ardenne	51	4	28	373	Moncetz-l;Abbaye	104	5	109
21	Champagne-Ardenne	51	1	16	372	Moncetz-Longevas	554	11	565
21	Champagne-Ardenne	51	2	25	374	Mondement-Montgivroux	44	2	46
21	Champagne-Ardenne	51	3	14	382	Mont-sur-Courville	132	3	135
21	Champagne-Ardenne	51	3	30	375	Montbré	261	3	264
21	Champagne-Ardenne	51	2	13	377	Montépreux	40	1	41
21	Champagne-Ardenne	51	2	12	376	Montgenost	156	3	159
21	Champagne-Ardenne	51	2	02	378	Monthelon	371	3	374
21	Champagne-Ardenne	51	3	14	379	Montigny-sur-Vesle	477	9	486
21	Champagne-Ardenne	51	2	17	380	Montmirail	3795	75	3870
21	Champagne-Ardenne	51	2	18	381	Montmort-Lucy	589	12	601
21	Champagne-Ardenne	51	2	02	384	Morangis	312	3	315
21	Champagne-Ardenne	51	2	17	386	Morsains	116	6	122
21	Champagne-Ardenne	51	2	02	387	Moslins	294	14	308
21	Champagne-Ardenne	51	1	27	388	Mourmelon-le-Grand	5048	71	5119
21	Champagne-Ardenne	51	1	27	389	Mourmelon-le-Petit	751	19	770
21	Champagne-Ardenne	51	2	37	390	Moussy	764	16	780
21	Champagne-Ardenne	51	3	31	391	Muizon	2209	61	2270
21	Champagne-Ardenne	51	2	03	392	Mutigny	226	2	228
21	Champagne-Ardenne	51	3	07	393	Nanteuil-la-Forêt	233	5	238
21	Champagne-Ardenne	51	2	12	395	Nesle-la-Reposte	88	7	95
21	Champagne-Ardenne	51	2	09	396	Nesle-le-Repons	158	3	161
21	Champagne-Ardenne	51	5	23	399	La Neuville-au-Pont	571	16	587
21	Champagne-Ardenne	51	5	08	397	La Neuville-aux-Bois	155	9	164
21	Champagne-Ardenne	51	3	07	398	La Neuville-aux-Larris	157	5	162
21	Champagne-Ardenne	51	2	12	402	Neuvy	226	4	230
21	Champagne-Ardenne	51	3	04	403	Nogent-l;Abbesse	575	10	585
21	Champagne-Ardenne	51	5	08	404	Noirlieu	118	8	126
21	Champagne-Ardenne	51	4	28	406	Norrois	173	3	176
21	Champagne-Ardenne	51	2	12	407	La Noue	324	8	332
21	Champagne-Ardenne	51	1	10	409	Nuisement-sur-Coole	334	15	349
21	Champagne-Ardenne	51	2	09	410	OEuilly	626	4	630
21	Champagne-Ardenne	51	2	02	411	Oger	575	14	589
21	Champagne-Ardenne	51	2	13	412	Ognes	68	1	69
21	Champagne-Ardenne	51	2	02	413	Oiry	880	19	899
21	Champagne-Ardenne	51	3	07	414	Olizy	154	2	156
21	Champagne-Ardenne	51	1	16	415	Omey	243	1	244
21	Champagne-Ardenne	51	2	18	416	Orbais-l;Abbaye	575	18	593
21	Champagne-Ardenne	51	4	28	417	Orconte	425	8	433
21	Champagne-Ardenne	51	3	19	418	Ormes	453	17	470
21	Champagne-Ardenne	51	4	24	419	Outines	150	1	151
21	Champagne-Ardenne	51	4	15	420	Outrepont	107	4	111
21	Champagne-Ardenne	51	2	25	421	Oyes	80	3	83
21	Champagne-Ardenne	51	3	31	422	Pargny-lès-Reims	366	9	375
21	Champagne-Ardenne	51	4	28	423	Pargny-sur-Saulx	1969	14	1983
21	Champagne-Ardenne	51	5	23	424	Passavant-en-Argonne	219	0	219
21	Champagne-Ardenne	51	3	07	425	Passy-Grigny	380	9	389
21	Champagne-Ardenne	51	2	25	426	Péas	68	1	69
21	Champagne-Ardenne	51	3	30	428	Les Petites-Loges	465	5	470
21	Champagne-Ardenne	51	3	14	429	Pévy	206	3	209
21	Champagne-Ardenne	51	1	29	430	Pierre-Morains	95	0	95
21	Champagne-Ardenne	51	2	37	431	Pierry	1174	35	1209
21	Champagne-Ardenne	51	2	25	432	Pleurs	854	23	877
21	Champagne-Ardenne	51	4	28	433	Plichancourt	212	3	215
21	Champagne-Ardenne	51	2	02	434	Plivot	763	18	781
21	Champagne-Ardenne	51	1	29	435	Pocancy	159	3	162
21	Champagne-Ardenne	51	1	16	436	Pogny	879	19	898
21	Champagne-Ardenne	51	3	31	437	Poilly	91	2	93
21	Champagne-Ardenne	51	1	16	438	Poix	80	0	80
21	Champagne-Ardenne	51	3	05	439	Pomacle	386	7	393
21	Champagne-Ardenne	51	3	04	440	Pontfaverger-Moronvilliers	1570	38	1608
21	Champagne-Ardenne	51	4	28	441	Ponthion	113	2	115
21	Champagne-Ardenne	51	4	15	442	Possesse	188	1	189
21	Champagne-Ardenne	51	2	12	443	Potangis	90	2	92
21	Champagne-Ardenne	51	3	05	444	Pouillon	467	8	475
21	Champagne-Ardenne	51	3	07	445	Pourcy	171	5	176
21	Champagne-Ardenne	51	4	34	446	Pringy	447	10	457
21	Champagne-Ardenne	51	3	04	447	Prosnes	530	5	535
21	Champagne-Ardenne	51	3	14	448	Prouilly	588	4	592
21	Champagne-Ardenne	51	3	04	449	Prunay	968	15	983
21	Champagne-Ardenne	51	3	30	450	Puisieulx	366	9	375
21	Champagne-Ardenne	51	2	25	451	Queudes	89	1	90
21	Champagne-Ardenne	51	5	08	452	Rapsécourt	34	0	34
21	Champagne-Ardenne	51	1	35	453	Recy	1041	17	1058
21	Champagne-Ardenne	51	3	99	454	Reims	179992	4019	184011
21	Champagne-Ardenne	51	4	28	455	Reims-la-Brûlée	231	7	238
21	Champagne-Ardenne	51	5	08	456	Remicourt	64	3	67
21	Champagne-Ardenne	51	3	07	457	Reuil	304	3	307
21	Champagne-Ardenne	51	2	25	458	Reuves	63	1	64
21	Champagne-Ardenne	51	2	12	459	Réveillon	107	5	112
21	Champagne-Ardenne	51	2	17	460	Rieux	177	2	179
21	Champagne-Ardenne	51	3	30	461	Rilly-la-Montagne	1039	22	1061
21	Champagne-Ardenne	51	4	24	463	Les Rivières-Henruel	176	3	179
21	Champagne-Ardenne	51	3	14	464	Romain	322	8	330
21	Champagne-Ardenne	51	2	03	465	Romery	179	1	180
21	Champagne-Ardenne	51	3	31	466	Romigny	198	2	200
21	Champagne-Ardenne	51	3	31	468	Rosnay	300	14	314
21	Champagne-Ardenne	51	1	29	469	Rouffy	98	2	100
21	Champagne-Ardenne	51	5	32	470	Rouvroy-Ripont	7	0	7
21	Champagne-Ardenne	51	3	31	471	Sacy	380	1	381
21	Champagne-Ardenne	51	4	33	472	Saint-Amand-sur-Fion	1058	28	1086
21	Champagne-Ardenne	51	2	12	473	Saint-Bon	110	3	113
21	Champagne-Ardenne	51	3	41	474	Saint-Brice-Courcelles	3409	44	3453
21	Champagne-Ardenne	51	4	24	475	Saint-Chéron	76	1	77
21	Champagne-Ardenne	51	1	35	476	Saint-Étienne-au-Temple	649	9	658
21	Champagne-Ardenne	51	3	05	477	Saint-Étienne-sur-Suippe	283	5	288
21	Champagne-Ardenne	51	4	28	478	Saint-Eulien	454	10	464
21	Champagne-Ardenne	51	3	31	479	Saint-Euphraise-et-Clairizet	216	2	218
21	Champagne-Ardenne	51	1	16	482	Saint-Germain-la-Ville	577	18	595
21	Champagne-Ardenne	51	1	36	483	Saint-Gibrien	474	14	488
21	Champagne-Ardenne	51	3	14	484	Saint-Gilles	273	2	275
21	Champagne-Ardenne	51	1	27	485	Saint-Hilaire-au-Temple	290	5	295
21	Champagne-Ardenne	51	1	27	486	Saint-Hilaire-le-Grand	341	18	359
21	Champagne-Ardenne	51	3	04	487	Saint-Hilaire-le-Petit	293	6	299
21	Champagne-Ardenne	51	2	03	488	Saint-Imoges	297	27	324
21	Champagne-Ardenne	51	4	15	489	Saint-Jean-devant-Possesse	47	0	47
21	Champagne-Ardenne	51	1	16	490	Saint-Jean-sur-Moivre	201	7	208
21	Champagne-Ardenne	51	5	23	491	Saint-Jean-sur-Tourbe	109	1	110
21	Champagne-Ardenne	51	2	01	492	Saint-Just-Sauvage	1539	25	1564
21	Champagne-Ardenne	51	3	40	493	Saint-Léonard	94	2	96
21	Champagne-Ardenne	51	2	25	495	Saint-Loup	75	0	75
21	Champagne-Ardenne	51	4	33	496	Saint-Lumier-en-Champagne	237	3	240
21	Champagne-Ardenne	51	4	28	497	Saint-Lumier-la-Populeuse	36	0	36
21	Champagne-Ardenne	51	1	29	499	Saint-Mard-lès-Rouffy	166	2	168
21	Champagne-Ardenne	51	5	08	498	Saint-Mard-sur-Auve	54	0	54
21	Champagne-Ardenne	51	5	08	500	Saint-Mard-sur-le-Mont	124	3	127
21	Champagne-Ardenne	51	1	10	502	Saint-Martin-aux-Champs	97	0	97
21	Champagne-Ardenne	51	2	37	002	Saint-Martin-d;Ablois	1484	37	1521
21	Champagne-Ardenne	51	3	04	503	Saint-Martin-l;Heureux	74	6	80
21	Champagne-Ardenne	51	1	35	504	Saint-Martin-sur-le-Pré	772	34	806
21	Champagne-Ardenne	51	3	04	505	Saint-Masmes	455	4	459
21	Champagne-Ardenne	51	1	43	506	Saint-Memmie	5319	127	5446
21	Champagne-Ardenne	51	4	26	508	Saint-Ouen-Domprot	202	7	209
21	Champagne-Ardenne	51	1	10	509	Saint-Pierre	301	7	308
21	Champagne-Ardenne	51	2	01	511	Saint-Quentin-le-Verger	122	3	125
21	Champagne-Ardenne	51	4	33	510	Saint-Quentin-les-Marais	131	7	138
21	Champagne-Ardenne	51	1	10	512	Saint-Quentin-sur-Coole	62	3	65
21	Champagne-Ardenne	51	4	24	513	Saint-Remy-en-Bouzemont-Saint-Genest-et-Isson	573	14	587
21	Champagne-Ardenne	51	2	25	514	Saint-Remy-sous-Broyes	99	2	101
21	Champagne-Ardenne	51	5	08	515	Saint-Remy-sur-Bussy	348	7	355
21	Champagne-Ardenne	51	2	01	516	Saint-Saturnin	58	1	59
21	Champagne-Ardenne	51	3	04	517	Saint-Souplet-sur-Py	149	6	155
21	Champagne-Ardenne	51	3	05	518	Saint-Thierry	627	22	649
21	Champagne-Ardenne	51	5	32	519	Saint-Thomas-en-Argonne	41	2	43
21	Champagne-Ardenne	51	4	26	520	Saint-Utin	79	1	80
21	Champagne-Ardenne	51	4	28	521	Saint-Vrain	210	5	215
21	Champagne-Ardenne	51	3	07	480	Sainte-Gemme	141	2	143
21	Champagne-Ardenne	51	1	27	501	Sainte-Marie-à-Py	193	7	200
21	Champagne-Ardenne	51	4	24	277	Sainte-Marie-du-Lac-Nuisement	254	4	258
21	Champagne-Ardenne	51	5	23	507	Sainte-Menehould	4464	174	4638
21	Champagne-Ardenne	51	4	28	522	Sapignicourt	357	1	358
21	Champagne-Ardenne	51	3	31	523	Sarcy	249	3	252
21	Champagne-Ardenne	51	2	01	524	Saron-sur-Aube	292	6	298
21	Champagne-Ardenne	51	1	16	525	Sarry	2031	101	2132
21	Champagne-Ardenne	51	2	25	526	Saudoy	367	12	379
21	Champagne-Ardenne	51	3	31	527	Savigny-sur-Ardres	260	1	261
21	Champagne-Ardenne	51	4	28	528	Scrupt	128	4	132
21	Champagne-Ardenne	51	3	04	529	Selles	359	6	365
21	Champagne-Ardenne	51	3	30	530	Sept-Saulx	579	10	589
21	Champagne-Ardenne	51	4	28	531	Sermaize-les-Bains	2104	36	2140
21	Champagne-Ardenne	51	3	30	532	Sermiers	558	17	575
21	Champagne-Ardenne	51	5	32	533	Servon-Melzicourt	119	1	120
21	Champagne-Ardenne	51	3	31	534	Serzy-et-Prin	180	5	185
21	Champagne-Ardenne	51	2	25	535	Sézanne	5264	204	5468
21	Champagne-Ardenne	51	3	30	536	Sillery	1614	42	1656
21	Champagne-Ardenne	51	5	08	537	Sivry-Ante	186	6	192
21	Champagne-Ardenne	51	1	10	538	Sogny-aux-Moulins	121	4	125
21	Champagne-Ardenne	51	4	15	539	Sogny-en-l;Angle	41	1	42
21	Champagne-Ardenne	51	2	17	542	Soizy-aux-Bois	158	1	159
21	Champagne-Ardenne	51	5	23	543	Somme-Bionne	78	1	79
21	Champagne-Ardenne	51	1	27	546	Somme-Suippe	460	177	637
21	Champagne-Ardenne	51	5	23	547	Somme-Tourbe	150	1	151
21	Champagne-Ardenne	51	1	16	548	Somme-Vesle	425	197	622
21	Champagne-Ardenne	51	5	08	549	Somme-Yèvre	110	2	112
21	Champagne-Ardenne	51	5	32	544	Sommepy-Tahure	618	19	637
21	Champagne-Ardenne	51	4	26	545	Sommesous	469	8	477
21	Champagne-Ardenne	51	4	26	550	Sompuis	266	7	273
21	Champagne-Ardenne	51	4	26	551	Somsois	184	3	187
21	Champagne-Ardenne	51	4	34	552	Songy	273	3	276
21	Champagne-Ardenne	51	1	27	553	Souain-Perthes-lès-Hurlus	212	6	218
21	Champagne-Ardenne	51	4	26	555	Soudé	162	5	167
21	Champagne-Ardenne	51	1	10	556	Soudron	320	9	329
21	Champagne-Ardenne	51	4	33	557	Soulanges	481	3	484
21	Champagne-Ardenne	51	1	29	558	Soulières	131	4	135
21	Champagne-Ardenne	51	1	27	559	Suippes	3977	63	4040
21	Champagne-Ardenne	51	2	18	560	Suizy-le-Franc	120	6	126
21	Champagne-Ardenne	51	3	40	562	Taissy	2317	60	2377
21	Champagne-Ardenne	51	2	18	563	Talus-Saint-Prix	108	0	108
21	Champagne-Ardenne	51	2	03	564	Tauxières-Mutry	278	8	286
21	Champagne-Ardenne	51	2	13	565	Thaas	110	2	112
21	Champagne-Ardenne	51	1	10	566	Thibie	263	5	268
21	Champagne-Ardenne	51	4	28	567	Thiéblemont-Farémont	516	11	527
21	Champagne-Ardenne	51	3	05	568	Thil	292	9	301
21	Champagne-Ardenne	51	3	19	569	Thillois	346	78	424
21	Champagne-Ardenne	51	2	17	570	Le Thoult-Trosnay	90	4	94
21	Champagne-Ardenne	51	5	08	572	Tilloy-et-Bellay	224	8	232
21	Champagne-Ardenne	51	3	19	573	Tinqueux	10300	196	10496
21	Champagne-Ardenne	51	1	10	574	Togny-aux-Boeufs	134	3	137
21	Champagne-Ardenne	51	2	03	576	Tours-sur-Marne	1352	24	1376
21	Champagne-Ardenne	51	3	31	577	Tramery	149	4	153
21	Champagne-Ardenne	51	1	29	578	Trécon	83	0	83
21	Champagne-Ardenne	51	2	17	579	Tréfols	127	6	133
21	Champagne-Ardenne	51	3	30	580	Trépail	433	3	436
21	Champagne-Ardenne	51	3	31	581	Treslon	192	0	192
21	Champagne-Ardenne	51	3	14	582	Trigny	537	12	549
21	Champagne-Ardenne	51	4	28	583	Trois-Fontaines-l;Abbaye	221	6	227
21	Champagne-Ardenne	51	3	40	584	Trois-Puits	150	0	150
21	Champagne-Ardenne	51	2	09	585	Troissy	836	9	845
21	Champagne-Ardenne	51	3	14	586	Unchair	158	2	160
21	Champagne-Ardenne	51	1	27	587	Vadenay	275	3	278
21	Champagne-Ardenne	51	3	30	571	Val-de-Vesle	778	16	794
21	Champagne-Ardenne	51	4	15	218	Val-de-Vière	124	2	126
21	Champagne-Ardenne	51	1	29	158	Val-des-Marais	573	5	578
21	Champagne-Ardenne	51	5	23	588	Valmy	287	3	290
21	Champagne-Ardenne	51	4	15	589	Vanault-le-Châtel	181	1	182
21	Champagne-Ardenne	51	4	15	590	Vanault-les-Dames	405	11	416
21	Champagne-Ardenne	51	3	14	591	Vandeuil	198	3	201
21	Champagne-Ardenne	51	3	07	592	Vandières	336	9	345
21	Champagne-Ardenne	51	2	13	594	Vassimont-et-Chapelaine	64	3	67
21	Champagne-Ardenne	51	1	10	595	Vatry	111	3	114
21	Champagne-Ardenne	51	2	17	596	Vauchamps	343	7	350
21	Champagne-Ardenne	51	2	37	597	Vauciennes	294	7	301
21	Champagne-Ardenne	51	4	28	598	Vauclerc	491	19	510
21	Champagne-Ardenne	51	1	27	599	Vaudemange	298	2	300
21	Champagne-Ardenne	51	3	04	600	Vaudesincourt	119	3	122
21	Champagne-Ardenne	51	4	15	601	Vavray-le-Grand	169	6	175
21	Champagne-Ardenne	51	4	15	602	Vavray-le-Petit	66	3	69
21	Champagne-Ardenne	51	1	29	603	Vélye	155	2	157
21	Champagne-Ardenne	51	3	14	604	Ventelay	254	13	267
21	Champagne-Ardenne	51	2	37	605	Venteuil	587	20	607
21	Champagne-Ardenne	51	2	17	607	Verdon	182	4	186
21	Champagne-Ardenne	51	4	15	608	Vernancourt	75	3	78
21	Champagne-Ardenne	51	2	09	609	Verneuil	835	16	851
21	Champagne-Ardenne	51	5	23	610	Verrières	413	15	428
21	Champagne-Ardenne	51	1	29	611	Vert-Toulon	298	9	307
21	Champagne-Ardenne	51	1	29	612	Vertus	2536	95	2631
21	Champagne-Ardenne	51	3	30	613	Verzenay	1061	20	1081
21	Champagne-Ardenne	51	3	30	614	Verzy	1056	21	1077
21	Champagne-Ardenne	51	1	16	616	Vésigneul-sur-Marne	271	7	278
21	Champagne-Ardenne	51	1	35	617	La Veuve	620	12	632
21	Champagne-Ardenne	51	2	17	618	Le Vézier	191	3	194
21	Champagne-Ardenne	51	5	08	619	Le Vieil-Dampierre	112	0	112
21	Champagne-Ardenne	51	5	32	620	Vienne-la-Ville	181	5	186
21	Champagne-Ardenne	51	5	32	621	Vienne-le-Château	562	12	574
21	Champagne-Ardenne	51	3	31	622	Ville-Dommange	419	13	432
21	Champagne-Ardenne	51	3	30	623	Ville-en-Selve	275	48	323
21	Champagne-Ardenne	51	3	31	624	Ville-en-Tardenois	605	17	622
21	Champagne-Ardenne	51	2	18	639	La Ville-sous-Orbais	50	1	51
21	Champagne-Ardenne	51	5	32	640	Ville-sur-Tourbe	218	2	220
21	Champagne-Ardenne	51	2	12	625	Villeneuve-la-Lionne	302	4	306
21	Champagne-Ardenne	51	2	17	626	La Villeneuve-lès-Charleville	119	4	123
21	Champagne-Ardenne	51	1	29	627	Villeneuve-Renneville-Chevigny	311	10	321
21	Champagne-Ardenne	51	2	25	628	Villeneuve-Saint-Vistre-et-Villevotte	128	7	135
21	Champagne-Ardenne	51	3	30	629	Villers-Allerand	844	20	864
21	Champagne-Ardenne	51	2	02	630	Villers-aux-Bois	287	2	289
21	Champagne-Ardenne	51	3	30	631	Villers-aux-Noeuds	170	0	170
21	Champagne-Ardenne	51	5	23	632	Villers-en-Argonne	231	9	240
21	Champagne-Ardenne	51	3	05	633	Villers-Franqueux	317	18	335
21	Champagne-Ardenne	51	1	10	634	Villers-le-Château	255	6	261
21	Champagne-Ardenne	51	4	15	635	Villers-le-Sec	101	5	106
21	Champagne-Ardenne	51	3	30	636	Villers-Marmery	555	7	562
21	Champagne-Ardenne	51	3	07	637	Villers-sous-Châtillon	225	1	226
21	Champagne-Ardenne	51	1	29	638	Villeseneux	224	10	234
21	Champagne-Ardenne	51	2	18	641	Villevenard	196	3	199
21	Champagne-Ardenne	51	2	01	642	Villiers-aux-Corneilles	90	1	91
21	Champagne-Ardenne	51	2	37	643	Vinay	555	8	563
21	Champagne-Ardenne	51	2	09	644	Vincelles	339	5	344
21	Champagne-Ardenne	51	2	25	645	Vindey	128	11	139
21	Champagne-Ardenne	51	5	32	646	Virginy	85	0	85
21	Champagne-Ardenne	51	4	33	647	Vitry-en-Perthois	870	32	902
21	Champagne-Ardenne	51	1	10	648	Vitry-la-Ville	363	16	379
21	Champagne-Ardenne	51	4	98	649	Vitry-le-François	13384	442	13826
21	Champagne-Ardenne	51	5	23	650	Voilemont	47	1	48
21	Champagne-Ardenne	51	1	29	651	Voipreux	213	6	219
21	Champagne-Ardenne	51	2	01	652	Vouarces	63	4	67
21	Champagne-Ardenne	51	4	28	654	Vouillers	229	2	231
21	Champagne-Ardenne	51	1	29	655	Vouzy	319	10	329
21	Champagne-Ardenne	51	1	35	656	Vraux	473	11	484
21	Champagne-Ardenne	51	3	31	657	Vrigny	213	4	217
21	Champagne-Ardenne	51	4	15	658	Vroil	120	4	124
21	Champagne-Ardenne	51	5	32	659	Wargemoulin-Hurlus	49	3	52
21	Champagne-Ardenne	51	3	05	660	Warmeriville	2128	25	2153
21	Champagne-Ardenne	51	3	05	662	Witry-lès-Reims	4749	73	4822
21	Champagne-Ardenne	52	1	21	001	Ageville	312	4	316
21	Champagne-Ardenne	52	2	04	002	Aigremont	23	0	23
21	Champagne-Ardenne	52	1	24	003	Aillianville	164	4	168
21	Champagne-Ardenne	52	3	22	004	Aingoulaincourt	13	0	13
21	Champagne-Ardenne	52	1	06	005	Aizanville	29	3	32
21	Champagne-Ardenne	52	3	28	006	Allichamps	402	3	405
21	Champagne-Ardenne	52	3	11	007	Ambonville	73	1	74
21	Champagne-Ardenne	52	1	01	008	Andelot-Blancheville	908	14	922
21	Champagne-Ardenne	52	2	20	009	Andilly-en-Bassigny	113	4	117
21	Champagne-Ardenne	52	1	27	011	Annéville-la-Prairie	68	3	71
21	Champagne-Ardenne	52	3	22	012	Annonville	30	0	30
21	Champagne-Ardenne	52	2	15	013	Anrosey	153	6	159
21	Champagne-Ardenne	52	2	17	014	Aprey	188	3	191
21	Champagne-Ardenne	52	2	26	015	Arbigny-sous-Varennes	80	0	80
21	Champagne-Ardenne	52	2	03	016	Arbot	69	1	70
21	Champagne-Ardenne	52	1	02	017	Arc-en-Barrois	769	12	781
21	Champagne-Ardenne	52	3	11	019	Arnancourt	108	2	110
21	Champagne-Ardenne	52	3	28	021	Attancourt	236	8	244
21	Champagne-Ardenne	52	1	02	022	Aubepierre-sur-Aube	188	5	193
21	Champagne-Ardenne	52	2	03	023	Auberive	196	4	200
21	Champagne-Ardenne	52	1	09	025	Audeloncourt	95	4	99
21	Champagne-Ardenne	52	2	17	027	Aujeurres	77	0	77
21	Champagne-Ardenne	52	2	03	028	Aulnoy-sur-Aube	56	2	58
21	Champagne-Ardenne	52	3	13	029	Autigny-le-Grand	160	2	162
21	Champagne-Ardenne	52	3	13	030	Autigny-le-Petit	54	2	56
21	Champagne-Ardenne	52	1	14	031	Autreville-sur-la-Renne	394	10	404
21	Champagne-Ardenne	52	2	19	033	Avrecourt	136	1	137
21	Champagne-Ardenne	52	3	28	034	Bailly-aux-Forges	132	4	136
21	Champagne-Ardenne	52	2	17	035	Baissey	203	3	206
21	Champagne-Ardenne	52	2	16	036	Balesmes-sur-Marne	255	10	265
21	Champagne-Ardenne	52	2	20	037	Bannes	398	13	411
21	Champagne-Ardenne	52	1	09	038	Bassoncourt	66	2	68
21	Champagne-Ardenne	52	3	11	039	Baudrecourt	118	2	120
21	Champagne-Ardenne	52	2	03	040	Bay-sur-Aube	53	3	56
21	Champagne-Ardenne	52	3	08	265	Bayard-sur-Marne	1453	23	1476
21	Champagne-Ardenne	52	2	20	042	Beauchemin	105	7	112
21	Champagne-Ardenne	52	2	12	043	Belmont	50	0	50
21	Champagne-Ardenne	52	3	30	045	Bettancourt-la-Ferrée	1794	70	1864
21	Champagne-Ardenne	52	3	11	047	Beurville	102	0	102
21	Champagne-Ardenne	52	1	21	050	Biesles	1404	30	1434
21	Champagne-Ardenne	52	2	15	051	Bize	84	0	84
21	Champagne-Ardenne	52	1	14	053	Blaisy	76	3	79
21	Champagne-Ardenne	52	3	13	055	Blécourt	110	5	115
21	Champagne-Ardenne	52	1	06	056	Blessonville	223	4	227
21	Champagne-Ardenne	52	3	11	057	Blumeray	106	9	115
21	Champagne-Ardenne	52	1	27	058	Bologne	1877	40	1917
21	Champagne-Ardenne	52	2	20	059	Bonnecourt	129	2	131
21	Champagne-Ardenne	52	2	04	060	Bourbonne-les-Bains	2230	93	2323
21	Champagne-Ardenne	52	1	01	061	Bourdons-sur-Rognon	274	11	285
21	Champagne-Ardenne	52	2	17	062	Bourg	148	7	155
21	Champagne-Ardenne	52	1	05	063	Bourg-Sainte-Marie	97	5	102
21	Champagne-Ardenne	52	1	05	064	Bourmont	516	50	566
21	Champagne-Ardenne	52	3	11	065	Bouzancourt	65	2	67
21	Champagne-Ardenne	52	3	11	066	Brachay	60	1	61
21	Champagne-Ardenne	52	1	05	067	Brainville-sur-Meuse	82	6	88
21	Champagne-Ardenne	52	1	06	069	Braux-le-Châtel	141	3	144
21	Champagne-Ardenne	52	2	17	070	Brennes	123	10	133
21	Champagne-Ardenne	52	1	07	072	Brethenay	385	17	402
21	Champagne-Ardenne	52	1	09	074	Breuvannes-en-Bassigny	710	33	743
21	Champagne-Ardenne	52	1	01	075	Briaucourt	195	8	203
21	Champagne-Ardenne	52	1	06	076	Bricon	459	8	467
21	Champagne-Ardenne	52	3	28	079	Brousseval	734	10	744
21	Champagne-Ardenne	52	1	02	082	Bugnières	151	4	155
21	Champagne-Ardenne	52	1	24	084	Busson	40	1	41
21	Champagne-Ardenne	52	1	09	085	Buxières-lès-Clefmont	23	1	24
21	Champagne-Ardenne	52	1	29	087	Buxières-lès-Villiers	228	50	278
21	Champagne-Ardenne	52	3	18	088	Ceffonds	636	17	653
21	Champagne-Ardenne	52	2	26	089	Celles-en-Bassigny	73	0	73
21	Champagne-Ardenne	52	2	20	090	Celsoy	108	3	111
21	Champagne-Ardenne	52	3	10	091	Cerisières	95	3	98
21	Champagne-Ardenne	52	2	23	092	Chalancey	121	2	123
21	Champagne-Ardenne	52	2	17	093	Chalindrey	2587	66	2653
21	Champagne-Ardenne	52	1	24	095	Chalvraines	205	5	210
21	Champagne-Ardenne	52	1	07	125	Chamarandes-Choignes	1054	164	1218
21	Champagne-Ardenne	52	1	24	097	Chambroncourt	39	0	39
21	Champagne-Ardenne	52	3	32	099	Chamouilley	848	23	871
21	Champagne-Ardenne	52	1	05	101	Champigneulles-en-Bassigny	56	3	59
21	Champagne-Ardenne	52	2	16	102	Champigny-lès-Langres	414	15	429
21	Champagne-Ardenne	52	2	26	103	Champigny-sous-Varennes	125	5	130
21	Champagne-Ardenne	52	2	12	083	Champsevraine	806	32	838
21	Champagne-Ardenne	52	3	30	104	Chancenay	1058	40	1098
21	Champagne-Ardenne	52	2	20	105	Changey	283	9	292
21	Champagne-Ardenne	52	2	16	106	Chanoy	150	4	154
21	Champagne-Ardenne	52	1	01	107	Chantraines	224	4	228
21	Champagne-Ardenne	52	2	20	108	Charmes	152	1	153
21	Champagne-Ardenne	52	3	11	109	Charmes-en-l;Angle	7	0	7
21	Champagne-Ardenne	52	3	11	110	Charmes-la-Grande	163	3	166
21	Champagne-Ardenne	52	2	23	113	Chassigny	241	5	246
21	Champagne-Ardenne	52	1	06	114	Châteauvillain	1665	31	1696
21	Champagne-Ardenne	52	2	04	400	Le Châtelet-sur-Meuse	155	4	159
21	Champagne-Ardenne	52	2	16	115	Chatenay-Mâcheron	112	6	118
21	Champagne-Ardenne	52	2	20	116	Chatenay-Vaudin	62	1	63
21	Champagne-Ardenne	52	3	13	118	Chatonrupt-Sommermont	331	6	337
21	Champagne-Ardenne	52	2	12	119	Chaudenay	303	8	311
21	Champagne-Ardenne	52	2	19	120	Chauffourt	210	4	214
21	Champagne-Ardenne	52	1	85	121	Chaumont	23011	1489	24500
21	Champagne-Ardenne	52	1	05	122	Chaumont-la-Ville	125	2	127
21	Champagne-Ardenne	52	3	08	123	Chevillon	1406	37	1443
21	Champagne-Ardenne	52	2	26	124	Chézeaux	74	3	77
21	Champagne-Ardenne	52	2	23	126	Choilley-Dardenay	173	5	178
21	Champagne-Ardenne	52	1	09	127	Choiseul	95	1	96
21	Champagne-Ardenne	52	1	01	128	Cirey-lès-Mareilles	128	0	128
21	Champagne-Ardenne	52	3	11	129	Cirey-sur-Blaise	107	2	109
21	Champagne-Ardenne	52	1	06	130	Cirfontaines-en-Azois	202	2	204
21	Champagne-Ardenne	52	3	22	131	Cirfontaines-en-Ornois	78	2	80
21	Champagne-Ardenne	52	1	09	132	Clefmont	212	5	217
21	Champagne-Ardenne	52	1	05	133	Clinchamp	95	4	99
21	Champagne-Ardenne	52	2	17	134	Cohons	265	9	274
21	Champagne-Ardenne	52	2	26	135	Coiffy-le-Bas	100	0	100
21	Champagne-Ardenne	52	2	04	136	Coiffy-le-Haut	120	2	122
21	Champagne-Ardenne	52	2	03	137	Colmier-le-Bas	21	0	21
21	Champagne-Ardenne	52	2	03	138	Colmier-le-Haut	68	4	72
21	Champagne-Ardenne	52	1	14	140	Colombey-les-Deux-Églises	672	24	696
21	Champagne-Ardenne	52	1	07	141	Condes	291	11	302
21	Champagne-Ardenne	52	1	01	142	Consigny	67	2	69
21	Champagne-Ardenne	52	2	23	145	Coublanc	129	4	133
21	Champagne-Ardenne	52	1	02	146	Coupray	172	8	180
21	Champagne-Ardenne	52	1	02	151	Cour-l;Évêque	182	1	183
21	Champagne-Ardenne	52	2	16	147	Courcelles-en-Montagne	88	0	88
21	Champagne-Ardenne	52	3	11	149	Courcelles-sur-Blaise	120	2	122
21	Champagne-Ardenne	52	2	16	155	Culmont	570	10	580
21	Champagne-Ardenne	52	3	13	156	Curel	428	24	452
21	Champagne-Ardenne	52	1	14	157	Curmont	16	0	16
21	Champagne-Ardenne	52	2	23	158	Cusey	252	4	256
21	Champagne-Ardenne	52	1	09	159	Cuves	24	0	24
21	Champagne-Ardenne	52	1	27	160	Daillancourt	80	0	80
21	Champagne-Ardenne	52	1	09	161	Daillecourt	82	0	82
21	Champagne-Ardenne	52	2	19	162	Dammartin-sur-Meuse	226	1	227
21	Champagne-Ardenne	52	2	20	163	Dampierre	362	12	374
21	Champagne-Ardenne	52	2	04	164	Damrémont	217	5	222
21	Champagne-Ardenne	52	1	02	165	Dancevoir	229	5	234
21	Champagne-Ardenne	52	1	01	167	Darmannes	262	2	264
21	Champagne-Ardenne	52	1	06	168	Dinteville	53	2	55
21	Champagne-Ardenne	52	3	28	169	Domblain	95	4	99
21	Champagne-Ardenne	52	2	23	170	Dommarien	159	2	161
21	Champagne-Ardenne	52	3	28	171	Dommartin-le-Franc	218	4	222
21	Champagne-Ardenne	52	3	11	172	Dommartin-le-Saint-Père	288	9	297
21	Champagne-Ardenne	52	3	10	173	Domremy-Landéville	89	1	90
21	Champagne-Ardenne	52	1	05	174	Doncourt-sur-Meuse	52	1	53
21	Champagne-Ardenne	52	3	10	175	Donjeux	376	24	400
21	Champagne-Ardenne	52	3	10	177	Doulaincourt-Saucourt	943	100	1043
21	Champagne-Ardenne	52	3	11	178	Doulevant-le-Château	419	13	432
21	Champagne-Ardenne	52	3	28	179	Doulevant-le-Petit	49	0	49
21	Champagne-Ardenne	52	3	18	180	Droyes	416	65	481
21	Champagne-Ardenne	52	3	22	181	Échenay	87	5	92
21	Champagne-Ardenne	52	3	31	182	Éclaron-Braucourt-Sainte-Livière	2015	39	2054
21	Champagne-Ardenne	52	1	01	183	Ecot-la-Combe	48	1	49
21	Champagne-Ardenne	52	3	22	184	Effincourt	73	0	73
21	Champagne-Ardenne	52	2	04	185	Enfonvelle	78	3	81
21	Champagne-Ardenne	52	3	22	187	Épizon	144	6	150
21	Champagne-Ardenne	52	1	21	190	Esnouveaux	334	8	342
21	Champagne-Ardenne	52	1	07	193	Euffigneix	294	8	302
21	Champagne-Ardenne	52	3	08	194	Eurville-Bienville	2029	34	2063
21	Champagne-Ardenne	52	2	12	195	Farincourt	51	2	53
21	Champagne-Ardenne	52	2	16	196	Faverolles	118	5	123
21	Champagne-Ardenne	52	2	12	197	Fayl-Billot	1436	114	1550
21	Champagne-Ardenne	52	3	28	198	Fays	79	3	82
21	Champagne-Ardenne	52	3	13	199	Ferrière-et-Lafolie	45	2	47
21	Champagne-Ardenne	52	2	17	200	Flagey	86	2	88
21	Champagne-Ardenne	52	3	11	201	Flammerécourt	67	0	67
21	Champagne-Ardenne	52	3	08	203	Fontaines-sur-Marne	159	0	159
21	Champagne-Ardenne	52	1	01	204	Forcey	87	1	88
21	Champagne-Ardenne	52	1	29	205	Foulain	748	20	768
21	Champagne-Ardenne	52	3	18	206	Frampas	162	3	165
21	Champagne-Ardenne	52	2	20	207	Frécourt	96	0	96
21	Champagne-Ardenne	52	2	04	208	Fresnes-sur-Apance	165	1	166
21	Champagne-Ardenne	52	1	27	211	Froncles	1597	24	1621
21	Champagne-Ardenne	52	3	13	212	Fronville	332	8	340
21	Champagne-Ardenne	52	2	12	213	Genevrières	146	5	151
21	Champagne-Ardenne	52	1	27	214	La Genevroye	27	0	27
21	Champagne-Ardenne	52	2	03	216	Germaines	31	1	32
21	Champagne-Ardenne	52	1	05	217	Germainvilliers	99	2	101
21	Champagne-Ardenne	52	3	22	218	Germay	47	1	48
21	Champagne-Ardenne	52	3	22	219	Germisay	21	1	22
21	Champagne-Ardenne	52	1	02	220	Giey-sur-Aujon	157	5	162
21	Champagne-Ardenne	52	1	14	221	Gillancourt	120	7	127
21	Champagne-Ardenne	52	3	22	222	Gillaumé	38	1	39
21	Champagne-Ardenne	52	2	12	223	Gilley	71	0	71
21	Champagne-Ardenne	52	1	05	225	Goncourt	292	13	305
21	Champagne-Ardenne	52	1	05	227	Graffigny-Chemin	211	9	220
21	Champagne-Ardenne	52	2	23	228	Grandchamp	84	1	85
21	Champagne-Ardenne	52	2	12	229	Grenant	150	1	151
21	Champagne-Ardenne	52	3	10	230	Gudmont-Villiers	353	6	359
21	Champagne-Ardenne	52	3	13	231	Guindrecourt-aux-Ormes	84	3	87
21	Champagne-Ardenne	52	1	27	232	Guindrecourt-sur-Blaise	44	1	45
21	Champagne-Ardenne	52	2	15	233	Guyonvelle	115	5	120
21	Champagne-Ardenne	52	1	05	234	Hâcourt	35	0	35
21	Champagne-Ardenne	52	3	31	235	Hallignicourt	294	6	300
21	Champagne-Ardenne	52	1	05	237	Harréville-les-Chanteurs	279	7	286
21	Champagne-Ardenne	52	2	26	242	Haute-Amance	990	20	1010
21	Champagne-Ardenne	52	2	17	239	Heuilley-Cotton	277	11	288
21	Champagne-Ardenne	52	2	17	240	Heuilley-le-Grand	197	9	206
21	Champagne-Ardenne	52	1	05	243	Huilliécourt	127	11	138
21	Champagne-Ardenne	52	3	31	244	Humbécourt	774	18	792
21	Champagne-Ardenne	52	1	24	245	Humberville	64	1	65
21	Champagne-Ardenne	52	2	16	246	Humes-Jorquenay	578	7	585
21	Champagne-Ardenne	52	1	05	247	Illoud	255	7	262
21	Champagne-Ardenne	52	1	21	248	Is-en-Bassigny	585	11	596
21	Champagne-Ardenne	52	2	23	249	Isômes	147	4	151
21	Champagne-Ardenne	52	3	13	250	Joinville	3635	115	3750
21	Champagne-Ardenne	52	1	07	251	Jonchery	1021	24	1045
21	Champagne-Ardenne	52	1	14	253	Juzennecourt	207	5	212
21	Champagne-Ardenne	52	1	14	254	Lachapelle-en-Blaisy	76	5	81
21	Champagne-Ardenne	52	1	24	256	Lafauche	87	2	89
21	Champagne-Ardenne	52	2	15	257	Laferté-sur-Amance	111	1	112
21	Champagne-Ardenne	52	1	06	258	Laferté-sur-Aube	367	9	376
21	Champagne-Ardenne	52	1	27	260	Lamancine	126	0	126
21	Champagne-Ardenne	52	1	14	262	Lamothe-en-Blaisy	78	0	78
21	Champagne-Ardenne	52	2	26	264	Laneuvelle	64	4	68
21	Champagne-Ardenne	52	3	18	266	Laneuville-à-Rémy	64	0	64
21	Champagne-Ardenne	52	3	31	267	Laneuville-au-Pont	179	3	182
21	Champagne-Ardenne	52	2	16	269	Langres	8082	551	8633
21	Champagne-Ardenne	52	1	21	271	Lanques-sur-Rognon	219	4	223
21	Champagne-Ardenne	52	1	06	272	Lanty-sur-Aube	132	5	137
21	Champagne-Ardenne	52	2	04	273	Larivière-Arnoncourt	165	1	166
21	Champagne-Ardenne	52	1	06	274	Latrecey-Ormoy-sur-Aube	320	13	333
21	Champagne-Ardenne	52	2	26	275	Lavernoy	87	0	87
21	Champagne-Ardenne	52	1	07	276	Laville-aux-Bois	219	4	223
21	Champagne-Ardenne	52	2	19	277	Lavilleneuve	69	2	71
21	Champagne-Ardenne	52	1	14	278	Lavilleneuve-au-Roi	92	3	95
21	Champagne-Ardenne	52	2	20	280	Lecey	220	5	225
21	Champagne-Ardenne	52	1	02	282	Leffonds	321	9	330
21	Champagne-Ardenne	52	3	11	284	Leschères-sur-le-Blaiseron	96	1	97
21	Champagne-Ardenne	52	2	17	285	Leuchey	75	1	76
21	Champagne-Ardenne	52	1	24	286	Leurville	93	1	94
21	Champagne-Ardenne	52	1	05	287	Levécourt	97	4	101
21	Champagne-Ardenne	52	3	22	288	Lezéville	110	6	116
21	Champagne-Ardenne	52	1	24	289	Liffol-le-Petit	335	11	346
21	Champagne-Ardenne	52	2	12	290	Les Loges	131	3	134
21	Champagne-Ardenne	52	1	09	291	Longchamp	74	2	76
21	Champagne-Ardenne	52	2	17	292	Longeau-Percey	720	20	740
21	Champagne-Ardenne	52	3	18	293	Longeville-sur-la-Laines	462	10	472
21	Champagne-Ardenne	52	3	28	294	Louvemont	739	20	759
21	Champagne-Ardenne	52	1	21	295	Louvières	102	3	105
21	Champagne-Ardenne	52	3	18	296	Louze	312	10	322
21	Champagne-Ardenne	52	1	29	297	Luzy-sur-Marne	265	21	286
21	Champagne-Ardenne	52	2	23	298	Maâtz	83	2	85
21	Champagne-Ardenne	52	3	28	300	Magneux	157	4	161
21	Champagne-Ardenne	52	1	09	301	Maisoncelles	54	1	55
21	Champagne-Ardenne	52	3	08	302	Maizières	170	5	175
21	Champagne-Ardenne	52	2	15	303	Maizières-sur-Amance	107	0	107
21	Champagne-Ardenne	52	1	05	304	Malaincourt-sur-Meuse	58	1	59
21	Champagne-Ardenne	52	1	21	305	Mandres-la-Côte	542	18	560
21	Champagne-Ardenne	52	1	24	306	Manois	473	3	476
21	Champagne-Ardenne	52	2	16	307	Marac	226	7	233
21	Champagne-Ardenne	52	1	14	308	Maranville	457	8	465
21	Champagne-Ardenne	52	1	27	310	Marbéville	113	1	114
21	Champagne-Ardenne	52	2	26	311	Marcilly-en-Bassigny	224	5	229
21	Champagne-Ardenne	52	2	16	312	Mardor	67	0	67
21	Champagne-Ardenne	52	1	01	313	Mareilles	142	5	147
21	Champagne-Ardenne	52	1	21	315	Marnay-sur-Marne	300	7	307
21	Champagne-Ardenne	52	3	13	316	Mathons	60	2	62
21	Champagne-Ardenne	52	2	04	318	Melay	291	1	292
21	Champagne-Ardenne	52	1	09	319	Mennouveaux	69	3	72
21	Champagne-Ardenne	52	1	09	320	Merrey	138	3	141
21	Champagne-Ardenne	52	3	11	321	Mertrud	207	4	211
21	Champagne-Ardenne	52	1	14	322	Meures	112	0	112
21	Champagne-Ardenne	52	1	09	325	Millières	127	2	129
21	Champagne-Ardenne	52	1	27	326	Mirbel	50	3	53
21	Champagne-Ardenne	52	3	31	327	Moëslains	440	13	453
21	Champagne-Ardenne	52	2	04	328	Montcharvot	37	1	38
21	Champagne-Ardenne	52	1	14	330	Montheries	72	0	72
21	Champagne-Ardenne	52	3	18	331	Montier-en-Der	2088	76	2164
21	Champagne-Ardenne	52	1	01	335	Montot-sur-Rognon	113	3	116
21	Champagne-Ardenne	52	3	28	336	Montreuil-sur-Blaise	154	6	160
21	Champagne-Ardenne	52	3	22	337	Montreuil-sur-Thonnance	68	0	68
21	Champagne-Ardenne	52	2	23	340	Montsaugeon	65	4	69
21	Champagne-Ardenne	52	3	28	341	Morancourt	142	5	147
21	Champagne-Ardenne	52	1	24	342	Morionvilliers	29	1	30
21	Champagne-Ardenne	52	2	03	344	Mouilleron	33	1	34
21	Champagne-Ardenne	52	3	10	346	Mussey-sur-Marne	338	5	343
21	Champagne-Ardenne	52	3	08	347	Narcy	244	0	244
21	Champagne-Ardenne	52	2	20	348	Neuilly-l;Évêque	639	14	653
21	Champagne-Ardenne	52	1	29	349	Neuilly-sur-Suize	332	14	346
21	Champagne-Ardenne	52	2	15	350	Neuvelle-lès-Voisey	90	1	91
21	Champagne-Ardenne	52	1	05	351	Nijon	75	4	79
21	Champagne-Ardenne	52	1	21	352	Ninville	85	2	87
21	Champagne-Ardenne	52	1	21	353	Nogent	3985	65	4050
21	Champagne-Ardenne	52	2	17	354	Noidant-Chatenoy	90	2	92
21	Champagne-Ardenne	52	2	16	355	Noidant-le-Rocheux	206	13	219
21	Champagne-Ardenne	52	3	13	356	Nomécourt	97	4	101
21	Champagne-Ardenne	52	3	22	357	Noncourt-sur-le-Rongeant	170	1	171
21	Champagne-Ardenne	52	1	09	358	Noyers	72	2	74
21	Champagne-Ardenne	52	3	11	359	Nully	177	6	183
21	Champagne-Ardenne	52	2	23	360	Occey	148	7	155
21	Champagne-Ardenne	52	2	20	362	Orbigny-au-Mont	155	7	162
21	Champagne-Ardenne	52	2	20	363	Orbigny-au-Val	96	3	99
21	Champagne-Ardenne	52	2	17	364	Orcevaux	120	5	125
21	Champagne-Ardenne	52	1	06	365	Orges	407	12	419
21	Champagne-Ardenne	52	2	16	366	Ormancey	81	3	84
21	Champagne-Ardenne	52	1	27	367	Ormoy-lès-Sexfontaines	42	0	42
21	Champagne-Ardenne	52	1	24	369	Orquevaux	79	3	82
21	Champagne-Ardenne	52	3	08	370	Osne-le-Val	277	6	283
21	Champagne-Ardenne	52	1	27	371	Oudincourt	163	3	166
21	Champagne-Ardenne	52	1	05	372	Outremécourt	88	3	91
21	Champagne-Ardenne	52	1	05	373	Ozières	58	0	58
21	Champagne-Ardenne	52	2	17	374	Le Pailly	306	8	314
21	Champagne-Ardenne	52	2	17	375	Palaiseul	60	0	60
21	Champagne-Ardenne	52	3	22	376	Pansey	85	0	85
21	Champagne-Ardenne	52	2	04	377	Parnoy-en-Bassigny	298	10	308
21	Champagne-Ardenne	52	3	22	378	Paroy-sur-Saulx	45	0	45
21	Champagne-Ardenne	52	3	10	379	Pautaines-Augeville	21	1	22
21	Champagne-Ardenne	52	2	16	380	Peigney	341	15	356
21	Champagne-Ardenne	52	2	16	383	Perrancey-les-Vieux-Moulins	284	13	297
21	Champagne-Ardenne	52	2	17	384	Perrogney-les-Fontaines	107	5	112
21	Champagne-Ardenne	52	1	09	385	Perrusse	43	2	45
21	Champagne-Ardenne	52	3	31	386	Perthes	558	20	578
21	Champagne-Ardenne	52	2	15	388	Pierremont-sur-Amance	168	6	174
21	Champagne-Ardenne	52	2	15	390	Pisseloup	44	0	44
21	Champagne-Ardenne	52	3	18	391	Planrupt	315	4	319
21	Champagne-Ardenne	52	2	26	392	Plesnoy	105	2	107
21	Champagne-Ardenne	52	2	03	393	Poinsenot	53	3	56
21	Champagne-Ardenne	52	2	12	394	Poinson-lès-Fayl	227	0	227
21	Champagne-Ardenne	52	2	03	395	Poinson-lès-Grancey	60	4	64
21	Champagne-Ardenne	52	1	21	396	Poinson-lès-Nogent	151	4	155
21	Champagne-Ardenne	52	2	20	397	Poiseul	75	1	76
21	Champagne-Ardenne	52	3	22	398	Poissons	736	19	755
21	Champagne-Ardenne	52	1	06	399	Pont-la-Ville	149	6	155
21	Champagne-Ardenne	52	1	21	401	Poulangy	385	9	394
21	Champagne-Ardenne	52	2	03	403	Praslay	68	4	72
21	Champagne-Ardenne	52	2	23	405	Prauthoy	505	12	517
21	Champagne-Ardenne	52	2	12	406	Pressigny	201	8	209
21	Champagne-Ardenne	52	1	24	407	Prez-sous-Lafauche	347	4	351
21	Champagne-Ardenne	52	3	18	411	Puellemontier	218	15	233
21	Champagne-Ardenne	52	3	08	414	Rachecourt-sur-Marne	824	19	843
21	Champagne-Ardenne	52	3	28	413	Rachecourt-Suzémont	111	1	112
21	Champagne-Ardenne	52	1	09	416	Rangecourt	78	0	78
21	Champagne-Ardenne	52	2	26	415	Rançonnières	113	1	114
21	Champagne-Ardenne	52	1	14	419	Rennepont	165	3	168
21	Champagne-Ardenne	52	1	01	420	Reynel	126	5	131
21	Champagne-Ardenne	52	1	07	421	Riaucourt	456	11	467
21	Champagne-Ardenne	52	1	02	422	Richebourg	270	10	280
21	Champagne-Ardenne	52	1	01	423	Rimaucourt	728	15	743
21	Champagne-Ardenne	52	2	23	425	Rivière-les-Fosses	221	4	225
21	Champagne-Ardenne	52	2	17	424	Rivières-le-Bois	70	1	71
21	Champagne-Ardenne	52	1	14	426	Rizaucourt-Buchey	118	2	120
21	Champagne-Ardenne	52	3	18	427	Robert-Magny	249	3	252
21	Champagne-Ardenne	52	1	01	428	Rochefort-sur-la-Côte	65	3	68
21	Champagne-Ardenne	52	3	10	044	Roches-Bettaincourt	629	8	637
21	Champagne-Ardenne	52	3	32	429	Roches-sur-Marne	580	8	588
21	Champagne-Ardenne	52	2	03	431	Rochetaillée	151	4	155
21	Champagne-Ardenne	52	2	20	432	Rolampont	1604	29	1633
21	Champagne-Ardenne	52	1	05	433	Romain-sur-Meuse	124	8	132
21	Champagne-Ardenne	52	3	10	436	Rouécourt	58	1	59
21	Champagne-Ardenne	52	2	03	437	Rouelles	37	1	38
21	Champagne-Ardenne	52	2	12	438	Rougeux	126	10	136
21	Champagne-Ardenne	52	2	03	439	Rouvres-sur-Aube	100	3	103
21	Champagne-Ardenne	52	3	10	440	Rouvroy-sur-Marne	366	13	379
21	Champagne-Ardenne	52	3	13	442	Rupt	331	11	342
21	Champagne-Ardenne	52	3	22	443	Sailly	42	2	44
21	Champagne-Ardenne	52	1	24	444	Saint-Blin	396	15	411
21	Champagne-Ardenne	52	2	17	445	Saint-Broingt-le-Bois	84	38	122
21	Champagne-Ardenne	52	2	23	446	Saint-Broingt-les-Fosses	221	10	231
21	Champagne-Ardenne	52	2	16	447	Saint-Ciergues	178	6	184
21	Champagne-Ardenne	52	3	86	448	Saint-Dizier	25526	1023	26549
21	Champagne-Ardenne	52	2	03	450	Saint-Loup-sur-Aujon	167	3	170
21	Champagne-Ardenne	52	2	16	452	Saint-Martin-lès-Langres	95	4	99
21	Champagne-Ardenne	52	2	16	453	Saint-Maurice	123	5	128
21	Champagne-Ardenne	52	1	05	455	Saint-Thiébault	278	14	292
21	Champagne-Ardenne	52	3	10	456	Saint-Urbain-Maconcourt	648	12	660
21	Champagne-Ardenne	52	2	16	457	Saint-Vallier-sur-Marne	181	5	186
21	Champagne-Ardenne	52	2	16	449	Saints-Geosmes	972	45	1017
21	Champagne-Ardenne	52	1	21	459	Sarcey	113	1	114
21	Champagne-Ardenne	52	2	19	461	Sarrey	383	15	398
21	Champagne-Ardenne	52	3	22	463	Saudron	35	1	36
21	Champagne-Ardenne	52	2	12	464	Saulles	56	0	56
21	Champagne-Ardenne	52	2	19	465	Saulxures	126	5	131
21	Champagne-Ardenne	52	2	12	467	Savigny	56	2	58
21	Champagne-Ardenne	52	1	24	468	Semilly	94	4	98
21	Champagne-Ardenne	52	1	29	469	Semoutiers-Montsaon	911	11	922
21	Champagne-Ardenne	52	2	04	470	Serqueux	466	10	476
21	Champagne-Ardenne	52	1	14	472	Sexfontaines	125	2	127
21	Champagne-Ardenne	52	1	01	473	Signéville	100	0	100
21	Champagne-Ardenne	52	1	06	474	Silvarouvres	47	1	48
21	Champagne-Ardenne	52	3	28	475	Sommancourt	62	1	63
21	Champagne-Ardenne	52	1	05	476	Sommerécourt	81	3	84
21	Champagne-Ardenne	52	3	18	479	Sommevoire	752	21	773
21	Champagne-Ardenne	52	1	27	480	Soncourt-sur-Marne	411	6	417
21	Champagne-Ardenne	52	1	05	482	Soulaucourt-sur-Mouzon	106	5	111
21	Champagne-Ardenne	52	2	15	483	Soyers	76	0	76
21	Champagne-Ardenne	52	3	13	484	Suzannecourt	340	9	349
21	Champagne-Ardenne	52	2	03	486	Ternat	56	2	58
21	Champagne-Ardenne	52	3	18	487	Thilleux	87	4	91
21	Champagne-Ardenne	52	1	21	488	Thivet	278	4	282
21	Champagne-Ardenne	52	1	09	489	Thol-lès-Millières	38	2	40
21	Champagne-Ardenne	52	3	13	490	Thonnance-lès-Joinville	810	20	830
21	Champagne-Ardenne	52	3	22	491	Thonnance-les-Moulins	119	1	120
21	Champagne-Ardenne	52	2	12	492	Torcenay	536	16	552
21	Champagne-Ardenne	52	2	12	493	Tornay	37	1	38
21	Champagne-Ardenne	52	1	07	494	Treix	248	14	262
21	Champagne-Ardenne	52	3	11	495	Trémilly	88	3	91
21	Champagne-Ardenne	52	3	28	497	Troisfontaines-la-Ville	411	5	416
21	Champagne-Ardenne	52	2	23	499	Vaillant	71	1	72
21	Champagne-Ardenne	52	2	23	189	Le Val-d;Esnoms	374	15	389
21	Champagne-Ardenne	52	2	19	332	Val-de-Meuse	1918	77	1995
21	Champagne-Ardenne	52	3	31	500	Valcourt	604	28	632
21	Champagne-Ardenne	52	3	28	502	Valleret	50	3	53
21	Champagne-Ardenne	52	2	12	503	Valleroy	35	0	35
21	Champagne-Ardenne	52	2	03	094	Vals-des-Tilles	165	4	169
21	Champagne-Ardenne	52	2	26	504	Varennes-sur-Amance	300	7	307
21	Champagne-Ardenne	52	1	05	505	Vaudrecourt	33	0	33
21	Champagne-Ardenne	52	1	14	506	Vaudrémont	116	0	116
21	Champagne-Ardenne	52	2	23	509	Vaux-sous-Aubigny	697	22	719
21	Champagne-Ardenne	52	3	28	510	Vaux-sur-Blaise	400	17	417
21	Champagne-Ardenne	52	3	10	511	Vaux-sur-Saint-Urbain	68	4	72
21	Champagne-Ardenne	52	2	16	507	Vauxbons	60	2	62
21	Champagne-Ardenne	52	3	13	512	Vecqueville	610	14	624
21	Champagne-Ardenne	52	2	15	513	Velles	82	2	84
21	Champagne-Ardenne	52	1	29	514	Verbiesles	291	11	302
21	Champagne-Ardenne	52	2	17	515	Verseilles-le-Bas	102	4	106
21	Champagne-Ardenne	52	2	17	516	Verseilles-le-Haut	45	2	47
21	Champagne-Ardenne	52	1	24	517	Vesaignes-sous-Lafauche	128	3	131
21	Champagne-Ardenne	52	1	21	518	Vesaignes-sur-Marne	118	3	121
21	Champagne-Ardenne	52	2	23	519	Vesvres-sous-Chalancey	55	1	56
21	Champagne-Ardenne	52	2	26	520	Vicq	165	6	171
21	Champagne-Ardenne	52	1	27	522	Viéville	338	10	348
21	Champagne-Ardenne	52	1	01	523	Vignes-la-Côte	51	1	52
21	Champagne-Ardenne	52	1	27	524	Vignory	278	6	284
21	Champagne-Ardenne	52	1	06	525	Villars-en-Azois	75	2	77
21	Champagne-Ardenne	52	2	03	526	Villars-Santenoge	97	6	103
21	Champagne-Ardenne	52	3	28	528	Ville-en-Blaisois	172	4	176
21	Champagne-Ardenne	52	2	17	529	Villegusien-le-Lac	721	26	747
21	Champagne-Ardenne	52	3	31	534	Villiers-en-Lieu	1580	40	1620
21	Champagne-Ardenne	52	1	29	535	Villiers-le-Sec	705	22	727
21	Champagne-Ardenne	52	2	17	536	Villiers-lès-Aprey	38	0	38
21	Champagne-Ardenne	52	1	02	538	Villiers-sur-Suize	251	5	256
21	Champagne-Ardenne	52	2	17	539	Violot	84	4	88
21	Champagne-Ardenne	52	2	03	540	Vitry-en-Montagne	35	0	35
21	Champagne-Ardenne	52	1	21	541	Vitry-lès-Nogent	184	2	186
21	Champagne-Ardenne	52	2	03	542	Vivey	62	5	67
21	Champagne-Ardenne	52	3	28	543	Voillecomte	470	4	474
21	Champagne-Ardenne	52	2	15	544	Voisey	337	8	345
21	Champagne-Ardenne	52	2	16	545	Voisines	90	5	95
21	Champagne-Ardenne	52	2	12	546	Voncourt	18	1	19
21	Champagne-Ardenne	52	1	27	547	Vouécourt	220	11	231
21	Champagne-Ardenne	52	1	27	548	Vraincourt	94	0	94
21	Champagne-Ardenne	52	1	05	549	Vroncourt-la-Côte	20	4	24
21	Champagne-Ardenne	52	3	28	550	Wassy	2980	133	3113
52	Pays de la Loire	53	2	32	001	Ahuillé	1839	42	1881
52	Pays de la Loire	53	3	21	002	Alexain	564	7	571
52	Pays de la Loire	53	3	01	003	Ambrières-les-Vallées	2787	69	2856
52	Pays de la Loire	53	1	06	004	Ampoigné	558	14	572
52	Pays de la Loire	53	2	05	005	Andouillé	2261	59	2320
52	Pays de la Loire	53	1	04	006	Argenton-Notre-Dame	208	11	219
52	Pays de la Loire	53	2	02	007	Argentré	2681	65	2746
52	Pays de la Loire	53	3	20	008	Aron	1756	53	1809
52	Pays de la Loire	53	2	22	009	Arquenay	631	20	651
52	Pays de la Loire	53	2	11	010	Assé-le-Bérenger	418	8	426
52	Pays de la Loire	53	2	32	011	Astillé	791	15	806
52	Pays de la Loire	53	1	09	012	Athée	517	13	530
52	Pays de la Loire	53	3	27	013	Averton	615	16	631
52	Pays de la Loire	53	1	31	014	Azé	3256	205	3461
52	Pays de la Loire	53	2	05	015	La Baconnière	1606	36	1642
52	Pays de la Loire	53	3	03	016	Bais	1275	26	1301
52	Pays de la Loire	53	1	13	017	Ballée	727	22	749
52	Pays de la Loire	53	1	25	018	Ballots	1279	20	1299
52	Pays de la Loire	53	2	22	019	Bannes	136	3	139
52	Pays de la Loire	53	3	20	021	La Bazoge-Montpinçon	908	17	925
52	Pays de la Loire	53	2	22	022	La Bazouge-de-Chemeré	521	10	531
52	Pays de la Loire	53	3	20	023	La Bazouge-des-Alleux	454	5	459
52	Pays de la Loire	53	2	22	025	Bazougers	1036	7	1043
52	Pays de la Loire	53	2	19	026	Beaulieu-sur-Oudon	509	23	532
52	Pays de la Loire	53	1	13	027	Beaumont-Pied-de-Boeuf	204	6	210
52	Pays de la Loire	53	3	20	028	Belgeard	553	2	555
52	Pays de la Loire	53	1	04	029	Bierné	673	25	698
52	Pays de la Loire	53	2	22	030	Le Bignon-du-Maine	328	8	336
52	Pays de la Loire	53	2	05	031	La Bigottière	449	3	452
52	Pays de la Loire	53	2	26	032	Blandouet	203	2	205
52	Pays de la Loire	53	1	09	033	La Boissière	127	5	132
52	Pays de la Loire	53	2	02	034	Bonchamp-lès-Laval	5842	207	6049
52	Pays de la Loire	53	1	09	035	Bouchamps-lès-Craon	567	7	574
52	Pays de la Loire	53	1	13	036	Bouère	1034	19	1053
52	Pays de la Loire	53	1	13	037	Bouessay	766	14	780
52	Pays de la Loire	53	3	24	038	Boulay-les-Ifs	161	1	162
52	Pays de la Loire	53	2	19	039	Le Bourgneuf-la-Forêt	1797	24	1821
52	Pays de la Loire	53	2	19	040	Bourgon	621	9	630
52	Pays de la Loire	53	1	25	041	Brains-sur-les-Marches	228	16	244
52	Pays de la Loire	53	3	12	042	Brecé	827	12	839
52	Pays de la Loire	53	2	23	043	Brée	536	5	541
52	Pays de la Loire	53	2	19	045	La Brûlatte	706	10	716
52	Pays de la Loire	53	1	13	046	Le Buret	312	6	318
52	Pays de la Loire	53	3	12	047	Carelles	283	9	292
52	Pays de la Loire	53	2	05	048	Chailland	1185	43	1228
52	Pays de la Loire	53	2	02	049	Châlons-du-Maine	641	10	651
52	Pays de la Loire	53	2	26	050	Chammes	334	6	340
52	Pays de la Loire	53	3	14	051	Champéon	598	11	609
52	Pays de la Loire	53	3	24	052	Champfrémont	316	28	344
52	Pays de la Loire	53	3	03	053	Champgenéteux	570	18	588
52	Pays de la Loire	53	2	17	054	Changé	5509	215	5724
52	Pays de la Loire	53	3	01	055	Chantrigné	605	13	618
52	Pays de la Loire	53	2	02	056	La Chapelle-Anthenaise	933	21	954
52	Pays de la Loire	53	3	14	057	La Chapelle-au-Riboul	514	8	522
52	Pays de la Loire	53	1	07	058	La Chapelle-Craonnaise	325	4	329
52	Pays de la Loire	53	2	23	059	La Chapelle-Rainsouin	393	3	396
52	Pays de la Loire	53	3	14	061	Charchigné	511	6	517
52	Pays de la Loire	53	1	97	062	Château-Gontier	11585	558	12143
52	Pays de la Loire	53	1	04	063	Châtelain	488	7	495
52	Pays de la Loire	53	3	12	064	Châtillon-sur-Colmont	1026	39	1065
52	Pays de la Loire	53	2	11	065	Châtres-la-Forêt	798	22	820
52	Pays de la Loire	53	1	06	066	Chemazé	1360	39	1399
52	Pays de la Loire	53	2	22	067	Chémeré-le-Roi	453	22	475
52	Pays de la Loire	53	1	09	068	Chérancé	168	6	174
52	Pays de la Loire	53	3	08	069	Chevaigné-du-Maine	191	7	198
52	Pays de la Loire	53	3	12	071	Colombiers-du-Plessis	449	12	461
52	Pays de la Loire	53	3	20	072	Commer	1240	28	1268
52	Pays de la Loire	53	1	25	073	Congrier	924	25	949
52	Pays de la Loire	53	3	21	074	Contest	913	30	943
52	Pays de la Loire	53	1	07	075	Cosmes	316	5	321
52	Pays de la Loire	53	2	22	076	Cossé-en-Champagne	330	14	344
52	Pays de la Loire	53	1	07	077	Cossé-le-Vivien	2938	64	3002
52	Pays de la Loire	53	1	04	078	Coudray	856	25	881
52	Pays de la Loire	53	3	01	079	Couesmes-Vaucé	390	11	401
52	Pays de la Loire	53	3	08	080	Couptrain	155	5	160
52	Pays de la Loire	53	2	32	082	Courbeveille	657	6	663
52	Pays de la Loire	53	3	27	083	Courcité	909	30	939
52	Pays de la Loire	53	1	09	084	Craon	4556	209	4765
52	Pays de la Loire	53	3	27	085	Crennes-sur-Fraubée	208	16	224
52	Pays de la Loire	53	2	05	086	La Croixille	671	8	679
52	Pays de la Loire	53	2	22	087	La Cropte	221	7	228
52	Pays de la Loire	53	1	07	088	Cuillé	967	23	990
52	Pays de la Loire	53	1	04	089	Daon	484	10	494
52	Pays de la Loire	53	1	09	090	Denazé	157	4	161
52	Pays de la Loire	53	3	15	091	Désertines	525	9	534
52	Pays de la Loire	53	2	23	092	Deux-Évailles	209	1	210
52	Pays de la Loire	53	3	15	093	La Dorée	316	12	328
52	Pays de la Loire	53	2	28	094	Entrammes	2202	45	2247
52	Pays de la Loire	53	2	22	095	Épineux-le-Seguin	229	6	235
52	Pays de la Loire	53	3	10	096	Ernée	5791	147	5938
52	Pays de la Loire	53	2	11	097	Évron	7148	207	7355
52	Pays de la Loire	53	1	25	098	Fontaine-Couverte	391	14	405
52	Pays de la Loire	53	2	02	099	Forcé	1001	34	1035
52	Pays de la Loire	53	3	15	100	Fougerolles-du-Plessis	1352	23	1375
52	Pays de la Loire	53	1	31	101	Fromentières	811	13	824
52	Pays de la Loire	53	1	07	102	Gastines	188	8	196
52	Pays de la Loire	53	2	19	103	Le Genest-Saint-Isle	2050	43	2093
52	Pays de la Loire	53	1	04	104	Gennes-sur-Glaize	984	31	1015
52	Pays de la Loire	53	2	23	105	Gesnes	223	7	230
52	Pays de la Loire	53	3	27	106	Gesvres	534	13	547
52	Pays de la Loire	53	3	12	107	Gorron	2772	69	2841
52	Pays de la Loire	53	2	19	108	La Gravelle	534	9	543
52	Pays de la Loire	53	3	20	109	Grazay	605	9	614
52	Pays de la Loire	53	1	13	110	Grez-en-Bouère	1005	18	1023
52	Pays de la Loire	53	3	01	111	La Haie-Traversaine	491	13	504
52	Pays de la Loire	53	3	14	112	Le Ham	431	11	442
52	Pays de la Loire	53	3	03	113	Hambers	601	18	619
52	Pays de la Loire	53	3	14	114	Hardanges	204	5	209
52	Pays de la Loire	53	3	12	115	Hercé	330	5	335
52	Pays de la Loire	53	3	14	116	Le Horps	768	18	786
52	Pays de la Loire	53	1	06	117	Houssay	431	6	437
52	Pays de la Loire	53	3	16	118	Le Housseau-Brétignolles	234	10	244
52	Pays de la Loire	53	2	32	119	L; Huisserie	4088	132	4220
52	Pays de la Loire	53	3	03	120	Izé	495	5	500
52	Pays de la Loire	53	3	08	121	Javron-les-Chapelles	1452	46	1498
52	Pays de la Loire	53	3	03	122	Jublains	682	21	703
52	Pays de la Loire	53	2	05	123	Juvigné	1434	20	1454
52	Pays de la Loire	53	1	06	124	Laigné	862	22	884
52	Pays de la Loire	53	3	15	125	Landivy	1172	17	1189
52	Pays de la Loire	53	3	10	126	Larchamp	1052	27	1079
52	Pays de la Loire	53	3	16	127	Lassay-les-Châteaux	2423	69	2492
52	Pays de la Loire	53	1	07	128	Laubrières	315	6	321
52	Pays de la Loire	53	2	19	129	Launay-Villiers	395	2	397
52	Pays de la Loire	53	2	98	130	Laval	50940	3160	54100
52	Pays de la Loire	53	3	12	131	Lesbois	197	4	201
52	Pays de la Loire	53	3	12	132	Levaré	313	6	319
52	Pays de la Loire	53	3	08	133	Lignières-Orgères	710	16	726
52	Pays de la Loire	53	2	11	134	Livet	148	2	150
52	Pays de la Loire	53	1	09	135	Livré-la-Touche	760	26	786
52	Pays de la Loire	53	1	06	136	Loigné-sur-Mayenne	879	32	911
52	Pays de la Loire	53	2	19	137	Loiron	1486	37	1523
52	Pays de la Loire	53	1	04	138	Longuefuye	336	9	345
52	Pays de la Loire	53	3	27	139	Loupfougères	412	8	420
52	Pays de la Loire	53	2	02	140	Louverné	3946	93	4039
52	Pays de la Loire	53	2	02	141	Louvigné	1057	9	1066
52	Pays de la Loire	53	3	08	142	Madré	355	8	363
52	Pays de la Loire	53	2	22	143	Maisoncelles-du-Maine	515	15	530
52	Pays de la Loire	53	3	20	144	Marcillé-la-Ville	798	26	824
52	Pays de la Loire	53	1	06	145	Marigné-Peuton	556	10	566
52	Pays de la Loire	53	3	20	146	Martigné-sur-Mayenne	1653	22	1675
52	Pays de la Loire	53	3	99	147	Mayenne	13299	965	14264
52	Pays de la Loire	53	1	09	148	Mée	203	1	204
52	Pays de la Loire	53	1	31	150	Ménil	961	27	988
52	Pays de la Loire	53	1	07	151	Méral	1089	24	1113
52	Pays de la Loire	53	2	22	152	Meslay-du-Maine	2749	45	2794
52	Pays de la Loire	53	2	11	153	Mézangers	702	19	721
52	Pays de la Loire	53	3	15	154	Montaudin	900	16	916
52	Pays de la Loire	53	3	10	155	Montenay	1387	22	1409
52	Pays de la Loire	53	2	02	156	Montflours	236	8	244
52	Pays de la Loire	53	2	32	157	Montigné-le-Brillant	1272	50	1322
52	Pays de la Loire	53	2	19	158	Montjean	987	17	1004
52	Pays de la Loire	53	2	23	159	Montourtier	352	8	360
52	Pays de la Loire	53	3	14	160	Montreuil-Poulay	403	12	415
52	Pays de la Loire	53	2	23	161	Montsûrs	2107	38	2145
52	Pays de la Loire	53	3	20	162	Moulay	993	20	1013
52	Pays de la Loire	53	2	11	163	Neau	697	12	709
52	Pays de la Loire	53	3	08	164	Neuilly-le-Vendin	386	14	400
52	Pays de la Loire	53	1	09	165	Niafles	316	3	319
52	Pays de la Loire	53	2	32	168	Nuillé-sur-Vicoin	1226	15	1241
52	Pays de la Loire	53	3	21	170	Oisseau	1180	23	1203
52	Pays de la Loire	53	2	19	169	Olivet	425	6	431
52	Pays de la Loire	53	1	06	172	Origné	412	10	422
52	Pays de la Loire	53	3	08	173	La Pallu	180	8	188
52	Pays de la Loire	53	3	21	174	Parigné-sur-Braye	736	29	765
52	Pays de la Loire	53	2	02	175	Parné-sur-Roc	1263	30	1293
52	Pays de la Loire	53	3	01	176	Le Pas	532	8	540
52	Pays de la Loire	53	3	10	177	La Pellerine	300	10	310
52	Pays de la Loire	53	1	07	178	Peuton	223	14	237
52	Pays de la Loire	53	3	21	179	Placé	333	4	337
52	Pays de la Loire	53	1	09	180	Pommerieux	688	24	712
52	Pays de la Loire	53	3	15	181	Pontmain	870	18	888
52	Pays de la Loire	53	2	19	182	Port-Brillet	1910	37	1947
52	Pays de la Loire	53	3	24	185	Pré-en-Pail	2032	100	2132
52	Pays de la Loire	53	1	13	184	Préaux	173	6	179
52	Pays de la Loire	53	1	07	186	Quelaines-Saint-Gault	1962	42	2004
52	Pays de la Loire	53	3	24	187	Ravigny	213	5	218
52	Pays de la Loire	53	1	25	188	Renazé	2671	65	2736
52	Pays de la Loire	53	3	16	189	Rennes-en-Grenouilles	113	1	114
52	Pays de la Loire	53	3	14	190	Le Ribay	467	7	474
52	Pays de la Loire	53	1	25	191	La Roë	250	6	256
52	Pays de la Loire	53	1	25	192	La Rouaudière	340	15	355
52	Pays de la Loire	53	1	13	193	Ruillé-Froid-Fonds	501	12	513
52	Pays de la Loire	53	2	19	194	Ruillé-le-Gravelais	864	16	880
52	Pays de la Loire	53	3	20	195	Sacé	449	9	458
52	Pays de la Loire	53	3	08	196	Saint-Aignan-de-Couptrain	390	5	395
52	Pays de la Loire	53	1	25	197	Saint-Aignan-sur-Roë	868	18	886
52	Pays de la Loire	53	3	27	198	Saint-Aubin-du-Désert	291	3	294
52	Pays de la Loire	53	3	12	199	Saint-Aubin-Fosse-Louvain	232	5	237
52	Pays de la Loire	53	3	21	200	Saint-Baudelle	1186	17	1203
52	Pays de la Loire	53	2	32	201	Saint-Berthevin	7277	256	7533
52	Pays de la Loire	53	3	15	202	Saint-Berthevin-la-Tannière	384	13	397
52	Pays de la Loire	53	1	13	203	Saint-Brice	536	14	550
52	Pays de la Loire	53	3	08	204	Saint-Calais-du-Désert	384	3	387
52	Pays de la Loire	53	2	23	205	Saint-Céneré	448	12	460
52	Pays de la Loire	53	1	13	206	Saint-Charles-la-Forêt	220	8	228
52	Pays de la Loire	53	2	11	207	Saint-Christophe-du-Luat	774	17	791
52	Pays de la Loire	53	3	24	208	Saint-Cyr-en-Pail	461	20	481
52	Pays de la Loire	53	2	19	209	Saint-Cyr-le-Gravelais	543	6	549
52	Pays de la Loire	53	1	04	210	Saint-Denis-d;Anjou	1519	26	1545
52	Pays de la Loire	53	3	10	211	Saint-Denis-de-Gastines	1687	34	1721
52	Pays de la Loire	53	2	22	212	Saint-Denis-du-Maine	432	12	444
52	Pays de la Loire	53	3	15	213	Saint-Ellier-du-Maine	536	13	549
52	Pays de la Loire	53	1	25	214	Saint-Erblon	166	9	175
52	Pays de la Loire	53	1	31	215	Saint-Fort	1532	75	1607
52	Pays de la Loire	53	3	20	216	Saint-Fraimbault-de-Prières	1016	23	1039
52	Pays de la Loire	53	3	21	219	Saint-Georges-Buttavent	1394	41	1435
52	Pays de la Loire	53	2	22	220	Saint-Georges-le-Fléchard	382	1	383
52	Pays de la Loire	53	2	11	221	Saint-Georges-sur-Erve	409	16	425
52	Pays de la Loire	53	3	21	222	Saint-Germain-d;Anxure	328	4	332
52	Pays de la Loire	53	3	27	223	Saint-Germain-de-Coulamer	401	10	411
52	Pays de la Loire	53	2	17	224	Saint-Germain-le-Fouilloux	1024	17	1041
52	Pays de la Loire	53	2	05	225	Saint-Germain-le-Guillaume	480	7	487
52	Pays de la Loire	53	2	05	226	Saint-Hilaire-du-Maine	833	16	849
52	Pays de la Loire	53	2	26	228	Saint-Jean-sur-Erve	479	3	482
52	Pays de la Loire	53	2	17	229	Saint-Jean-sur-Mayenne	1526	46	1572
52	Pays de la Loire	53	3	16	230	Saint-Julien-du-Terroux	271	3	274
52	Pays de la Loire	53	1	04	231	Saint-Laurent-des-Mortiers	194	10	204
52	Pays de la Loire	53	2	26	232	Saint-Léger	286	0	286
52	Pays de la Loire	53	1	13	233	Saint-Loup-du-Dorat	333	11	344
52	Pays de la Loire	53	3	01	234	Saint-Loup-du-Gast	361	15	376
52	Pays de la Loire	53	3	27	236	Saint-Mars-du-Désert	201	2	203
52	Pays de la Loire	53	3	12	237	Saint-Mars-sur-Colmont	438	12	450
52	Pays de la Loire	53	3	15	238	Saint-Mars-sur-la-Futaie	621	22	643
52	Pays de la Loire	53	3	03	239	Saint-Martin-de-Connée	410	10	420
52	Pays de la Loire	53	1	09	240	Saint-Martin-du-Limet	491	11	502
52	Pays de la Loire	53	1	04	241	Saint-Michel-de-Feins	170	6	176
52	Pays de la Loire	53	1	25	242	Saint-Michel-de-la-Roë	249	5	254
52	Pays de la Loire	53	2	19	243	Saint-Ouën-des-Toits	1685	39	1724
52	Pays de la Loire	53	2	23	244	Saint-Ouën-des-Vallons	200	2	202
52	Pays de la Loire	53	2	05	245	Saint-Pierre-des-Landes	977	29	1006
52	Pays de la Loire	53	3	24	246	Saint-Pierre-des-Nids	1932	43	1975
52	Pays de la Loire	53	2	19	247	Saint-Pierre-la-Cour	1971	38	2009
52	Pays de la Loire	53	2	26	248	Saint-Pierre-sur-Erve	137	4	141
52	Pays de la Loire	53	3	03	249	Saint-Pierre-sur-Orthe	476	12	488
52	Pays de la Loire	53	1	07	250	Saint-Poix	398	11	409
52	Pays de la Loire	53	1	09	251	Saint-Quentin-les-Anges	403	8	411
52	Pays de la Loire	53	3	24	252	Saint-Samson	427	11	438
52	Pays de la Loire	53	1	25	253	Saint-Saturnin-du-Limet	513	15	528
52	Pays de la Loire	53	1	06	254	Saint-Sulpice	229	9	238
52	Pays de la Loire	53	3	03	256	Saint-Thomas-de-Courceriers	223	14	237
52	Pays de la Loire	53	2	11	218	Sainte-Gemmes-le-Robert	850	22	872
52	Pays de la Loire	53	3	16	235	Sainte-Marie-du-Bois	236	9	245
52	Pays de la Loire	53	2	26	255	Sainte-Suzanne	975	24	999
52	Pays de la Loire	53	2	22	257	Saulges	303	9	312
52	Pays de la Loire	53	1	09	258	La Selle-Craonnaise	932	20	952
52	Pays de la Loire	53	1	25	259	Senonnes	352	17	369
52	Pays de la Loire	53	1	07	260	Simplé	373	9	382
52	Pays de la Loire	53	3	01	261	Soucé	187	3	190
52	Pays de la Loire	53	2	23	262	Soulgé-sur-Ouette	1105	18	1123
52	Pays de la Loire	53	2	26	264	Thorigné-en-Charnie	189	5	194
52	Pays de la Loire	53	3	16	263	Thuboeuf	296	5	301
52	Pays de la Loire	53	2	26	265	Torcé-Viviers-en-Charnie	731	13	744
52	Pays de la Loire	53	3	03	266	Trans	231	7	238
52	Pays de la Loire	53	2	26	267	Vaiges	1155	11	1166
52	Pays de la Loire	53	3	10	269	Vautorte	584	16	600
52	Pays de la Loire	53	3	12	270	Vieuvy	124	3	127
52	Pays de la Loire	53	3	27	271	Villaines-la-Juhel	3072	86	3158
52	Pays de la Loire	53	3	27	272	Villepail	195	1	196
52	Pays de la Loire	53	1	13	273	Villiers-Charlemagne	1061	29	1090
52	Pays de la Loire	53	2	11	274	Vimarcé	227	5	232
52	Pays de la Loire	53	2	11	276	Voutré	888	16	904
41	Lorraine	54	3	23	001	Abaucourt	298	5	303
41	Lorraine	54	1	11	002	Abbéville-lès-Conflans	231	9	240
41	Lorraine	54	4	10	003	Aboncourt	112	2	114
41	Lorraine	54	1	11	004	Affléville	200	8	208
41	Lorraine	54	3	14	005	Affracourt	103	6	109
41	Lorraine	54	3	42	006	Agincourt	426	5	431
41	Lorraine	54	4	27	007	Aingeray	544	9	553
41	Lorraine	54	4	10	008	Allain	476	3	479
41	Lorraine	54	1	11	009	Allamont	136	1	137
41	Lorraine	54	4	10	010	Allamps	511	13	524
41	Lorraine	54	1	15	011	Allondrelle-la-Malmaison	619	2	621
41	Lorraine	54	3	42	012	Amance	333	7	340
41	Lorraine	54	2	06	013	Amenoncourt	90	4	94
41	Lorraine	54	2	06	014	Ancerviller	254	9	263
41	Lorraine	54	1	02	015	Anderny	289	2	291
41	Lorraine	54	4	12	016	Andilly	289	3	292
41	Lorraine	54	2	04	017	Angomont	101	2	103
41	Lorraine	54	1	07	018	Anoux	277	5	282
41	Lorraine	54	4	12	019	Ansauville	86	4	90
41	Lorraine	54	2	17	020	Anthelupt	447	11	458
41	Lorraine	54	3	23	021	Armaucourt	213	5	218
41	Lorraine	54	4	26	022	Arnaville	605	10	615
41	Lorraine	54	2	01	023	Arracourt	246	5	251
41	Lorraine	54	3	23	024	Arraye-et-Han	331	6	337
41	Lorraine	54	3	40	025	Art-sur-Meurthe	1292	318	1610
41	Lorraine	54	2	01	026	Athienville	165	0	165
41	Lorraine	54	3	24	027	Atton	780	15	795
41	Lorraine	54	1	31	028	Auboué	2589	25	2614
41	Lorraine	54	1	02	029	Audun-le-Roman	2467	59	2526
41	Lorraine	54	2	06	030	Autrepierre	123	2	125
41	Lorraine	54	3	24	031	Autreville-sur-Moselle	267	6	273
41	Lorraine	54	3	29	032	Autrey	174	5	179
41	Lorraine	54	1	02	033	Avillers	94	6	100
41	Lorraine	54	4	12	034	Avrainville	223	8	231
41	Lorraine	54	2	06	035	Avricourt	409	12	421
41	Lorraine	54	1	07	036	Avril	960	14	974
41	Lorraine	54	3	25	037	Azelot	416	7	423
41	Lorraine	54	2	03	038	Azerailles	861	20	881
41	Lorraine	54	2	03	039	Baccarat	4656	71	4727
41	Lorraine	54	2	04	040	Badonviller	1637	28	1665
41	Lorraine	54	4	10	041	Bagneux	155	4	159
41	Lorraine	54	3	14	042	Bainville-aux-Miroirs	349	5	354
41	Lorraine	54	3	33	043	Bainville-sur-Madon	1349	14	1363
41	Lorraine	54	2	06	044	Barbas	152	8	160
41	Lorraine	54	2	05	045	Barbonville	423	7	430
41	Lorraine	54	4	10	046	Barisey-au-Plain	378	13	391
41	Lorraine	54	4	10	047	Barisey-la-Côte	201	3	204
41	Lorraine	54	1	07	048	Les Baroches	373	17	390
41	Lorraine	54	1	37	049	Baslieux	574	8	582
41	Lorraine	54	2	01	050	Bathelémont	60	2	62
41	Lorraine	54	1	31	051	Batilly	1276	20	1296
41	Lorraine	54	4	10	052	Battigny	106	4	110
41	Lorraine	54	2	17	053	Bauzemont	158	2	160
41	Lorraine	54	2	05	054	Bayon	1566	16	1582
41	Lorraine	54	4	26	055	Bayonville-sur-Mad	322	4	326
41	Lorraine	54	1	37	056	Bazailles	163	4	167
41	Lorraine	54	4	12	057	Beaumont	68	1	69
41	Lorraine	54	1	11	058	Béchamps	84	1	85
41	Lorraine	54	3	23	059	Belleau	829	4	833
41	Lorraine	54	3	24	060	Belleville	1474	17	1491
41	Lorraine	54	2	18	061	Bénaménil	545	14	559
41	Lorraine	54	3	14	062	Benney	617	8	625
41	Lorraine	54	4	12	063	Bernécourt	169	4	173
41	Lorraine	54	2	09	064	Bertrambois	357	9	366
41	Lorraine	54	2	03	065	Bertrichamps	1077	35	1112
41	Lorraine	54	1	02	066	Bettainvillers	240	4	244
41	Lorraine	54	1	15	067	Beuveille	735	19	754
41	Lorraine	54	4	10	068	Beuvezin	120	2	122
41	Lorraine	54	1	02	069	Beuvillers	349	4	353
41	Lorraine	54	3	23	070	Bey-sur-Seille	158	0	158
41	Lorraine	54	2	01	071	Bezange-la-Grande	169	1	170
41	Lorraine	54	3	24	072	Bezaumont	249	2	251
41	Lorraine	54	4	28	073	Bicqueley	936	9	945
41	Lorraine	54	2	17	074	Bienville-la-Petite	28	0	28
41	Lorraine	54	2	04	075	Bionville	131	4	135
41	Lorraine	54	2	05	076	Blainville-sur-l;Eau	4013	50	4063
41	Lorraine	54	2	06	077	Blâmont	1143	27	1170
41	Lorraine	54	2	06	078	Blémerey	61	1	62
41	Lorraine	54	3	41	079	Blénod-lès-Pont-à-Mousson	4374	55	4429
41	Lorraine	54	4	28	080	Blénod-lès-Toul	1042	17	1059
41	Lorraine	54	1	37	081	Boismont	470	11	481
41	Lorraine	54	1	11	082	Boncourt	189	2	191
41	Lorraine	54	2	17	083	Bonviller	185	4	189
41	Lorraine	54	2	05	085	Borville	96	0	96
41	Lorraine	54	4	27	086	Boucq	384	9	393
41	Lorraine	54	4	26	087	Bouillonville	127	2	129
41	Lorraine	54	4	27	088	Bouvron	244	8	252
41	Lorraine	54	3	42	089	Bouxières-aux-Chênes	1402	37	1439
41	Lorraine	54	3	42	090	Bouxières-aux-Dames	4101	38	4139
41	Lorraine	54	3	24	091	Bouxières-sous-Froidmont	280	2	282
41	Lorraine	54	3	14	092	Bouzanville	67	0	67
41	Lorraine	54	1	11	093	Brainville	160	4	164
41	Lorraine	54	3	14	094	Bralleville	182	3	185
41	Lorraine	54	3	23	095	Bratte	39	0	39
41	Lorraine	54	1	37	096	Bréhain-la-Ville	298	6	304
41	Lorraine	54	2	04	097	Bréménil	127	2	129
41	Lorraine	54	2	05	098	Brémoncourt	157	4	161
41	Lorraine	54	1	07	099	Briey	5579	193	5772
41	Lorraine	54	3	42	100	Brin-sur-Seille	653	12	665
41	Lorraine	54	2	03	101	Brouville	125	2	127
41	Lorraine	54	4	27	102	Bruley	600	9	609
41	Lorraine	54	1	11	103	Bruville	218	3	221
41	Lorraine	54	3	40	104	Buissoncourt	269	7	276
41	Lorraine	54	4	28	105	Bulligny	501	10	511
41	Lorraine	54	2	01	106	Bures	71	3	74
41	Lorraine	54	2	06	107	Buriville	71	0	71
41	Lorraine	54	3	25	108	Burthecourt-aux-Chênes	92	2	94
41	Lorraine	54	3	14	109	Ceintrey	824	5	829
41	Lorraine	54	3	40	110	Cerville	586	11	597
41	Lorraine	54	3	33	111	Chaligny	3086	31	3117
41	Lorraine	54	1	08	112	Chambley-Bussières	641	7	648
41	Lorraine	54	3	43	113	Champenoux	1208	22	1230
41	Lorraine	54	3	24	114	Champey-sur-Moselle	347	2	349
41	Lorraine	54	3	34	115	Champigneulles	6920	80	7000
41	Lorraine	54	2	18	116	Chanteheux	2009	48	2057
41	Lorraine	54	3	29	117	Chaouilley	116	1	117
41	Lorraine	54	1	15	118	Charency-Vezin	658	8	666
41	Lorraine	54	4	26	119	Charey	74	0	74
41	Lorraine	54	4	28	120	Charmes-la-Côte	319	4	323
41	Lorraine	54	2	05	121	Charmois	157	7	164
41	Lorraine	54	4	28	122	Chaudeney-sur-Moselle	684	23	707
41	Lorraine	54	3	33	123	Chavigny	1758	29	1787
41	Lorraine	54	2	06	124	Chazelles-sur-Albe	32	1	33
41	Lorraine	54	2	18	125	Chenevières	451	7	458
41	Lorraine	54	3	23	126	Chenicourt	222	6	228
41	Lorraine	54	1	32	127	Chenières	619	14	633
41	Lorraine	54	4	28	128	Choloy-Ménillot	709	21	730
41	Lorraine	54	2	09	129	Cirey-sur-Vezouze	1733	26	1759
41	Lorraine	54	2	05	130	Clayeures	194	4	198
41	Lorraine	54	3	23	131	Clémery	517	10	527
41	Lorraine	54	3	29	132	Clérey-sur-Brenon	60	1	61
41	Lorraine	54	2	01	133	Coincourt	157	2	159
41	Lorraine	54	1	15	134	Colmey	293	2	295
41	Lorraine	54	4	10	135	Colombey-les-Belles	1378	25	1403
41	Lorraine	54	1	11	136	Conflans-en-Jarnisy	2413	29	2442
41	Lorraine	54	1	15	137	Cons-la-Grandville	579	12	591
41	Lorraine	54	1	32	138	Cosnes-et-Romain	2621	49	2670
41	Lorraine	54	2	17	139	Courbesseaux	270	5	275
41	Lorraine	54	4	10	140	Courcelles	107	4	111
41	Lorraine	54	3	25	141	Coyviller	138	0	138
41	Lorraine	54	3	14	142	Crantenoy	130	0	130
41	Lorraine	54	4	10	143	Crépey	348	11	359
41	Lorraine	54	3	14	144	Crévéchamps	334	4	338
41	Lorraine	54	2	17	145	Crévic	943	18	961
41	Lorraine	54	4	28	146	Crézilles	256	5	261
41	Lorraine	54	2	18	147	Crion	84	6	90
41	Lorraine	54	2	18	148	Croismare	618	7	625
41	Lorraine	54	1	02	149	Crusnes	1622	25	1647
41	Lorraine	54	3	42	150	Custines	2950	41	2991
41	Lorraine	54	1	32	151	Cutry	966	31	997
41	Lorraine	54	2	05	152	Damelevières	3048	31	3079
41	Lorraine	54	1	08	153	Dampvitoux	65	1	66
41	Lorraine	54	2	03	154	Deneuvre	534	23	557
41	Lorraine	54	2	17	155	Deuxville	408	12	420
41	Lorraine	54	3	14	156	Diarville	499	8	507
41	Lorraine	54	3	41	157	Dieulouard	4558	62	4620
41	Lorraine	54	4	10	158	Dolcourt	92	2	94
41	Lorraine	54	3	25	159	Dombasle-sur-Meurthe	10028	211	10239
41	Lorraine	54	4	12	160	Domèvre-en-Haye	446	5	451
41	Lorraine	54	2	06	161	Domèvre-sur-Vezouze	291	11	302
41	Lorraine	54	4	28	162	Domgermain	1302	32	1334
41	Lorraine	54	2	06	163	Domjevin	243	5	248
41	Lorraine	54	3	29	164	Dommarie-Eulmont	78	1	79
41	Lorraine	54	3	35	165	Dommartemont	645	30	675
41	Lorraine	54	4	26	166	Dommartin-la-Chaussée	41	0	41
41	Lorraine	54	4	27	167	Dommartin-lès-Toul	2024	28	2052
41	Lorraine	54	3	42	168	Dommartin-sous-Amance	257	7	264
41	Lorraine	54	1	02	169	Domprix	65	3	68
41	Lorraine	54	2	05	170	Domptail-en-l;Air	66	0	66
41	Lorraine	54	1	11	171	Doncourt-lès-Conflans	1199	16	1215
41	Lorraine	54	1	15	172	Doncourt-lès-Longuyon	290	4	294
41	Lorraine	54	2	17	173	Drouville	171	1	172
41	Lorraine	54	4	27	174	Écrouves	4245	68	4313
41	Lorraine	54	2	05	175	Einvaux	327	5	332
41	Lorraine	54	2	17	176	Einville-au-Jard	1238	22	1260
41	Lorraine	54	2	06	177	Emberménil	270	3	273
41	Lorraine	54	1	15	178	Épiez-sur-Chiers	186	5	191
41	Lorraine	54	3	23	179	Éply	305	7	312
41	Lorraine	54	3	40	180	Erbéviller-sur-Amezule	89	1	90
41	Lorraine	54	1	02	181	Errouville	786	8	794
41	Lorraine	54	4	26	182	Essey-et-Maizerais	391	12	403
41	Lorraine	54	2	13	183	Essey-la-Côte	88	3	91
41	Lorraine	54	3	35	184	Essey-lès-Nancy	8450	172	8622
41	Lorraine	54	3	29	185	Étreval	64	0	64
41	Lorraine	54	3	42	186	Eulmont	997	25	1022
41	Lorraine	54	4	26	187	Euvezin	101	1	102
41	Lorraine	54	3	23	188	Faulx	1319	5	1324
41	Lorraine	54	4	10	189	Favières	602	17	619
41	Lorraine	54	4	10	190	Fécocourt	115	1	116
41	Lorraine	54	2	04	191	Fenneviller	100	5	105
41	Lorraine	54	3	25	192	Ferrières	287	3	290
41	Lorraine	54	3	41	193	Fey-en-Haye	74	1	75
41	Lorraine	54	1	37	194	Fillières	479	12	491
41	Lorraine	54	2	17	195	Flainval	208	4	212
41	Lorraine	54	3	25	196	Flavigny-sur-Moselle	1746	115	1861
41	Lorraine	54	3	40	197	Fléville-devant-Nancy	2360	45	2405
41	Lorraine	54	1	11	198	Fléville-Lixières	280	1	281
41	Lorraine	54	2	03	199	Flin	383	8	391
41	Lorraine	54	4	26	200	Flirey	180	4	184
41	Lorraine	54	2	03	201	Fontenoy-la-Joûte	289	11	300
41	Lorraine	54	4	27	202	Fontenoy-sur-Moselle	366	4	370
41	Lorraine	54	3	29	203	Forcelles-Saint-Gorgon	147	5	152
41	Lorraine	54	3	29	204	Forcelles-sous-Gugney	93	1	94
41	Lorraine	54	4	27	205	Foug	2767	38	2805
41	Lorraine	54	2	13	206	Fraimbois	346	6	352
41	Lorraine	54	3	29	207	Fraisnes-en-Saintois	110	1	111
41	Lorraine	54	4	12	208	Francheville	290	9	299
41	Lorraine	54	2	13	209	Franconville	52	1	53
41	Lorraine	54	2	06	210	Fréménil	203	5	208
41	Lorraine	54	2	06	211	Frémonville	196	2	198
41	Lorraine	54	1	15	212	Fresnois-la-Montagne	423	9	432
41	Lorraine	54	1	11	213	Friauville	390	8	398
41	Lorraine	54	3	29	214	Frolois	683	10	693
41	Lorraine	54	3	34	215	Frouard	6693	75	6768
41	Lorraine	54	2	05	216	Froville	121	3	124
41	Lorraine	54	2	03	217	Gélacourt	161	2	163
41	Lorraine	54	4	10	218	Gélaucourt	58	1	59
41	Lorraine	54	3	40	219	Gellenoncourt	67	0	67
41	Lorraine	54	4	10	220	Gémonville	79	2	81
41	Lorraine	54	3	14	221	Gerbécourt-et-Haplemont	223	4	227
41	Lorraine	54	2	13	222	Gerbéviller	1365	24	1389
41	Lorraine	54	4	10	223	Germiny	197	4	201
41	Lorraine	54	3	14	224	Germonville	98	5	103
41	Lorraine	54	4	12	225	Gézoncourt	173	1	174
41	Lorraine	54	4	10	226	Gibeaumeix	157	1	158
41	Lorraine	54	1	11	227	Giraumont	1237	11	1248
41	Lorraine	54	2	13	228	Giriviller	75	0	75
41	Lorraine	54	2	03	229	Glonville	347	9	356
41	Lorraine	54	2	06	230	Gogney	47	1	48
41	Lorraine	54	1	11	231	Gondrecourt-Aix	180	2	182
41	Lorraine	54	4	27	232	Gondreville	2809	28	2837
41	Lorraine	54	2	06	233	Gondrexon	33	3	36
41	Lorraine	54	1	32	234	Gorcy	2429	41	2470
41	Lorraine	54	3	29	235	Goviller	393	12	405
41	Lorraine	54	1	15	236	Grand-Failly	318	0	318
41	Lorraine	54	4	10	237	Grimonviller	97	2	99
41	Lorraine	54	3	14	238	Gripport	251	1	252
41	Lorraine	54	4	12	239	Griscourt	123	0	123
41	Lorraine	54	4	12	240	Grosrouvres	53	0	53
41	Lorraine	54	3	29	241	Gugney	80	2	82
41	Lorraine	54	4	28	242	Gye	195	2	197
41	Lorraine	54	2	03	243	Hablainville	215	9	224
41	Lorraine	54	1	08	244	Hagéville	124	1	125
41	Lorraine	54	2	05	245	Haigneville	56	1	57
41	Lorraine	54	2	06	246	Halloville	64	4	68
41	Lorraine	54	3	29	247	Hammeville	168	2	170
41	Lorraine	54	4	12	248	Hamonville	98	2	100
41	Lorraine	54	1	15	602	Han-devant-Pierrepont	133	1	134
41	Lorraine	54	1	11	249	Hannonville-Suzémont	289	4	293
41	Lorraine	54	3	40	250	Haraucourt	703	8	711
41	Lorraine	54	2	06	251	Harbouey	106	7	113
41	Lorraine	54	3	14	252	Haroué	418	9	427
41	Lorraine	54	1	31	253	Hatrize	833	16	849
41	Lorraine	54	1	30	254	Haucourt-Moulaine	3100	46	3146
41	Lorraine	54	2	13	255	Haudonville	88	1	89
41	Lorraine	54	2	05	256	Haussonville	321	5	326
41	Lorraine	54	3	38	257	Heillecourt	5774	107	5881
41	Lorraine	54	2	18	258	Hénaménil	169	9	178
41	Lorraine	54	2	06	259	Herbéviller	219	9	228
41	Lorraine	54	2	18	260	Hériménil	954	17	971
41	Lorraine	54	1	30	261	Herserange	4462	59	4521
41	Lorraine	54	2	17	262	Hoéville	178	3	181
41	Lorraine	54	1	31	263	Homécourt	6322	103	6425
41	Lorraine	54	3	29	264	Houdelmont	239	1	240
41	Lorraine	54	3	38	265	Houdemont	2368	56	2424
41	Lorraine	54	3	29	266	Houdreville	436	5	441
41	Lorraine	54	3	14	268	Housséville	180	4	184
41	Lorraine	54	2	17	269	Hudiviller	316	4	320
41	Lorraine	54	1	30	270	Hussigny-Godbrange	3390	55	3445
41	Lorraine	54	2	06	271	Igney	116	6	122
41	Lorraine	54	4	12	272	Jaillon	353	6	359
41	Lorraine	54	1	11	273	Jarny	8519	157	8676
41	Lorraine	54	3	38	274	Jarville-la-Malgrange	9385	266	9651
41	Lorraine	54	4	26	275	Jaulny	263	6	269
41	Lorraine	54	3	23	276	Jeandelaincourt	784	7	791
41	Lorraine	54	1	11	277	Jeandelize	379	12	391
41	Lorraine	54	3	14	278	Jevoncourt	80	1	81
41	Lorraine	54	3	41	279	Jezainville	929	14	943
41	Lorraine	54	1	07	280	Joeuf	6829	76	6905
41	Lorraine	54	2	18	281	Jolivet	869	9	878
41	Lorraine	54	1	02	282	Joppécourt	145	2	147
41	Lorraine	54	1	31	283	Jouaville	318	3	321
41	Lorraine	54	1	02	284	Joudreville	1201	23	1224
41	Lorraine	54	2	01	285	Juvrecourt	67	1	68
41	Lorraine	54	1	11	286	Labry	1679	18	1697
41	Lorraine	54	2	03	287	Lachapelle	253	5	258
41	Lorraine	54	4	27	288	Lagney	490	13	503
41	Lorraine	54	3	42	289	Laître-sous-Amance	363	6	369
41	Lorraine	54	1	37	290	Laix	205	4	209
41	Lorraine	54	3	29	291	Laloeuf	304	5	309
41	Lorraine	54	2	13	292	Lamath	184	2	186
41	Lorraine	54	2	05	293	Landécourt	94	1	95
41	Lorraine	54	3	24	294	Landremont	136	3	139
41	Lorraine	54	1	02	295	Landres	886	64	950
41	Lorraine	54	3	43	296	Laneuvelotte	408	13	421
41	Lorraine	54	2	18	297	Laneuveville-aux-Bois	307	7	314
41	Lorraine	54	4	27	298	Laneuveville-derrière-Foug	136	7	143
41	Lorraine	54	3	14	299	Laneuveville-devant-Bayon	245	3	248
41	Lorraine	54	3	40	300	Laneuveville-devant-Nancy	6012	54	6066
41	Lorraine	54	3	23	301	Lanfroicourt	118	3	121
41	Lorraine	54	1	07	302	Lantéfontaine	770	16	786
41	Lorraine	54	2	18	303	Laronxe	388	3	391
41	Lorraine	54	3	39	304	Laxou	14812	327	15139
41	Lorraine	54	3	42	305	Lay-Saint-Christophe	2541	56	2597
41	Lorraine	54	4	27	306	Lay-Saint-Remy	346	3	349
41	Lorraine	54	3	14	307	Lebeuville	172	0	172
41	Lorraine	54	2	06	308	Leintrey	161	1	162
41	Lorraine	54	3	14	309	Lemainville	348	6	354
41	Lorraine	54	3	14	310	Leménil-Mitry	3	0	3
41	Lorraine	54	3	40	311	Lenoncourt	592	8	600
41	Lorraine	54	3	24	312	Lesménils	485	11	496
41	Lorraine	54	3	23	313	Létricourt	233	2	235
41	Lorraine	54	1	32	314	Lexy	3067	75	3142
41	Lorraine	54	3	23	315	Leyr	956	14	970
41	Lorraine	54	4	26	316	Limey-Remenauville	211	7	218
41	Lorraine	54	4	26	317	Lironville	115	4	119
41	Lorraine	54	4	12	318	Liverdun	6003	81	6084
41	Lorraine	54	3	24	320	Loisy	322	12	334
41	Lorraine	54	1	30	321	Longlaville	2450	36	2486
41	Lorraine	54	1	15	322	Longuyon	5577	97	5674
41	Lorraine	54	1	16	323	Longwy	14420	287	14707
41	Lorraine	54	2	05	324	Lorey	99	0	99
41	Lorraine	54	2	05	325	Loromontzey	82	2	84
41	Lorraine	54	1	07	326	Lubey	220	6	226
41	Lorraine	54	4	27	327	Lucey	580	12	592
41	Lorraine	54	3	38	328	Ludres	6463	112	6575
41	Lorraine	54	2	97	329	Lunéville	19740	546	20286
41	Lorraine	54	3	25	330	Lupcourt	416	5	421
41	Lorraine	54	2	13	331	Magnières	342	5	347
41	Lorraine	54	3	41	332	Maidières	1526	38	1564
41	Lorraine	54	3	23	333	Mailly-sur-Seille	258	0	258
41	Lorraine	54	1	02	334	Mairy-Mainville	574	12	586
41	Lorraine	54	2	17	335	Maixe	432	4	436
41	Lorraine	54	3	33	336	Maizières	930	9	939
41	Lorraine	54	1	02	337	Malavillers	148	0	148
41	Lorraine	54	3	23	338	Malleloy	926	9	935
41	Lorraine	54	3	42	339	Malzéville	8094	250	8344
41	Lorraine	54	4	12	340	Mamey	325	7	332
41	Lorraine	54	1	07	341	Mance	608	26	634
41	Lorraine	54	1	07	342	Mancieulles	1719	17	1736
41	Lorraine	54	4	12	343	Mandres-aux-Quatre-Tours	183	2	185
41	Lorraine	54	3	14	344	Mangonville	228	2	230
41	Lorraine	54	3	25	345	Manoncourt-en-Vermois	337	2	339
41	Lorraine	54	4	12	346	Manoncourt-en-Woëvre	229	4	233
41	Lorraine	54	4	12	348	Manonville	242	4	246
41	Lorraine	54	2	18	349	Manonviller	165	8	173
41	Lorraine	54	2	18	350	Marainviller	702	7	709
41	Lorraine	54	3	34	351	Marbache	1776	14	1790
41	Lorraine	54	3	33	352	Maron	839	13	852
41	Lorraine	54	1	08	353	Mars-la-Tour	968	16	984
41	Lorraine	54	3	29	354	Marthemont	44	0	44
41	Lorraine	54	4	12	355	Martincourt	95	2	97
41	Lorraine	54	2	13	356	Mattexey	69	9	78
41	Lorraine	54	3	34	357	Maxéville	9561	137	9698
41	Lorraine	54	3	43	358	Mazerulles	242	6	248
41	Lorraine	54	2	05	359	Méhoncourt	256	9	265
41	Lorraine	54	4	27	360	Ménil-la-Tour	313	4	317
41	Lorraine	54	1	02	362	Mercy-le-Bas	1359	22	1381
41	Lorraine	54	1	02	363	Mercy-le-Haut	247	1	248
41	Lorraine	54	3	33	364	Méréville	1390	19	1409
41	Lorraine	54	2	03	365	Merviller	379	20	399
41	Lorraine	54	3	33	366	Messein	1822	21	1843
41	Lorraine	54	1	30	367	Mexy	2225	60	2285
41	Lorraine	54	2	03	368	Mignéville	176	5	181
41	Lorraine	54	3	24	369	Millery	637	8	645
41	Lorraine	54	4	12	370	Minorville	228	3	231
41	Lorraine	54	1	31	371	Moineville	1106	14	1120
41	Lorraine	54	3	23	372	Moivrons	461	5	466
41	Lorraine	54	2	18	373	Moncel-lès-Lunéville	524	7	531
41	Lorraine	54	3	43	374	Moncel-sur-Seille	486	7	493
41	Lorraine	54	1	02	084	Mont-Bonvillers	1009	11	1020
41	Lorraine	54	4	10	379	Mont-l;Étroit	107	2	109
41	Lorraine	54	4	28	380	Mont-le-Vignoble	391	5	396
41	Lorraine	54	1	32	382	Mont-Saint-Martin	8117	126	8243
41	Lorraine	54	2	13	383	Mont-sur-Meurthe	1119	15	1134
41	Lorraine	54	3	41	375	Montauville	1167	21	1188
41	Lorraine	54	3	23	376	Montenoy	396	13	409
41	Lorraine	54	2	03	377	Montigny	133	0	133
41	Lorraine	54	1	15	378	Montigny-sur-Chiers	477	8	485
41	Lorraine	54	2	06	381	Montreux	60	0	60
41	Lorraine	54	1	37	385	Morfontaine	1125	28	1153
41	Lorraine	54	2	13	386	Moriviller	101	1	102
41	Lorraine	54	3	24	387	Morville-sur-Seille	130	4	134
41	Lorraine	54	2	01	388	Mouacourt	87	0	87
41	Lorraine	54	1	11	389	Mouaville	109	2	111
41	Lorraine	54	3	24	390	Mousson	121	5	126
41	Lorraine	54	1	31	391	Moutiers	1748	30	1778
41	Lorraine	54	4	28	392	Moutrot	303	6	309
41	Lorraine	54	2	13	393	Moyen	527	18	545
41	Lorraine	54	1	02	394	Murville	244	11	255
41	Lorraine	54	3	98	395	Nancy	105421	2289	107710
41	Lorraine	54	2	04	396	Neufmaisons	236	14	250
41	Lorraine	54	3	33	397	Neuves-Maisons	7162	96	7258
41	Lorraine	54	2	04	398	Neuviller-lès-Badonviller	91	1	92
41	Lorraine	54	3	14	399	Neuviller-sur-Moselle	249	1	250
41	Lorraine	54	3	23	400	Nomeny	1168	25	1193
41	Lorraine	54	2	06	401	Nonhigny	113	1	114
41	Lorraine	54	1	11	402	Norroy-le-Sec	412	4	416
41	Lorraine	54	3	41	403	Norroy-lès-Pont-à-Mousson	1240	24	1264
41	Lorraine	54	4	12	404	Noviant-aux-Prés	260	2	262
41	Lorraine	54	4	28	405	Ochey	475	6	481
41	Lorraine	54	2	06	406	Ogéviller	299	9	308
41	Lorraine	54	3	29	407	Ognéville	122	1	123
41	Lorraine	54	1	11	408	Olley	252	7	259
41	Lorraine	54	3	29	409	Omelmont	167	1	168
41	Lorraine	54	1	08	410	Onville	539	6	545
41	Lorraine	54	3	14	411	Ormes-et-Ville	245	2	247
41	Lorraine	54	1	15	412	Othe	31	2	33
41	Lorraine	54	1	11	413	Ozerailles	157	4	161
41	Lorraine	54	4	27	414	Pagney-derrière-Barine	571	11	582
41	Lorraine	54	3	41	415	Pagny-sur-Moselle	4041	49	4090
41	Lorraine	54	4	26	416	Pannes	185	4	189
41	Lorraine	54	3	29	417	Parey-Saint-Césaire	224	1	225
41	Lorraine	54	2	01	418	Parroy	162	5	167
41	Lorraine	54	2	09	419	Parux	80	2	82
41	Lorraine	54	1	15	420	Petit-Failly	82	2	84
41	Lorraine	54	2	09	421	Petitmont	364	8	372
41	Lorraine	54	2	03	422	Pettonville	59	1	60
41	Lorraine	54	2	04	423	Pexonne	411	5	416
41	Lorraine	54	3	23	424	Phlin	43	0	43
41	Lorraine	54	1	02	425	Piennes	2469	55	2524
41	Lorraine	54	4	28	426	Pierre-la-Treiche	535	8	543
41	Lorraine	54	2	04	427	Pierre-Percée	103	4	107
41	Lorraine	54	1	15	428	Pierrepont	902	15	917
41	Lorraine	54	3	29	429	Pierreville	325	3	328
41	Lorraine	54	3	34	430	Pompey	4993	61	5054
41	Lorraine	54	3	24	431	Pont-à-Mousson	14505	327	14832
41	Lorraine	54	3	33	432	Pont-Saint-Vincent	1968	40	2008
41	Lorraine	54	3	24	433	Port-sur-Seille	234	3	237
41	Lorraine	54	3	29	434	Praye	268	3	271
41	Lorraine	54	3	41	435	Prény	374	5	379
41	Lorraine	54	1	02	436	Preutin-Higny	147	4	151
41	Lorraine	54	3	29	437	Pulligny	1227	23	1250
41	Lorraine	54	4	10	438	Pulney	67	2	69
41	Lorraine	54	3	43	439	Pulnoy	4486	78	4564
41	Lorraine	54	1	11	440	Puxe	112	2	114
41	Lorraine	54	1	08	441	Puxieux	246	6	252
41	Lorraine	54	3	29	442	Quevilloncourt	113	2	115
41	Lorraine	54	2	04	443	Raon-lès-Leau	40	1	41
41	Lorraine	54	3	23	444	Raucourt	202	4	206
41	Lorraine	54	2	17	445	Raville-sur-Sânon	103	1	104
41	Lorraine	54	2	01	446	Réchicourt-la-Petite	78	1	79
41	Lorraine	54	2	06	447	Réclonville	74	4	78
41	Lorraine	54	2	13	449	Rehainviller	968	14	982
41	Lorraine	54	2	03	450	Reherrey	128	3	131
41	Lorraine	54	1	32	451	Réhon	3719	65	3784
41	Lorraine	54	2	06	452	Reillon	60	6	66
41	Lorraine	54	4	26	453	Rembercourt-sur-Mad	186	6	192
41	Lorraine	54	2	13	455	Remenoville	156	4	160
41	Lorraine	54	3	40	456	Réméréville	522	8	530
41	Lorraine	54	2	06	457	Remoncourt	40	0	40
41	Lorraine	54	2	06	458	Repaix	81	2	83
41	Lorraine	54	3	25	459	Richardménil	2487	34	2521
41	Lorraine	54	4	12	460	Rogéville	171	5	176
41	Lorraine	54	2	05	461	Romain	59	2	61
41	Lorraine	54	3	25	462	Rosières-aux-Salines	2866	26	2892
41	Lorraine	54	4	12	463	Rosières-en-Haye	237	4	241
41	Lorraine	54	3	23	464	Rouves	102	1	103
41	Lorraine	54	3	14	465	Roville-devant-Bayon	810	8	818
41	Lorraine	54	4	12	466	Royaumeix	342	6	348
41	Lorraine	54	2	05	467	Rozelieures	183	5	188
41	Lorraine	54	3	25	468	Saffais	128	2	130
41	Lorraine	54	1	31	469	Saint-Ail	360	5	365
41	Lorraine	54	4	26	470	Saint-Baussant	70	3	73
41	Lorraine	54	2	05	471	Saint-Boingt	77	3	80
41	Lorraine	54	2	18	472	Saint-Clément	857	12	869
41	Lorraine	54	3	14	473	Saint-Firmin	279	2	281
41	Lorraine	54	2	05	475	Saint-Germain	151	5	156
41	Lorraine	54	1	15	476	Saint-Jean-lès-Longuyon	400	6	406
41	Lorraine	54	1	08	477	Saint-Julien-lès-Gorze	162	4	166
41	Lorraine	54	1	11	478	Saint-Marcel	139	7	146
41	Lorraine	54	2	05	479	Saint-Mard	98	2	100
41	Lorraine	54	2	06	480	Saint-Martin	74	4	78
41	Lorraine	54	2	04	481	Saint-Maurice-aux-Forges	88	6	94
41	Lorraine	54	3	35	482	Saint-Max	9930	140	10070
41	Lorraine	54	3	25	483	Saint-Nicolas-de-Port	7697	92	7789
41	Lorraine	54	1	15	485	Saint-Pancré	315	5	320
41	Lorraine	54	3	14	486	Saint-Remimont	335	4	339
41	Lorraine	54	2	05	487	Saint-Rémy-aux-Bois	72	2	74
41	Lorraine	54	2	09	488	Saint-Sauveur	48	1	49
41	Lorraine	54	1	02	489	Saint-Supplet	167	4	171
41	Lorraine	54	3	24	474	Sainte-Geneviève	188	3	191
41	Lorraine	54	2	04	484	Sainte-Pôle	204	1	205
41	Lorraine	54	3	34	490	Saizerais	1519	5	1524
41	Lorraine	54	1	02	491	Sancy	349	4	353
41	Lorraine	54	4	27	492	Sanzey	135	6	141
41	Lorraine	54	1	30	493	Saulnes	2350	39	2389
41	Lorraine	54	4	10	494	Saulxerotte	84	0	84
41	Lorraine	54	3	43	495	Saulxures-lès-Nancy	3884	65	3949
41	Lorraine	54	4	10	496	Saulxures-lès-Vannes	354	5	359
41	Lorraine	54	3	29	497	Saxon-Sion	70	3	73
41	Lorraine	54	3	43	498	Seichamps	4981	70	5051
41	Lorraine	54	4	26	499	Seicheprey	118	0	118
41	Lorraine	54	4	10	500	Selaincourt	192	6	198
41	Lorraine	54	2	13	501	Seranville	99	2	101
41	Lorraine	54	2	17	502	Serres	256	5	261
41	Lorraine	54	1	02	504	Serrouville	647	9	656
41	Lorraine	54	4	28	505	Sexey-aux-Forges	658	9	667
41	Lorraine	54	4	27	506	Sexey-les-Bois	366	2	368
41	Lorraine	54	2	18	507	Sionviller	117	3	120
41	Lorraine	54	3	23	508	Sivry	254	4	258
41	Lorraine	54	2	17	509	Sommerviller	905	11	916
41	Lorraine	54	3	43	510	Sornéville	366	6	372
41	Lorraine	54	1	08	511	Sponville	115	5	120
41	Lorraine	54	2	09	512	Tanconville	93	1	94
41	Lorraine	54	3	14	513	Tantonville	652	13	665
41	Lorraine	54	1	15	514	Tellancourt	571	6	577
41	Lorraine	54	3	29	515	Thélod	265	4	269
41	Lorraine	54	3	29	516	They-sous-Vaudemont	13	0	13
41	Lorraine	54	3	23	517	Thézey-Saint-Martin	201	3	204
41	Lorraine	54	4	26	518	Thiaucourt-Regniéville	1239	23	1262
41	Lorraine	54	2	03	519	Thiaville-sur-Meurthe	479	15	494
41	Lorraine	54	2	18	520	Thiébauménil	395	6	401
41	Lorraine	54	1	37	521	Thil	1616	30	1646
41	Lorraine	54	3	29	522	Thorey-Lyautey	133	2	135
41	Lorraine	54	4	10	523	Thuilley-aux-Groseilles	479	3	482
41	Lorraine	54	1	11	524	Thumeréville	98	4	102
41	Lorraine	54	1	37	525	Tiercelet	660	14	674
41	Lorraine	54	3	40	526	Tomblaine	7723	264	7987
41	Lorraine	54	3	25	527	Tonnoy	740	21	761
41	Lorraine	54	4	99	528	Toul	15693	387	16080
41	Lorraine	54	4	10	529	Tramont-Émy	34	0	34
41	Lorraine	54	4	10	530	Tramont-Lassus	83	1	84
41	Lorraine	54	4	10	531	Tramont-Saint-André	54	0	54
41	Lorraine	54	4	12	532	Tremblecourt	197	3	200
41	Lorraine	54	1	02	533	Trieux	2065	22	2087
41	Lorraine	54	4	27	534	Trondes	532	10	542
41	Lorraine	54	1	08	535	Tronville	213	0	213
41	Lorraine	54	1	02	536	Tucquegnieux	2575	61	2636
41	Lorraine	54	1	15	537	Ugny	743	14	757
41	Lorraine	54	4	10	538	Uruffe	378	8	386
41	Lorraine	54	2	03	539	Vacqueville	256	7	263
41	Lorraine	54	2	09	540	Val-et-Châtillon	656	8	664
41	Lorraine	54	2	17	541	Valhey	167	1	168
41	Lorraine	54	1	31	542	Valleroy	2453	29	2482
41	Lorraine	54	2	13	543	Vallois	148	0	148
41	Lorraine	54	4	26	544	Vandelainville	144	1	145
41	Lorraine	54	4	10	545	Vandeléville	206	0	206
41	Lorraine	54	3	41	546	Vandières	929	13	942
41	Lorraine	54	3	96	547	Vandoeuvre-lès-Nancy	30974	490	31464
41	Lorraine	54	4	10	548	Vannes-le-Châtel	573	12	585
41	Lorraine	54	3	40	549	Varangéville	3953	33	3986
41	Lorraine	54	2	13	550	Vathiménil	329	5	334
41	Lorraine	54	2	06	551	Vaucourt	71	1	72
41	Lorraine	54	3	29	552	Vaudémont	80	1	81
41	Lorraine	54	3	14	553	Vaudeville	189	4	193
41	Lorraine	54	3	14	554	Vaudigny	56	5	61
41	Lorraine	54	2	03	555	Vaxainville	86	0	86
41	Lorraine	54	2	06	556	Vého	119	4	123
41	Lorraine	54	4	12	557	Velaine-en-Haye	1435	112	1547
41	Lorraine	54	3	43	558	Velaine-sous-Amance	278	3	281
41	Lorraine	54	2	05	559	Velle-sur-Moselle	307	5	312
41	Lorraine	54	2	03	560	Veney	57	0	57
41	Lorraine	54	2	13	561	Vennezey	47	2	49
41	Lorraine	54	2	06	562	Verdenal	152	7	159
41	Lorraine	54	3	29	563	Vézelise	1495	23	1518
41	Lorraine	54	4	26	564	Viéville-en-Haye	167	7	174
41	Lorraine	54	2	05	565	Vigneulles	273	5	278
41	Lorraine	54	4	26	566	Vilcey-sur-Trey	150	3	153
41	Lorraine	54	2	05	567	Villacourt	470	9	479
41	Lorraine	54	1	37	568	Ville-au-Montois	267	3	270
41	Lorraine	54	3	24	569	Ville-au-Val	177	4	181
41	Lorraine	54	3	25	571	Ville-en-Vermois	595	10	605
41	Lorraine	54	1	32	572	Ville-Houdlémont	635	12	647
41	Lorraine	54	1	11	581	Ville-sur-Yron	301	10	311
41	Lorraine	54	1	08	570	Villecey-sur-Mad	320	10	330
41	Lorraine	54	4	12	573	Villers-en-Haye	180	3	183
41	Lorraine	54	1	15	574	Villers-la-Chèvre	563	17	580
41	Lorraine	54	1	37	575	Villers-la-Montagne	1449	38	1487
41	Lorraine	54	1	15	576	Villers-le-Rond	95	2	97
41	Lorraine	54	3	23	577	Villers-lès-Moivrons	135	1	136
41	Lorraine	54	3	39	578	Villers-lès-Nancy	14341	412	14753
41	Lorraine	54	3	41	579	Villers-sous-Prény	344	8	352
41	Lorraine	54	1	37	580	Villerupt	9421	168	9589
41	Lorraine	54	1	15	582	Villette	198	4	202
41	Lorraine	54	4	28	583	Villey-le-Sec	416	9	425
41	Lorraine	54	4	12	584	Villey-Saint-Étienne	1077	14	1091
41	Lorraine	54	2	05	585	Virecourt	455	12	467
41	Lorraine	54	3	29	586	Viterne	721	8	729
41	Lorraine	54	3	29	587	Vitrey	226	6	232
41	Lorraine	54	2	17	588	Vitrimont	380	5	385
41	Lorraine	54	3	24	589	Vittonville	132	3	135
41	Lorraine	54	1	15	590	Viviers-sur-Chiers	668	12	680
41	Lorraine	54	3	14	591	Voinémont	352	5	357
41	Lorraine	54	3	29	592	Vroncourt	257	5	262
41	Lorraine	54	1	08	593	Waville	444	3	447
41	Lorraine	54	4	26	594	Xammes	120	4	124
41	Lorraine	54	2	13	595	Xermaménil	566	19	585
41	Lorraine	54	3	29	596	Xeuilley	771	6	777
41	Lorraine	54	3	14	597	Xirocourt	454	9	463
41	Lorraine	54	1	02	598	Xivry-Circourt	264	4	268
41	Lorraine	54	1	08	599	Xonville	136	3	139
41	Lorraine	54	2	06	600	Xousse	121	2	123
41	Lorraine	54	2	01	601	Xures	126	5	131
41	Lorraine	55	2	10	001	Abainville	298	7	305
41	Lorraine	55	3	08	002	Abaucourt-Hautecourt	99	1	100
41	Lorraine	55	3	07	004	Aincreville	85	2	87
41	Lorraine	55	2	10	005	Amanty	45	0	45
41	Lorraine	55	3	26	007	Ambly-sur-Meuse	248	6	254
41	Lorraine	55	3	19	008	Amel-sur-l;Étang	175	9	184
41	Lorraine	55	3	18	009	Ancemont	599	15	614
41	Lorraine	55	1	01	010	Ancerville	2770	70	2840
41	Lorraine	55	1	16	011	Andernay	244	2	246
41	Lorraine	55	2	17	012	Apremont-la-Forêt	402	16	418
41	Lorraine	55	3	19	013	Arrancy-sur-Crusne	479	3	482
41	Lorraine	55	3	04	014	Aubréville	409	7	416
41	Lorraine	55	1	01	015	Aulnois-en-Perthois	490	10	500
41	Lorraine	55	1	21	017	Autrécourt-sur-Aire	130	1	131
41	Lorraine	55	3	20	018	Autréville-Saint-Lambert	49	2	51
41	Lorraine	55	3	09	021	Avillers-Sainte-Croix	63	2	65
41	Lorraine	55	3	14	022	Avioth	131	6	137
41	Lorraine	55	3	22	023	Avocourt	122	2	124
41	Lorraine	55	3	06	024	Azannes-et-Soumazannes	159	4	163
41	Lorraine	55	3	20	025	Baâlon	263	3	266
41	Lorraine	55	2	10	026	Badonvilliers-Gérauvilliers	140	7	147
41	Lorraine	55	2	15	027	Bannoncourt	173	4	177
41	Lorraine	55	3	12	028	Bantheville	131	1	132
41	Lorraine	55	1	92	029	Bar-le-Duc	15898	932	16830
41	Lorraine	55	2	10	030	Baudignécourt	77	3	80
41	Lorraine	55	1	01	031	Baudonvilliers	417	15	432
41	Lorraine	55	2	15	032	Baudrémont	54	7	61
41	Lorraine	55	3	22	033	Baulny	15	0	15
41	Lorraine	55	3	14	034	Bazeilles-sur-Othain	108	1	109
41	Lorraine	55	1	01	035	Bazincourt-sur-Saulx	151	10	161
41	Lorraine	55	3	20	036	Beauclair	83	3	86
41	Lorraine	55	3	20	037	Beaufort-en-Argonne	153	5	158
41	Lorraine	55	1	21	038	Beaulieu-en-Argonne	37	1	38
41	Lorraine	55	3	03	039	Beaumont-en-Verdunois	0	0	0
41	Lorraine	55	1	21	040	Beausite	280	13	293
41	Lorraine	55	1	25	041	Behonne	670	28	698
41	Lorraine	55	3	31	042	Belleray	432	8	440
41	Lorraine	55	3	03	043	Belleville-sur-Meuse	3203	75	3278
41	Lorraine	55	2	15	044	Belrain	45	5	50
41	Lorraine	55	3	26	045	Belrupt-en-Verdunois	481	10	491
41	Lorraine	55	2	27	046	Beney-en-Woëvre	155	2	157
41	Lorraine	55	3	03	047	Béthelainville	191	5	196
41	Lorraine	55	3	03	048	Béthincourt	29	1	30
41	Lorraine	55	1	16	049	Beurey-sur-Saulx	435	5	440
41	Lorraine	55	3	03	050	Bezonvaux	0	0	0
41	Lorraine	55	1	13	051	Biencourt-sur-Orge	134	5	139
41	Lorraine	55	3	19	053	Billy-sous-Mangiennes	394	4	398
41	Lorraine	55	2	17	054	Bislée	61	3	64
41	Lorraine	55	3	08	055	Blanzée	20	1	21
41	Lorraine	55	3	08	057	Boinville-en-Woëvre	70	0	70
41	Lorraine	55	2	05	058	Boncourt-sur-Meuse	315	11	326
41	Lorraine	55	2	10	059	Bonnet	215	10	225
41	Lorraine	55	3	09	060	Bonzée	364	13	377
41	Lorraine	55	1	13	061	Le Bouchon-sur-Saulx	236	6	242
41	Lorraine	55	2	17	062	Bouconville-sur-Madt	105	1	106
41	Lorraine	55	3	19	063	Bouligny	2727	33	2760
41	Lorraine	55	2	15	064	Bouquemont	115	1	116
41	Lorraine	55	3	22	065	Boureuilles	126	5	131
41	Lorraine	55	2	28	066	Bovée-sur-Barboure	132	10	142
41	Lorraine	55	2	28	067	Boviolles	108	4	112
41	Lorraine	55	3	04	068	Brabant-en-Argonne	104	1	105
41	Lorraine	55	1	16	069	Brabant-le-Roi	237	9	246
41	Lorraine	55	3	12	070	Brabant-sur-Meuse	138	2	140
41	Lorraine	55	3	06	071	Brandeville	170	0	170
41	Lorraine	55	3	08	072	Braquis	94	1	95
41	Lorraine	55	3	03	073	Bras-sur-Meuse	705	31	736
41	Lorraine	55	1	13	075	Brauvilliers	172	0	172
41	Lorraine	55	3	06	076	Bréhéville	182	2	184
41	Lorraine	55	3	14	077	Breux	267	6	273
41	Lorraine	55	3	07	078	Brieulles-sur-Meuse	331	4	335
41	Lorraine	55	1	01	079	Brillon-en-Barrois	596	19	615
41	Lorraine	55	2	24	080	Brixey-aux-Chanoines	79	5	84
41	Lorraine	55	1	21	081	Brizeaux	50	2	52
41	Lorraine	55	3	04	082	Brocourt-en-Argonne	47	5	52
41	Lorraine	55	3	20	083	Brouennes	155	2	157
41	Lorraine	55	2	28	084	Broussey-en-Blois	59	4	63
41	Lorraine	55	2	17	085	Broussey-Raulecourt	253	3	256
41	Lorraine	55	1	13	087	Bure	91	2	93
41	Lorraine	55	2	24	088	Burey-en-Vaux	142	0	142
41	Lorraine	55	2	24	089	Burey-la-Côte	83	1	84
41	Lorraine	55	2	27	093	Buxières-sous-les-Côtes	276	12	288
41	Lorraine	55	3	08	094	Buzy-Darmont	568	8	576
41	Lorraine	55	3	20	095	Cesse	130	3	133
41	Lorraine	55	2	27	096	Chaillon	96	7	103
41	Lorraine	55	2	24	097	Chalaines	327	7	334
41	Lorraine	55	3	03	099	Champneuville	118	6	124
41	Lorraine	55	2	24	100	Champougny	107	0	107
41	Lorraine	55	1	11	358	Chanteraine	205	10	215
41	Lorraine	55	1	25	101	Chardogne	296	7	303
41	Lorraine	55	3	03	102	Charny-sur-Meuse	560	16	576
41	Lorraine	55	3	22	103	Charpentry	25	3	28
41	Lorraine	55	2	10	104	Chassey-Beaupré	119	3	122
41	Lorraine	55	3	08	105	Châtillon-sous-les-Côtes	164	5	169
41	Lorraine	55	3	03	106	Chattancourt	168	6	174
41	Lorraine	55	3	06	107	Chaumont-devant-Damvillers	49	0	49
41	Lorraine	55	1	23	108	Chaumont-sur-Aire	162	6	168
41	Lorraine	55	3	14	109	Chauvency-le-Château	270	1	271
41	Lorraine	55	3	14	110	Chauvency-Saint-Hubert	257	7	264
41	Lorraine	55	2	17	111	Chauvoncourt	483	24	507
41	Lorraine	55	3	22	113	Cheppy	127	2	129
41	Lorraine	55	2	05	114	Chonville-Malaumont	168	10	178
41	Lorraine	55	3	12	115	Cierges-sous-Montfaucon	58	1	59
41	Lorraine	55	3	04	116	Le Claon	54	1	55
41	Lorraine	55	3	04	117	Clermont-en-Argonne	1567	35	1602
41	Lorraine	55	3	07	118	Cléry-le-Grand	78	0	78
41	Lorraine	55	3	07	119	Cléry-le-Petit	191	1	192
41	Lorraine	55	1	29	120	Combles-en-Barrois	863	31	894
41	Lorraine	55	3	09	121	Combres-sous-les-Côtes	114	6	120
41	Lorraine	55	2	05	122	Commercy	6340	267	6607
41	Lorraine	55	3	12	124	Consenvoye	288	6	294
41	Lorraine	55	1	16	125	Contrisson	745	12	757
41	Lorraine	55	2	15	127	Courcelles-en-Barrois	32	1	33
41	Lorraine	55	1	23	128	Courcelles-sur-Aire	37	5	42
41	Lorraine	55	2	15	129	Courouvre	36	0	36
41	Lorraine	55	1	01	132	Cousances-les-Forges	1706	33	1739
41	Lorraine	55	2	05	518	Cousances-lès-Triconville	144	3	147
41	Lorraine	55	1	13	133	Couvertpuis	88	2	90
41	Lorraine	55	1	16	134	Couvonges	152	4	156
41	Lorraine	55	3	12	137	Cuisy	47	2	49
41	Lorraine	55	3	03	139	Cumières-le-Mort-Homme	0	0	0
41	Lorraine	55	3	12	140	Cunel	14	0	14
41	Lorraine	55	2	05	141	Dagonville	82	3	85
41	Lorraine	55	2	10	142	Dainville-Bertheléville	157	6	163
41	Lorraine	55	3	08	143	Damloup	150	4	154
41	Lorraine	55	1	13	144	Dammarie-sur-Saulx	442	4	446
41	Lorraine	55	3	06	145	Damvillers	655	110	765
41	Lorraine	55	3	12	146	Dannevoux	215	8	223
41	Lorraine	55	2	10	148	Delouze-Rosières	130	3	133
41	Lorraine	55	3	06	149	Delut	105	0	105
41	Lorraine	55	2	10	150	Demange-aux-Eaux	545	20	565
41	Lorraine	55	3	08	153	Dieppe-sous-Douaumont	180	1	181
41	Lorraine	55	3	26	154	Dieue-sur-Meuse	1398	27	1425
41	Lorraine	55	3	04	155	Dombasle-en-Argonne	424	10	434
41	Lorraine	55	3	06	156	Dombras	139	2	141
41	Lorraine	55	3	09	157	Dommartin-la-Montagne	67	1	68
41	Lorraine	55	3	19	158	Dommary-Baroncourt	824	21	845
41	Lorraine	55	2	15	159	Dompcevrin	329	10	339
41	Lorraine	55	2	27	160	Dompierre-aux-Bois	45	2	47
41	Lorraine	55	3	19	162	Domremy-la-Canne	32	1	33
41	Lorraine	55	3	09	163	Doncourt-aux-Templiers	73	1	74
41	Lorraine	55	3	03	164	Douaumont	8	0	8
41	Lorraine	55	3	07	165	Doulcon	448	14	462
41	Lorraine	55	3	31	166	Dugny-sur-Meuse	1321	48	1369
41	Lorraine	55	3	07	167	Dun-sur-Meuse	720	24	744
41	Lorraine	55	3	19	168	Duzey	49	0	49
41	Lorraine	55	3	14	169	Écouviez	522	10	532
41	Lorraine	55	3	06	170	Écurey-en-Verdunois	140	4	144
41	Lorraine	55	3	08	171	Eix	248	10	258
41	Lorraine	55	3	09	172	Les Éparges	75	2	77
41	Lorraine	55	2	24	173	Épiez-sur-Meuse	34	0	34
41	Lorraine	55	3	12	174	Épinonville	77	3	80
41	Lorraine	55	1	25	175	Érize-la-Brûlée	178	0	178
41	Lorraine	55	1	23	177	Érize-la-Petite	68	1	69
41	Lorraine	55	1	25	178	Érize-Saint-Dizier	197	5	202
41	Lorraine	55	2	05	179	Erneville-aux-Bois	175	6	181
41	Lorraine	55	3	22	180	Esnes-en-Argonne	130	2	132
41	Lorraine	55	3	08	181	Étain	3808	57	3865
41	Lorraine	55	3	19	182	Éton	214	3	217
41	Lorraine	55	3	06	183	Étraye	43	1	44
41	Lorraine	55	2	05	184	Euville	1707	32	1739
41	Lorraine	55	1	21	185	Èvres	86	1	87
41	Lorraine	55	1	02	186	Fains-Véel	2255	111	2366
41	Lorraine	55	3	14	188	Flassigny	46	2	48
41	Lorraine	55	3	03	189	Fleury-devant-Douaumont	0	0	0
41	Lorraine	55	3	08	191	Foameix-Ornel	195	11	206
41	Lorraine	55	3	07	192	Fontaines-Saint-Clair	51	0	51
41	Lorraine	55	3	12	193	Forges-sur-Meuse	111	1	112
41	Lorraine	55	1	21	194	Foucaucourt-sur-Thabas	56	2	58
41	Lorraine	55	1	13	195	Fouchères-aux-Bois	143	2	145
41	Lorraine	55	2	05	196	Frémeréville-sous-les-Côtes	108	2	110
41	Lorraine	55	2	15	197	Fresnes-au-Mont	149	7	156
41	Lorraine	55	3	09	198	Fresnes-en-Woëvre	744	11	755
41	Lorraine	55	3	04	199	Froidos	92	4	96
41	Lorraine	55	3	03	200	Fromeréville-les-Vallons	234	9	243
41	Lorraine	55	3	08	201	Fromezey	53	0	53
41	Lorraine	55	3	04	202	Futeau	162	2	164
41	Lorraine	55	3	26	204	Génicourt-sur-Meuse	275	12	287
41	Lorraine	55	3	12	206	Gercourt-et-Drillancourt	142	3	145
41	Lorraine	55	1	25	207	Géry	58	0	58
41	Lorraine	55	3	12	208	Gesnes-en-Argonne	48	1	49
41	Lorraine	55	2	05	258	Geville	602	7	609
41	Lorraine	55	2	15	210	Gimécourt	37	1	38
41	Lorraine	55	3	08	211	Gincrey	63	0	63
41	Lorraine	55	2	05	212	Girauvoisin	75	6	81
41	Lorraine	55	1	11	214	Givrauval	326	6	332
41	Lorraine	55	2	10	215	Gondrecourt-le-Château	1198	25	1223
41	Lorraine	55	3	19	216	Gouraincourt	48	1	49
41	Lorraine	55	2	24	217	Goussaincourt	114	2	116
41	Lorraine	55	3	06	218	Gremilly	26	0	26
41	Lorraine	55	3	08	219	Grimaucourt-en-Woëvre	106	2	108
41	Lorraine	55	2	05	220	Grimaucourt-près-Sampigny	102	1	103
41	Lorraine	55	1	11	221	Guerpont	253	13	266
41	Lorraine	55	3	08	222	Gussainville	34	1	35
41	Lorraine	55	1	01	224	Haironville	615	8	623
41	Lorraine	55	3	20	225	Halles-sous-les-Côtes	153	1	154
41	Lorraine	55	3	14	226	Han-lès-Juvigny	105	3	108
41	Lorraine	55	2	17	229	Han-sur-Meuse	269	6	275
41	Lorraine	55	3	09	228	Hannonville-sous-les-Côtes	632	11	643
41	Lorraine	55	3	09	232	Harville	111	5	116
41	Lorraine	55	3	26	236	Haudainville	962	30	992
41	Lorraine	55	3	09	237	Haudiomont	235	5	240
41	Lorraine	55	3	03	239	Haumont-près-Samogneux	0	0	0
41	Lorraine	55	1	23	123	Les Hauts-de-Chée	734	25	759
41	Lorraine	55	3	18	241	Heippes	71	3	74
41	Lorraine	55	3	09	242	Hennemont	129	8	137
41	Lorraine	55	3	09	243	Herbeuville	180	3	183
41	Lorraine	55	3	08	244	Herméville-en-Woëvre	236	4	240
41	Lorraine	55	2	27	245	Heudicourt-sous-les-Côtes	182	12	194
41	Lorraine	55	1	13	246	Hévilliers	134	0	134
41	Lorraine	55	2	10	247	Horville-en-Ornois	65	4	69
41	Lorraine	55	2	10	248	Houdelaincourt	361	14	375
41	Lorraine	55	3	20	250	Inor	204	9	213
41	Lorraine	55	1	21	251	Ippécourt	97	3	100
41	Lorraine	55	3	14	252	Iré-le-Sec	160	4	164
41	Lorraine	55	3	04	253	Les Islettes	846	22	868
41	Lorraine	55	3	14	255	Jametz	263	1	264
41	Lorraine	55	2	27	256	Jonville-en-Woëvre	141	1	142
41	Lorraine	55	3	04	257	Jouy-en-Argonne	55	0	55
41	Lorraine	55	3	18	260	Julvécourt	68	6	74
41	Lorraine	55	1	01	261	Juvigny-en-Perthois	134	2	136
41	Lorraine	55	3	14	262	Juvigny-sur-Loison	265	2	267
41	Lorraine	55	2	15	263	Koeur-la-Grande	171	6	177
41	Lorraine	55	2	15	264	Koeur-la-Petite	299	4	303
41	Lorraine	55	3	09	265	Labeuville	140	3	143
41	Lorraine	55	3	22	266	Lachalade	61	1	62
41	Lorraine	55	2	27	267	Lachaussée	263	7	270
41	Lorraine	55	2	17	268	Lacroix-sur-Meuse	715	22	737
41	Lorraine	55	2	15	269	Lahaymeix	90	1	91
41	Lorraine	55	2	17	270	Lahayville	31	1	32
41	Lorraine	55	1	23	271	Laheycourt	384	17	401
41	Lorraine	55	1	16	272	Laimont	451	18	469
41	Lorraine	55	2	27	274	Lamorville	284	11	295
41	Lorraine	55	3	20	275	Lamouilly	105	1	106
41	Lorraine	55	3	18	276	Landrecourt-Lempire	193	2	195
41	Lorraine	55	2	28	278	Laneuville-au-Rupt	188	5	193
41	Lorraine	55	3	20	279	Laneuville-sur-Meuse	432	11	443
41	Lorraine	55	3	08	280	Lanhères	65	0	65
41	Lorraine	55	3	09	281	Latour-en-Woëvre	74	2	76
41	Lorraine	55	2	15	282	Lavallée	96	4	100
41	Lorraine	55	1	01	284	Lavincourt	75	1	76
41	Lorraine	55	1	21	285	Lavoye	157	9	166
41	Lorraine	55	3	18	286	Lemmes	230	2	232
41	Lorraine	55	2	05	288	Lérouville	1487	37	1524
41	Lorraine	55	2	15	289	Levoncourt	53	0	53
41	Lorraine	55	2	15	290	Lignières-sur-Aire	47	2	49
41	Lorraine	55	1	11	291	Ligny-en-Barrois	4307	152	4459
41	Lorraine	55	3	07	292	Liny-devant-Dun	190	4	194
41	Lorraine	55	3	07	293	Lion-devant-Dun	173	3	176
41	Lorraine	55	1	23	295	Lisle-en-Barrois	33	0	33
41	Lorraine	55	1	01	296	Lisle-en-Rigault	530	16	546
41	Lorraine	55	3	06	297	Lissey	135	5	140
41	Lorraine	55	1	11	298	Loisey-Culey	453	13	466
41	Lorraine	55	3	19	299	Loison	99	1	100
41	Lorraine	55	2	15	301	Longchamps-sur-Aire	139	5	144
41	Lorraine	55	1	11	300	Longeaux	235	8	243
41	Lorraine	55	1	02	302	Longeville-en-Barrois	1205	32	1237
41	Lorraine	55	2	17	303	Loupmont	86	4	90
41	Lorraine	55	1	23	304	Louppy-le-Château	164	6	170
41	Lorraine	55	3	14	306	Louppy-sur-Loison	122	7	129
41	Lorraine	55	3	03	307	Louvemont-Côte-du-Poivre	0	0	0
41	Lorraine	55	3	20	310	Luzy-Saint-Martin	105	2	107
41	Lorraine	55	3	09	311	Maizeray	35	1	36
41	Lorraine	55	2	17	312	Maizey	180	6	186
41	Lorraine	55	3	22	313	Malancourt	86	3	89
41	Lorraine	55	1	13	315	Mandres-en-Barrois	128	5	133
41	Lorraine	55	3	19	316	Mangiennes	396	7	403
41	Lorraine	55	3	09	317	Manheulles	153	7	160
41	Lorraine	55	3	09	320	Marchéville-en-Woëvre	79	0	79
41	Lorraine	55	3	03	321	Marre	165	8	173
41	Lorraine	55	2	28	322	Marson-sur-Barboure	48	0	48
41	Lorraine	55	3	20	323	Martincourt-sur-Meuse	65	0	65
41	Lorraine	55	3	14	324	Marville	561	11	572
41	Lorraine	55	3	08	325	Maucourt-sur-Orne	60	0	60
41	Lorraine	55	1	11	326	Maulan	98	1	99
41	Lorraine	55	2	10	327	Mauvages	271	8	279
41	Lorraine	55	2	24	328	Maxey-sur-Vaise	306	9	315
41	Lorraine	55	2	05	329	Mécrin	238	6	244
41	Lorraine	55	2	28	330	Méligny-le-Grand	97	7	104
41	Lorraine	55	2	28	331	Méligny-le-Petit	74	3	77
41	Lorraine	55	1	11	332	Menaucourt	219	2	221
41	Lorraine	55	2	15	333	Ménil-aux-Bois	42	2	44
41	Lorraine	55	2	28	334	Ménil-la-Horgne	158	4	162
41	Lorraine	55	1	13	335	Ménil-sur-Saulx	271	8	279
41	Lorraine	55	3	06	336	Merles-sur-Loison	166	4	170
41	Lorraine	55	3	07	338	Milly-sur-Bradon	173	3	176
41	Lorraine	55	3	08	339	Mogeville	74	1	75
41	Lorraine	55	1	16	340	Mognéville	389	9	398
41	Lorraine	55	3	06	341	Moirey-Flabas-Crépion	133	4	137
41	Lorraine	55	3	07	345	Mont-devant-Sassey	120	1	121
41	Lorraine	55	3	22	343	Montblainville	66	4	70
41	Lorraine	55	2	24	344	Montbras	26	1	27
41	Lorraine	55	3	12	346	Montfaucon-d;Argonne	362	6	368
41	Lorraine	55	3	18	347	Les Monthairons	381	4	385
41	Lorraine	55	1	13	348	Montiers-sur-Saulx	450	4	454
41	Lorraine	55	3	07	349	Montigny-devant-Sassey	133	8	141
41	Lorraine	55	2	24	350	Montigny-lès-Vaucouleurs	76	2	78
41	Lorraine	55	3	14	351	Montmédy	2359	83	2442
41	Lorraine	55	1	01	352	Montplonne	164	29	193
41	Lorraine	55	2	17	353	Montsec	86	3	89
41	Lorraine	55	3	03	355	Montzéville	171	7	178
41	Lorraine	55	3	08	356	Moranville	132	3	135
41	Lorraine	55	3	08	357	Morgemoulin	104	1	105
41	Lorraine	55	1	13	359	Morley	202	5	207
41	Lorraine	55	3	09	360	Mouilly	108	3	111
41	Lorraine	55	3	08	361	Moulainville	147	8	155
41	Lorraine	55	3	20	362	Moulins-Saint-Hubert	174	7	181
41	Lorraine	55	3	09	363	Moulotte	118	3	121
41	Lorraine	55	3	20	364	Mouzay	741	16	757
41	Lorraine	55	3	07	365	Murvaux	148	4	152
41	Lorraine	55	3	19	367	Muzeray	129	0	129
41	Lorraine	55	2	28	368	Naives-en-Blois	166	2	168
41	Lorraine	55	1	25	369	Naives-Rosières	824	25	849
41	Lorraine	55	1	11	370	Naix-aux-Forges	212	5	217
41	Lorraine	55	1	11	373	Nant-le-Grand	63	4	67
41	Lorraine	55	1	11	374	Nant-le-Petit	84	2	86
41	Lorraine	55	3	12	375	Nantillois	63	4	67
41	Lorraine	55	1	11	376	Nantois	93	0	93
41	Lorraine	55	2	05	371	Nançois-le-Grand	59	1	60
41	Lorraine	55	1	11	372	Nançois-sur-Ornain	388	8	396
41	Lorraine	55	3	20	377	Nepvant	58	2	60
41	Lorraine	55	1	16	378	Nettancourt	276	7	283
41	Lorraine	55	3	04	379	Le Neufour	78	2	80
41	Lorraine	55	2	15	380	Neuville-en-Verdunois	74	5	79
41	Lorraine	55	2	24	381	Neuville-lès-Vaucouleurs	189	3	192
41	Lorraine	55	1	16	382	Neuville-sur-Ornain	354	5	359
41	Lorraine	55	3	04	383	Neuvilly-en-Argonne	210	2	212
41	Lorraine	55	2	15	384	Nicey-sur-Aire	105	4	109
41	Lorraine	55	3	18	385	Nixéville-Blercourt	448	11	459
41	Lorraine	55	2	27	386	Nonsard-Lamarche	159	3	162
41	Lorraine	55	3	19	387	Nouillonpont	243	5	248
41	Lorraine	55	1	23	388	Noyers-Auzécourt	238	8	246
41	Lorraine	55	1	21	389	Nubécourt	277	8	285
41	Lorraine	55	3	20	391	Olizy-sur-Chiers	191	0	191
41	Lorraine	55	3	03	394	Ornes	6	0	6
41	Lorraine	55	3	18	395	Osches	51	2	53
41	Lorraine	55	2	28	396	Ourches-sur-Meuse	195	5	200
41	Lorraine	55	2	24	397	Pagny-la-Blanche-Côte	248	6	254
41	Lorraine	55	2	28	398	Pagny-sur-Meuse	992	24	1016
41	Lorraine	55	3	09	399	Pareid	119	2	121
41	Lorraine	55	3	08	400	Parfondrupt	52	1	53
41	Lorraine	55	2	17	401	Les Paroches	396	15	411
41	Lorraine	55	3	06	403	Peuvillers	64	5	69
41	Lorraine	55	2	15	404	Pierrefitte-sur-Aire	271	9	280
41	Lorraine	55	3	19	405	Pillon	234	4	238
41	Lorraine	55	3	09	406	Pintheville	93	2	95
41	Lorraine	55	2	05	407	Pont-sur-Meuse	143	7	150
41	Lorraine	55	3	20	408	Pouilly-sur-Meuse	210	7	217
41	Lorraine	55	1	21	409	Pretz-en-Argonne	66	3	69
41	Lorraine	55	3	14	410	Quincy-Landzécourt	146	11	157
41	Lorraine	55	1	25	442	Raival	269	1	270
41	Lorraine	55	3	18	411	Rambluzin-et-Benoite-Vaux	87	1	88
41	Lorraine	55	2	17	412	Rambucourt	190	2	192
41	Lorraine	55	1	16	414	Rancourt-sur-Ornain	210	2	212
41	Lorraine	55	2	17	415	Ranzières	70	0	70
41	Lorraine	55	3	04	416	Rarécourt	223	5	228
41	Lorraine	55	3	04	419	Récicourt	168	5	173
41	Lorraine	55	3	18	420	Récourt-le-Creux	75	2	77
41	Lorraine	55	2	28	421	Reffroy	66	1	67
41	Lorraine	55	3	12	422	Regnéville-sur-Meuse	45	0	45
41	Lorraine	55	1	23	423	Rembercourt-Sommaisne	325	13	338
41	Lorraine	55	1	16	424	Remennecourt	64	4	68
41	Lorraine	55	3	14	425	Remoiville	152	6	158
41	Lorraine	55	1	25	426	Resson	411	14	425
41	Lorraine	55	1	16	427	Revigny-sur-Ornain	3098	64	3162
41	Lorraine	55	3	06	428	Réville-aux-Bois	122	8	130
41	Lorraine	55	3	09	429	Riaville	45	3	48
41	Lorraine	55	1	13	430	Ribeaucourt	108	0	108
41	Lorraine	55	2	17	431	Richecourt	66	1	67
41	Lorraine	55	2	24	433	Rigny-la-Salle	387	17	404
41	Lorraine	55	2	24	434	Rigny-Saint-Martin	58	2	60
41	Lorraine	55	1	29	435	Robert-Espagne	824	18	842
41	Lorraine	55	2	10	436	Les Roises	33	1	34
41	Lorraine	55	3	06	437	Romagne-sous-les-Côtes	112	1	113
41	Lorraine	55	3	12	438	Romagne-sous-Montfaucon	191	5	196
41	Lorraine	55	3	09	439	Ronvaux	92	5	97
41	Lorraine	55	3	08	443	Rouvres-en-Woëvre	771	10	781
41	Lorraine	55	2	17	444	Rouvrois-sur-Meuse	184	7	191
41	Lorraine	55	3	19	445	Rouvrois-sur-Othain	200	6	206
41	Lorraine	55	1	25	446	Rumont	97	0	97
41	Lorraine	55	1	01	447	Rupt-aux-Nonains	363	10	373
41	Lorraine	55	2	15	448	Rupt-devant-Saint-Mihiel	52	1	53
41	Lorraine	55	3	26	449	Rupt-en-Woëvre	305	3	308
41	Lorraine	55	3	06	450	Rupt-sur-Othain	56	1	57
41	Lorraine	55	1	11	452	Saint-Amand-sur-Ornain	69	3	72
41	Lorraine	55	3	18	453	Saint-André-en-Barrois	58	3	61
41	Lorraine	55	2	05	454	Saint-Aubin-sur-Aire	171	4	175
41	Lorraine	55	2	24	456	Saint-Germain-sur-Meuse	265	3	268
41	Lorraine	55	3	09	457	Saint-Hilaire-en-Woëvre	192	9	201
41	Lorraine	55	3	08	458	Saint-Jean-lès-Buzy	322	4	326
41	Lorraine	55	2	10	459	Saint-Joire	245	7	252
41	Lorraine	55	2	05	460	Saint-Julien-sous-les-Côtes	127	3	130
41	Lorraine	55	3	19	461	Saint-Laurent-sur-Othain	496	12	508
41	Lorraine	55	2	27	462	Saint-Maurice-sous-les-Côtes	413	11	424
41	Lorraine	55	2	17	463	Saint-Mihiel	4620	111	4731
41	Lorraine	55	3	19	464	Saint-Pierrevillers	160	4	164
41	Lorraine	55	3	09	465	Saint-Remy-la-Calonne	81	2	83
41	Lorraine	55	1	11	466	Salmagne	310	7	317
41	Lorraine	55	3	03	468	Samogneux	76	1	77
41	Lorraine	55	2	15	467	Sampigny	735	15	750
41	Lorraine	55	3	07	469	Sassey-sur-Meuse	108	4	112
41	Lorraine	55	1	01	470	Saudrupt	202	6	208
41	Lorraine	55	3	07	471	Saulmory-et-Villefranche	107	3	110
41	Lorraine	55	2	28	472	Saulvaux	123	2	125
41	Lorraine	55	3	09	473	Saulx-lès-Champlon	133	4	137
41	Lorraine	55	2	24	474	Sauvigny	262	6	268
41	Lorraine	55	2	28	475	Sauvoy	62	0	62
41	Lorraine	55	1	29	476	Savonnières-devant-Bar	482	12	494
41	Lorraine	55	1	01	477	Savonnières-en-Perthois	460	13	473
41	Lorraine	55	1	25	479	Seigneulles	192	6	198
41	Lorraine	55	3	19	481	Senon	311	2	313
41	Lorraine	55	3	18	482	Senoncourt-les-Maujouy	102	1	103
41	Lorraine	55	3	12	484	Septsarges	50	2	52
41	Lorraine	55	2	24	485	Sepvigny	81	2	83
41	Lorraine	55	1	21	517	Seuil-d;Argonne	503	14	517
41	Lorraine	55	2	27	487	Seuzey	88	2	90
41	Lorraine	55	1	11	488	Silmont	185	2	187
41	Lorraine	55	3	30	489	Sivry-la-Perche	256	11	267
41	Lorraine	55	3	12	490	Sivry-sur-Meuse	376	10	386
41	Lorraine	55	3	26	492	Sommedieue	935	14	949
41	Lorraine	55	1	23	493	Sommeilles	200	4	204
41	Lorraine	55	1	01	494	Sommelonne	493	13	506
41	Lorraine	55	3	19	495	Sorbey	234	10	244
41	Lorraine	55	2	28	496	Sorcy-Saint-Martin	1005	18	1023
41	Lorraine	55	3	18	497	Les Souhesmes-Rampont	328	7	335
41	Lorraine	55	3	18	498	Souilly	360	8	368
41	Lorraine	55	3	19	500	Spincourt	838	25	863
41	Lorraine	55	1	01	501	Stainville	409	9	418
41	Lorraine	55	3	20	502	Stenay	2779	118	2897
41	Lorraine	55	2	24	503	Taillancourt	148	2	150
41	Lorraine	55	1	11	504	Tannois	397	12	409
41	Lorraine	55	3	03	505	Thierville-sur-Meuse	3071	89	3160
41	Lorraine	55	2	15	506	Thillombois	37	0	37
41	Lorraine	55	3	09	507	Thillot	256	5	261
41	Lorraine	55	3	14	508	Thonne-la-Long	266	3	269
41	Lorraine	55	3	14	509	Thonne-le-Thil	282	5	287
41	Lorraine	55	3	14	510	Thonne-les-Près	141	4	145
41	Lorraine	55	3	14	511	Thonnelle	152	3	155
41	Lorraine	55	3	18	512	Tilly-sur-Meuse	275	6	281
41	Lorraine	55	1	29	514	Trémont-sur-Saulx	649	13	662
41	Lorraine	55	3	09	515	Trésauvaux	86	1	87
41	Lorraine	55	2	10	516	Tréveray	635	15	650
41	Lorraine	55	1	21	254	Les Trois-Domaines	128	1	129
41	Lorraine	55	1	11	519	Tronville-en-Barrois	1568	44	1612
41	Lorraine	55	2	28	520	Troussey	420	8	428
41	Lorraine	55	2	17	521	Troyon	245	5	250
41	Lorraine	55	2	24	522	Ugny-sur-Meuse	99	2	101
41	Lorraine	55	3	03	523	Vacherauville	125	6	131
41	Lorraine	55	3	18	525	Vadelaincourt	66	4	70
41	Lorraine	55	2	05	526	Vadonville	255	6	261
41	Lorraine	55	1	16	366	Val-d;Ornain	988	40	1028
41	Lorraine	55	2	27	530	Valbois	104	7	111
41	Lorraine	55	3	22	527	Varennes-en-Argonne	661	18	679
41	Lorraine	55	2	17	528	Varnéville	53	3	56
41	Lorraine	55	1	16	531	Vassincourt	284	23	307
41	Lorraine	55	1	23	532	Vaubecourt	322	9	331
41	Lorraine	55	2	24	533	Vaucouleurs	2054	38	2092
41	Lorraine	55	2	10	534	Vaudeville-le-Haut	69	2	71
41	Lorraine	55	3	19	535	Vaudoncourt	68	3	71
41	Lorraine	55	3	22	536	Vauquois	22	3	25
41	Lorraine	55	3	03	537	Vaux-devant-Damloup	70	4	74
41	Lorraine	55	2	27	540	Vaux-lès-Palameix	47	3	50
41	Lorraine	55	1	25	541	Vavincourt	488	10	498
41	Lorraine	55	1	11	543	Velaines	923	26	949
41	Lorraine	55	3	14	544	Velosnes	159	4	163
41	Lorraine	55	3	93	545	Verdun	18513	1201	19714
41	Lorraine	55	3	14	546	Verneuil-Grand	219	8	227
41	Lorraine	55	3	14	547	Verneuil-Petit	136	1	137
41	Lorraine	55	3	22	549	Véry	89	5	94
41	Lorraine	55	3	14	552	Vigneul-sous-Montmédy	99	0	99
41	Lorraine	55	2	27	551	Vigneulles-lès-Hattonchâtel	1551	110	1661
41	Lorraine	55	2	05	553	Vignot	1317	42	1359
41	Lorraine	55	2	15	555	Ville-devant-Belrain	28	0	28
41	Lorraine	55	3	06	556	Ville-devant-Chaumont	56	0	56
41	Lorraine	55	3	09	557	Ville-en-Woëvre	134	3	137
41	Lorraine	55	3	18	567	Ville-sur-Cousances	111	4	115
41	Lorraine	55	1	01	568	Ville-sur-Saulx	308	8	316
41	Lorraine	55	3	14	554	Villécloye	243	4	247
41	Lorraine	55	2	28	559	Villeroy-sur-Méholle	37	0	37
41	Lorraine	55	1	16	560	Villers-aux-Vents	137	4	141
41	Lorraine	55	3	07	561	Villers-devant-Dun	60	7	67
41	Lorraine	55	1	13	562	Villers-le-Sec	135	1	136
41	Lorraine	55	3	19	563	Villers-lès-Mangiennes	77	1	78
41	Lorraine	55	3	09	565	Villers-sous-Pareid	64	0	64
41	Lorraine	55	3	18	566	Villers-sur-Meuse	263	4	267
41	Lorraine	55	1	23	569	Villotte-devant-Louppy	153	3	156
41	Lorraine	55	2	15	570	Villotte-sur-Aire	178	10	188
41	Lorraine	55	3	07	571	Vilosnes-Haraumont	204	1	205
41	Lorraine	55	3	06	572	Vittarville	87	3	90
41	Lorraine	55	2	28	573	Void-Vacon	1668	40	1708
41	Lorraine	55	2	10	574	Vouthon-Bas	62	1	63
41	Lorraine	55	2	10	575	Vouthon-Haut	72	3	75
41	Lorraine	55	1	21	577	Waly	62	1	63
41	Lorraine	55	3	08	578	Warcq	215	1	216
41	Lorraine	55	3	09	579	Watronville	109	4	113
41	Lorraine	55	3	06	580	Wavrille	43	2	45
41	Lorraine	55	1	11	581	Willeroncourt	129	4	133
41	Lorraine	55	3	20	582	Wiseppe	115	3	118
41	Lorraine	55	3	09	583	Woël	173	4	177
41	Lorraine	55	2	15	584	Woimbey	107	2	109
41	Lorraine	55	2	17	586	Xivray-et-Marvoisin	89	1	90
53	Bretagne	56	3	01	001	Allaire	3658	104	3762
53	Bretagne	56	3	21	002	Ambon	1732	49	1781
53	Bretagne	56	3	38	003	Arradon	5378	247	5625
53	Bretagne	56	3	21	004	Arzal	1443	31	1474
53	Bretagne	56	3	35	005	Arzon	2112	57	2169
53	Bretagne	56	3	13	006	Augan	1460	44	1504
53	Bretagne	56	1	02	007	Auray	12322	373	12695
53	Bretagne	56	3	38	008	Baden	4137	153	4290
53	Bretagne	56	1	22	009	Bangor	932	33	965
53	Bretagne	56	2	03	010	Baud	6010	136	6146
53	Bretagne	56	3	01	011	Béganne	1387	24	1411
53	Bretagne	56	3	13	012	Beignon	1647	69	1716
53	Bretagne	56	1	04	013	Belz	3497	86	3583
53	Bretagne	56	2	07	014	Berné	1538	191	1729
53	Bretagne	56	3	29	015	Berric	1591	31	1622
53	Bretagne	56	2	03	016	Bieuzy	755	18	773
53	Bretagne	56	2	34	017	Bignan	2729	70	2799
53	Bretagne	56	3	21	018	Billiers	918	26	944
53	Bretagne	56	2	34	019	Billio	396	4	400
53	Bretagne	56	3	19	020	Bohal	832	23	855
53	Bretagne	56	1	02	262	Bono	2176	71	2247
53	Bretagne	56	1	14	021	Brandérion	1232	16	1248
53	Bretagne	56	3	10	022	Brandivy	1204	32	1236
53	Bretagne	56	1	25	023	Brech	6487	264	6751
53	Bretagne	56	2	33	024	Bréhan	2336	66	2402
53	Bretagne	56	3	20	025	Brignac	187	2	189
53	Bretagne	56	1	24	026	Bubry	2388	49	2437
53	Bretagne	56	2	34	027	Buléon	487	6	493
53	Bretagne	56	3	32	028	Caden	1600	15	1615
53	Bretagne	56	1	24	029	Calan	957	23	980
53	Bretagne	56	3	31	030	Camoël	918	21	939
53	Bretagne	56	1	25	031	Camors	2821	63	2884
53	Bretagne	56	3	23	032	Campénéac	1811	60	1871
53	Bretagne	56	3	08	033	Carentoir	2761	55	2816
53	Bretagne	56	1	30	034	Carnac	4295	156	4451
53	Bretagne	56	3	19	035	Caro	1169	42	1211
53	Bretagne	56	1	27	036	Caudan	6918	202	7120
53	Bretagne	56	3	19	037	La Chapelle-Caro	1305	21	1326
53	Bretagne	56	3	08	038	La Chapelle-Gaceline	731	14	745
53	Bretagne	56	2	16	039	La Chapelle-Neuve	734	16	750
53	Bretagne	56	1	27	040	Cléguer	3306	67	3373
53	Bretagne	56	2	05	041	Cléguérec	2915	83	2998
53	Bretagne	56	3	10	042	Colpo	2230	45	2275
53	Bretagne	56	3	20	043	Concoret	756	15	771
53	Bretagne	56	3	08	044	Cournon	763	19	782
53	Bretagne	56	3	29	045	Le Cours	580	3	583
53	Bretagne	56	1	02	046	Crach	3283	91	3374
53	Bretagne	56	2	33	047	Crédin	1500	24	1524
53	Bretagne	56	2	12	048	Le Croisty	714	29	743
53	Bretagne	56	2	15	050	La Croix-Helléan	837	26	863
53	Bretagne	56	2	26	049	Croixanvec	152	3	155
53	Bretagne	56	2	15	051	Cruguel	633	6	639
53	Bretagne	56	3	21	052	Damgan	1625	38	1663
53	Bretagne	56	3	06	053	Elven	5310	135	5445
53	Bretagne	56	1	04	054	Erdeven	3489	90	3579
53	Bretagne	56	1	04	055	Étel	2077	140	2217
53	Bretagne	56	3	36	056	Évriguet	179	7	186
53	Bretagne	56	2	07	057	Le Faouët	2866	84	2950
53	Bretagne	56	3	31	058	Férel	2996	65	3061
53	Bretagne	56	2	15	059	Les Forges	400	10	410
53	Bretagne	56	3	08	060	Les Fougerêts	946	20	966
53	Bretagne	56	3	08	061	La Gacilly	2222	58	2280
53	Bretagne	56	1	28	062	Gâvres	737	16	753
53	Bretagne	56	1	27	063	Gestel	2594	67	2661
53	Bretagne	56	3	08	064	Glénac	881	22	903
53	Bretagne	56	3	23	065	Gourhel	590	13	603
53	Bretagne	56	2	09	066	Gourin	4084	185	4269
53	Bretagne	56	3	10	067	Grand-Champ	4964	121	5085
53	Bretagne	56	2	15	068	La Grée-Saint-Laurent	330	5	335
53	Bretagne	56	1	11	069	Groix	2253	74	2327
53	Bretagne	56	2	15	070	Guégon	2424	42	2466
53	Bretagne	56	2	34	071	Guéhenno	794	13	807
53	Bretagne	56	2	26	072	Gueltas	525	27	552
53	Bretagne	56	2	12	073	Guémené-sur-Scorff	1204	26	1230
53	Bretagne	56	2	03	074	Guénin	1569	18	1587
53	Bretagne	56	3	13	075	Guer	6193	270	6463
53	Bretagne	56	2	26	076	Guern	1422	24	1446
53	Bretagne	56	3	21	077	Le Guerno	857	13	870
53	Bretagne	56	1	27	078	Guidel	10359	359	10718
53	Bretagne	56	2	15	079	Guillac	1338	32	1370
53	Bretagne	56	3	36	080	Guilliers	1334	150	1484
53	Bretagne	56	2	07	081	Guiscriff	2344	62	2406
53	Bretagne	56	2	15	082	Helléan	341	6	347
53	Bretagne	56	1	14	083	Hennebont	15191	354	15545
53	Bretagne	56	3	37	084	Le Hézo	730	18	748
53	Bretagne	56	1	30	085	Hoedic	119	3	122
53	Bretagne	56	3	38	087	Île-aux-Moines	629	9	638
53	Bretagne	56	3	38	088	Île-d;Arz	247	4	251
53	Bretagne	56	1	30	086	Île-d;Houat	251	13	264
53	Bretagne	56	1	24	089	Inguiniel	2086	34	2120
53	Bretagne	56	1	14	090	Inzinzac-Lochrist	6013	139	6152
53	Bretagne	56	2	15	091	Josselin	2501	148	2649
53	Bretagne	56	2	26	092	Kerfourn	823	14	837
53	Bretagne	56	2	05	093	Kergrist	648	18	666
53	Bretagne	56	2	12	264	Kernascléden	422	7	429
53	Bretagne	56	1	28	094	Kervignac	5965	178	6143
53	Bretagne	56	1	25	096	Landaul	1998	45	2043
53	Bretagne	56	1	25	097	Landévant	3257	79	3336
53	Bretagne	56	1	40	098	Lanester	22219	525	22744
53	Bretagne	56	2	12	099	Langoëlan	405	8	413
53	Bretagne	56	2	09	100	Langonnet	1916	52	1968
53	Bretagne	56	1	14	101	Languidic	7318	189	7507
53	Bretagne	56	2	15	102	Lanouée	1690	28	1718
53	Bretagne	56	2	33	103	Lantillac	303	3	306
53	Bretagne	56	1	24	104	Lanvaudan	714	22	736
53	Bretagne	56	2	07	105	Lanvénégen	1214	23	1237
53	Bretagne	56	3	38	106	Larmor-Baden	810	16	826
53	Bretagne	56	1	42	107	Larmor-Plage	8334	387	8721
53	Bretagne	56	3	29	108	Larré	872	15	887
53	Bretagne	56	3	29	109	Lauzach	948	20	968
53	Bretagne	56	2	12	110	Lignol	910	22	932
53	Bretagne	56	3	32	111	Limerzel	1306	24	1330
53	Bretagne	56	3	19	112	Lizio	682	25	707
53	Bretagne	56	2	12	113	Locmalo	869	21	890
53	Bretagne	56	1	22	114	Locmaria	806	25	831
53	Bretagne	56	3	10	115	Locmaria-Grand-Champ	1382	20	1402
53	Bretagne	56	1	02	116	Locmariaquer	1661	70	1731
53	Bretagne	56	2	16	117	Locminé	4268	237	4505
53	Bretagne	56	1	28	118	Locmiquélic	4208	80	4288
53	Bretagne	56	1	04	119	Locoal-Mendon	3149	79	3228
53	Bretagne	56	3	10	120	Locqueltas	1616	31	1647
53	Bretagne	56	1	98	121	Lorient	57204	1627	58831
53	Bretagne	56	3	23	122	Loyat	1556	31	1587
53	Bretagne	56	3	32	123	Malansac	2064	49	2113
53	Bretagne	56	3	19	124	Malestroit	2488	116	2604
53	Bretagne	56	2	05	125	Malguénac	1741	60	1801
53	Bretagne	56	3	31	126	Marzan	2004	30	2034
53	Bretagne	56	3	20	127	Mauron	3284	82	3366
53	Bretagne	56	2	03	128	Melrand	1507	39	1546
53	Bretagne	56	3	36	129	Ménéac	1586	38	1624
53	Bretagne	56	1	28	130	Merlevenez	3058	65	3123
53	Bretagne	56	2	07	131	Meslan	1344	26	1370
53	Bretagne	56	3	10	132	Meucon	2119	55	2174
53	Bretagne	56	3	19	133	Missiriac	1078	35	1113
53	Bretagne	56	3	36	134	Mohon	985	11	996
53	Bretagne	56	3	29	135	Molac	1346	28	1374
53	Bretagne	56	3	13	136	Monteneuf	726	8	734
53	Bretagne	56	3	06	137	Monterblanc	3077	54	3131
53	Bretagne	56	3	19	138	Monterrein	387	5	392
53	Bretagne	56	3	23	139	Montertelot	355	7	362
53	Bretagne	56	2	16	140	Moréac	3783	67	3850
53	Bretagne	56	2	16	141	Moustoir-Ac	1754	34	1788
53	Bretagne	56	2	16	142	Moustoir-Remungol	641	33	674
53	Bretagne	56	3	21	143	Muzillac	4694	118	4812
53	Bretagne	56	2	16	144	Naizin	1714	25	1739
53	Bretagne	56	3	20	145	Néant-sur-Yvel	988	32	1020
53	Bretagne	56	2	05	146	Neulliac	1485	41	1526
53	Bretagne	56	3	31	147	Nivillac	4066	86	4152
53	Bretagne	56	1	28	148	Nostang	1380	32	1412
53	Bretagne	56	3	21	149	Noyal-Muzillac	2480	45	2525
53	Bretagne	56	2	26	151	Noyal-Pontivy	3726	117	3843
53	Bretagne	56	3	37	150	Noyalo	777	32	809
53	Bretagne	56	1	22	152	Le Palais	2552	73	2625
53	Bretagne	56	3	29	153	Péaule	2516	56	2572
53	Bretagne	56	3	01	154	Peillac	1839	52	1891
53	Bretagne	56	3	31	155	Pénestin	1900	43	1943
53	Bretagne	56	2	12	156	Persquen	322	11	333
53	Bretagne	56	3	10	157	Plaudren	1617	48	1665
53	Bretagne	56	3	10	158	Plescop	4696	132	4828
53	Bretagne	56	3	29	159	Pleucadeuc	1799	48	1847
53	Bretagne	56	2	33	160	Pleugriffet	1192	28	1220
53	Bretagne	56	1	04	161	Ploemel	2533	54	2587
53	Bretagne	56	1	42	162	Ploemeur	17805	786	18591
53	Bretagne	56	2	12	163	Ploërdut	1234	25	1259
53	Bretagne	56	3	38	164	Ploeren	5786	184	5970
53	Bretagne	56	3	23	165	Ploërmel	9067	561	9628
53	Bretagne	56	1	24	166	Plouay	5284	130	5414
53	Bretagne	56	1	02	167	Plougoumelen	2404	66	2470
53	Bretagne	56	1	30	168	Plouharnel	2038	43	2081
53	Bretagne	56	1	28	169	Plouhinec	5003	96	5099
53	Bretagne	56	2	09	170	Plouray	1107	28	1135
53	Bretagne	56	3	32	171	Pluherlin	1361	28	1389
53	Bretagne	56	2	34	172	Plumelec	2685	44	2729
53	Bretagne	56	2	03	173	Pluméliau	3607	103	3710
53	Bretagne	56	2	16	174	Plumelin	2514	44	2558
53	Bretagne	56	1	02	175	Plumergat	3552	96	3648
53	Bretagne	56	1	02	176	Pluneret	5149	127	5276
53	Bretagne	56	1	25	177	Pluvigner	7006	157	7163
53	Bretagne	56	1	27	179	Pont-Scorff	3211	87	3298
53	Bretagne	56	2	26	178	Pontivy	13765	1095	14860
53	Bretagne	56	3	13	180	Porcaro	671	10	681
53	Bretagne	56	1	28	181	Port-Louis	2718	88	2806
53	Bretagne	56	2	07	182	Priziac	1039	213	1252
53	Bretagne	56	3	08	183	Quelneuc	552	3	555
53	Bretagne	56	3	29	184	Questembert	7391	308	7699
53	Bretagne	56	1	27	185	Quéven	8798	279	9077
53	Bretagne	56	1	30	186	Quiberon	5058	144	5202
53	Bretagne	56	2	15	187	Quily	340	2	342
53	Bretagne	56	1	24	188	Quistinic	1407	26	1433
53	Bretagne	56	2	33	189	Radenac	989	18	1007
53	Bretagne	56	2	33	190	Réguiny	1813	20	1833
53	Bretagne	56	3	13	191	Réminiac	359	7	366
53	Bretagne	56	2	16	192	Remungol	959	22	981
53	Bretagne	56	1	28	193	Riantec	5097	152	5249
53	Bretagne	56	3	01	194	Rieux	2904	107	3011
53	Bretagne	56	3	19	197	Le Roc-Saint-André	936	29	965
53	Bretagne	56	3	31	195	La Roche-Bernard	761	21	782
53	Bretagne	56	3	32	196	Rochefort-en-Terre	660	15	675
53	Bretagne	56	2	33	198	Rohan	1653	37	1690
53	Bretagne	56	2	09	199	Roudouallec	712	25	737
53	Bretagne	56	3	19	200	Ruffiac	1413	49	1462
53	Bretagne	56	2	09	201	Le Saint	642	18	660
53	Bretagne	56	3	19	202	Saint-Abraham	546	18	564
53	Bretagne	56	2	05	203	Saint-Aignan	660	22	682
53	Bretagne	56	2	34	204	Saint-Allouestre	640	11	651
53	Bretagne	56	3	35	205	Saint-Armel	846	26	872
53	Bretagne	56	3	37	206	Saint-Avé	10450	296	10746
53	Bretagne	56	2	03	207	Saint-Barthélemy	1166	22	1188
53	Bretagne	56	3	20	208	Saint-Brieuc-de-Mauron	358	4	362
53	Bretagne	56	2	12	210	Saint-Caradec-Trégomel	480	12	492
53	Bretagne	56	3	32	211	Saint-Congard	750	18	768
53	Bretagne	56	3	31	212	Saint-Dolay	2305	38	2343
53	Bretagne	56	2	26	213	Saint-Gérand	1025	32	1057
53	Bretagne	56	3	35	214	Saint-Gildas-de-Rhuys	1656	43	1699
53	Bretagne	56	2	26	215	Saint-Gonnery	1072	28	1100
53	Bretagne	56	3	01	216	Saint-Gorgon	336	8	344
53	Bretagne	56	3	32	218	Saint-Gravé	740	15	755
53	Bretagne	56	3	19	219	Saint-Guyomard	1060	19	1079
53	Bretagne	56	3	01	221	Saint-Jacut-les-Pins	1744	83	1827
53	Bretagne	56	2	34	222	Saint-Jean-Brévelay	2724	139	2863
53	Bretagne	56	3	01	223	Saint-Jean-la-Poterie	1522	61	1583
53	Bretagne	56	3	32	224	Saint-Laurent-sur-Oust	372	10	382
53	Bretagne	56	3	20	225	Saint-Léry	181	7	188
53	Bretagne	56	3	13	226	Saint-Malo-de-Beignon	484	12	496
53	Bretagne	56	3	36	227	Saint-Malo-des-Trois-Fontaines	564	14	578
53	Bretagne	56	3	19	228	Saint-Marcel	1035	31	1066
53	Bretagne	56	3	08	229	Saint-Martin-sur-Oust	1276	38	1314
53	Bretagne	56	3	19	230	Saint-Nicolas-du-Tertre	458	12	470
53	Bretagne	56	3	06	231	Saint-Nolff	3736	134	3870
53	Bretagne	56	3	01	232	Saint-Perreux	1163	53	1216
53	Bretagne	56	1	02	233	Saint-Philibert	1564	43	1607
53	Bretagne	56	1	30	234	Saint-Pierre-Quiberon	2158	50	2208
53	Bretagne	56	2	15	236	Saint-Servant	778	28	806
53	Bretagne	56	2	26	237	Saint-Thuriau	1892	94	1986
53	Bretagne	56	2	12	238	Saint-Tugdual	401	9	410
53	Bretagne	56	3	01	239	Saint-Vincent-sur-Oust	1391	35	1426
53	Bretagne	56	1	02	263	Sainte-Anne-d;Auray	2433	62	2495
53	Bretagne	56	2	05	209	Sainte-Brigitte	166	7	173
53	Bretagne	56	1	28	220	Sainte-Hélène	1093	22	1115
53	Bretagne	56	3	35	240	Sarzeau	7682	178	7860
53	Bretagne	56	1	22	241	Sauzon	897	30	927
53	Bretagne	56	2	05	242	Séglien	726	25	751
53	Bretagne	56	3	37	243	Séné	8682	329	9011
53	Bretagne	56	3	19	244	Sérent	3004	68	3072
53	Bretagne	56	2	05	245	Silfiac	454	9	463
53	Bretagne	56	2	26	246	Le Sourn	2018	72	2090
53	Bretagne	56	3	06	247	Sulniac	3206	105	3311
53	Bretagne	56	3	37	248	Surzur	3720	106	3826
53	Bretagne	56	3	23	249	Taupont	2162	82	2244
53	Bretagne	56	3	31	250	Théhillac	547	18	565
53	Bretagne	56	3	37	251	Theix	6736	184	6920
53	Bretagne	56	3	35	252	Le Tour-du-Parc	1130	32	1162
53	Bretagne	56	3	08	253	Tréal	659	12	671
53	Bretagne	56	3	06	254	Trédion	1055	29	1084
53	Bretagne	56	3	06	255	Treffléan	2025	48	2073
53	Bretagne	56	3	20	256	Tréhorenteuc	110	1	111
53	Bretagne	56	3	36	257	La Trinité-Porhoët	716	15	731
53	Bretagne	56	1	30	258	La Trinité-sur-Mer	1630	44	1674
53	Bretagne	56	3	37	259	La Trinité-Surzur	1227	19	1246
53	Bretagne	56	3	99	260	Vannes	52515	2601	55116
53	Bretagne	56	3	06	261	La Vraie-Croix	1331	26	1357
41	Lorraine	57	7	21	001	Aboncourt	387	6	393
41	Lorraine	57	2	06	002	Aboncourt-sur-Seille	71	1	72
41	Lorraine	57	5	16	003	Abreschviller	1510	51	1561
41	Lorraine	57	2	06	004	Achain	83	2	85
41	Lorraine	57	6	26	006	Achen	1010	23	1033
41	Lorraine	57	1	09	007	Adaincourt	117	1	118
41	Lorraine	57	1	09	008	Adelange	227	3	230
41	Lorraine	57	2	07	009	Ajoncourt	91	1	92
41	Lorraine	57	2	07	010	Alaincourt-la-Côte	143	4	147
41	Lorraine	57	2	01	011	Albestroff	642	31	673
41	Lorraine	57	8	44	012	Algrange	6544	75	6619
41	Lorraine	57	3	51	013	Alsting	2638	50	2688
41	Lorraine	57	3	14	014	Altrippe	409	6	415
41	Lorraine	57	3	27	015	Altviller	565	19	584
41	Lorraine	57	1	04	016	Alzing	445	13	458
41	Lorraine	57	4	48	017	Amanvillers	2163	17	2180
41	Lorraine	57	2	06	018	Amelécourt	150	0	150
41	Lorraine	57	4	42	019	Amnéville	10100	67	10167
41	Lorraine	57	4	23	020	Ancerville	268	4	272
41	Lorraine	57	4	13	021	Ancy-sur-Moselle	1414	37	1451
41	Lorraine	57	8	11	022	Angevillers	1270	26	1296
41	Lorraine	57	4	35	024	Antilly	122	3	125
41	Lorraine	57	1	04	025	Anzeling	497	14	511
41	Lorraine	57	7	31	026	Apach	983	17	1000
41	Lorraine	57	4	35	028	Argancy	1310	28	1338
41	Lorraine	57	1	09	027	Arraincourt	130	0	130
41	Lorraine	57	1	09	029	Arriance	228	8	236
41	Lorraine	57	4	13	030	Arry	500	4	504
41	Lorraine	57	4	23	031	Ars-Laquenexy	937	18	955
41	Lorraine	57	4	13	032	Ars-sur-Moselle	4846	47	4893
41	Lorraine	57	5	24	033	Arzviller	535	15	550
41	Lorraine	57	5	16	034	Aspach	46	1	47
41	Lorraine	57	5	25	035	Assenoncourt	138	5	143
41	Lorraine	57	2	06	036	Attilloncourt	108	2	110
41	Lorraine	57	4	23	037	Aube	260	4	264
41	Lorraine	57	8	11	038	Audun-le-Tiche	6242	66	6308
41	Lorraine	57	4	20	039	Augny	2233	39	2272
41	Lorraine	57	2	07	040	Aulnois-sur-Seille	238	9	247
41	Lorraine	57	8	11	041	Aumetz	2308	31	2339
41	Lorraine	57	5	25	042	Avricourt	698	12	710
41	Lorraine	57	4	35	043	Ay-sur-Moselle	1540	50	1590
41	Lorraine	57	5	25	044	Azoudange	118	1	119
41	Lorraine	57	2	07	045	Bacourt	117	3	120
41	Lorraine	57	6	02	046	Baerenthal	762	10	772
41	Lorraine	57	1	09	047	Bambiderstroff	1030	21	1051
41	Lorraine	57	4	37	049	Le Ban-Saint-Martin	4252	93	4345
41	Lorraine	57	1	03	048	Bannay	83	1	84
41	Lorraine	57	5	29	050	Barchain	109	4	113
41	Lorraine	57	3	14	051	Baronville	412	6	418
41	Lorraine	57	3	41	052	Barst	563	11	574
41	Lorraine	57	7	21	287	Basse-Ham	2250	39	2289
41	Lorraine	57	7	05	574	Basse-Rentgen	375	10	385
41	Lorraine	57	2	08	053	Bassing	131	6	137
41	Lorraine	57	2	07	054	Baudrecourt	184	2	186
41	Lorraine	57	4	23	055	Bazoncourt	494	11	505
41	Lorraine	57	5	29	056	Bébing	162	4	166
41	Lorraine	57	4	23	057	Béchy	542	1	543
41	Lorraine	57	3	47	058	Behren-lès-Forbach	8193	113	8306
41	Lorraine	57	2	06	059	Bellange	57	2	59
41	Lorraine	57	5	10	086	Belles-Forêts	251	6	257
41	Lorraine	57	2	01	060	Bénestroff	533	17	550
41	Lorraine	57	3	41	061	Béning-lès-Saint-Avold	1238	28	1266
41	Lorraine	57	7	05	062	Berg-sur-Moselle	430	13	443
41	Lorraine	57	3	14	063	Bérig-Vintrange	245	2	247
41	Lorraine	57	5	24	064	Berling	291	9	300
41	Lorraine	57	2	01	065	Bermering	240	3	243
41	Lorraine	57	5	10	066	Berthelming	515	19	534
41	Lorraine	57	7	21	067	Bertrange	2607	48	2655
41	Lorraine	57	1	04	069	Berviller-en-Moselle	501	7	508
41	Lorraine	57	1	03	070	Bettange	214	0	214
41	Lorraine	57	5	10	071	Bettborn	427	9	436
41	Lorraine	57	7	21	072	Bettelainville	625	7	632
41	Lorraine	57	3	41	073	Betting	881	26	907
41	Lorraine	57	6	26	074	Bettviller	835	16	851
41	Lorraine	57	4	23	075	Beux	274	3	277
41	Lorraine	57	7	05	076	Beyren-lès-Sierck	482	14	496
41	Lorraine	57	2	34	077	Bezange-la-Petite	92	1	93
41	Lorraine	57	1	04	079	Bibiche	440	5	445
41	Lorraine	57	5	10	080	Bickenholtz	75	1	76
41	Lorraine	57	2	08	081	Bidestroff	126	4	130
41	Lorraine	57	3	14	082	Biding	308	6	314
41	Lorraine	57	6	26	083	Bining	1194	32	1226
41	Lorraine	57	2	06	084	Bioncourt	314	3	317
41	Lorraine	57	1	03	085	Bionville-sur-Nied	375	5	380
41	Lorraine	57	1	03	087	Bisten-en-Lorraine	259	10	269
41	Lorraine	57	3	14	088	Bistroff	336	3	339
41	Lorraine	57	6	02	089	Bitche	5319	294	5613
41	Lorraine	57	2	08	090	Blanche-Église	139	6	145
41	Lorraine	57	6	50	092	Blies-Ébersing	596	6	602
41	Lorraine	57	6	50	093	Blies-Guersviller	600	8	608
41	Lorraine	57	6	50	091	Bliesbruck	1015	19	1034
41	Lorraine	57	1	03	095	Boucheporn	544	16	560
41	Lorraine	57	8	11	096	Boulange	2290	35	2325
41	Lorraine	57	1	03	097	Boulay-Moselle	5070	79	5149
41	Lorraine	57	2	34	099	Bourdonnay	260	6	266
41	Lorraine	57	2	08	098	Bourgaltroff	283	5	288
41	Lorraine	57	5	24	100	Bourscheid	217	1	218
41	Lorraine	57	3	47	101	Bousbach	1125	37	1162
41	Lorraine	57	7	21	102	Bousse	2910	32	2942
41	Lorraine	57	6	36	103	Bousseviller	137	2	139
41	Lorraine	57	7	05	104	Boust	1131	18	1149
41	Lorraine	57	3	14	105	Boustroff	156	4	160
41	Lorraine	57	1	04	106	Bouzonville	4132	100	4232
41	Lorraine	57	2	07	107	Bréhain	103	4	107
41	Lorraine	57	6	36	108	Breidenbach	346	13	359
41	Lorraine	57	7	05	109	Breistroff-la-Grande	591	13	604
41	Lorraine	57	1	04	110	Brettnach	464	6	470
41	Lorraine	57	4	48	111	Bronvaux	527	12	539
41	Lorraine	57	1	03	112	Brouck	83	1	84
41	Lorraine	57	5	29	113	Brouderdorff	928	24	952
41	Lorraine	57	5	24	114	Brouviller	432	17	449
41	Lorraine	57	3	14	115	Brulange	101	2	103
41	Lorraine	57	4	33	116	Buchy	115	1	116
41	Lorraine	57	7	21	117	Buding	560	5	565
41	Lorraine	57	7	21	118	Budling	174	5	179
41	Lorraine	57	5	29	119	Buhl-Lorraine	1228	34	1262
41	Lorraine	57	2	06	120	Burlioncourt	178	1	179
41	Lorraine	57	4	35	121	Burtoncourt	201	1	202
41	Lorraine	57	3	41	122	Cappel	701	20	721
41	Lorraine	57	3	49	123	Carling	3655	48	3703
41	Lorraine	57	7	05	124	Cattenom	2660	41	2701
41	Lorraine	57	4	35	125	Chailly-lès-Ennery	348	9	357
41	Lorraine	57	2	06	126	Chambrey	378	6	384
41	Lorraine	57	4	23	127	Chanville	119	1	120
41	Lorraine	57	4	35	128	Charleville-sous-Bois	259	5	264
41	Lorraine	57	4	35	129	Charly-Oradour	667	25	692
41	Lorraine	57	2	07	130	Château-Bréhain	76	2	78
41	Lorraine	57	1	04	131	Château-Rouge	223	2	225
41	Lorraine	57	2	06	132	Château-Salins	2422	228	2650
41	Lorraine	57	2	06	133	Château-Voué	119	4	123
41	Lorraine	57	4	13	134	Châtel-Saint-Germain	2292	56	2348
41	Lorraine	57	1	04	136	Chémery-les-Deux	473	16	489
41	Lorraine	57	4	33	137	Cheminot	664	10	674
41	Lorraine	57	2	07	138	Chenois	63	1	64
41	Lorraine	57	4	33	139	Chérisey	272	7	279
41	Lorraine	57	4	33	140	Chesny	535	11	546
41	Lorraine	57	2	07	141	Chicourt	87	2	89
41	Lorraine	57	4	20	142	Chieulles	386	14	400
41	Lorraine	57	8	22	143	Clouange	3907	26	3933
41	Lorraine	57	3	47	144	Cocheren	3496	51	3547
41	Lorraine	57	4	33	146	Coin-lès-Cuvry	721	16	737
41	Lorraine	57	4	33	147	Coin-sur-Seille	294	9	303
41	Lorraine	57	4	23	145	Coincy	306	4	310
41	Lorraine	57	4	23	148	Colligny	310	2	312
41	Lorraine	57	1	04	149	Colmen	216	5	221
41	Lorraine	57	1	03	150	Condé-Northen	611	14	625
41	Lorraine	57	2	06	151	Conthil	179	3	182
41	Lorraine	57	7	31	152	Contz-les-Bains	485	6	491
41	Lorraine	57	4	13	153	Corny-sur-Moselle	2224	37	2261
41	Lorraine	57	1	03	154	Coume	684	7	691
41	Lorraine	57	4	23	155	Courcelles-Chaussy	3041	207	3248
41	Lorraine	57	4	23	156	Courcelles-sur-Nied	973	20	993
41	Lorraine	57	2	07	158	Craincourt	266	2	268
41	Lorraine	57	1	09	159	Créhange	3999	55	4054
41	Lorraine	57	1	04	160	Creutzwald	13483	287	13770
41	Lorraine	57	2	08	161	Cutting	111	4	115
41	Lorraine	57	4	33	162	Cuvry	753	11	764
41	Lorraine	57	5	24	163	Dabo	2625	70	2695
41	Lorraine	57	1	04	165	Dalem	660	11	671
41	Lorraine	57	2	06	166	Dalhain	117	3	120
41	Lorraine	57	1	04	167	Dalstein	335	7	342
41	Lorraine	57	5	24	168	Danne-et-Quatre-Vents	598	14	612
41	Lorraine	57	5	24	169	Dannelbourg	489	16	505
41	Lorraine	57	2	07	171	Delme	989	16	1005
41	Lorraine	57	1	03	172	Denting	245	3	248
41	Lorraine	57	5	10	173	Desseling	107	3	110
41	Lorraine	57	3	14	174	Destry	90	3	93
41	Lorraine	57	5	29	175	Diane-Capelle	224	12	236
41	Lorraine	57	3	47	176	Diebling	1647	32	1679
41	Lorraine	57	3	27	765	Diesen	1092	29	1121
41	Lorraine	57	2	08	177	Dieuze	3780	281	4061
41	Lorraine	57	3	14	178	Diffembach-lès-Hellimer	375	5	380
41	Lorraine	57	7	21	179	Distroff	1613	30	1643
41	Lorraine	57	5	10	180	Dolving	377	9	386
41	Lorraine	57	2	08	181	Domnom-lès-Dieuze	96	4	100
41	Lorraine	57	2	07	182	Donjeux	97	3	100
41	Lorraine	57	2	34	183	Donnelay	201	12	213
41	Lorraine	57	4	13	184	Dornot	196	8	204
41	Lorraine	57	1	04	186	Ébersviller	865	13	878
41	Lorraine	57	1	03	187	Éblange	373	2	375
41	Lorraine	57	6	02	188	Éguelshardt	443	134	577
41	Lorraine	57	3	14	189	Eincheville	227	2	229
41	Lorraine	57	1	09	190	Elvange	368	7	375
41	Lorraine	57	7	21	191	Elzange	779	12	791
41	Lorraine	57	6	26	192	Enchenberg	1241	18	1259
41	Lorraine	57	4	35	193	Ennery	1715	27	1742
41	Lorraine	57	7	05	194	Entrange	1316	30	1346
41	Lorraine	57	6	36	195	Epping	578	7	585
41	Lorraine	57	6	36	196	Erching	431	4	435
41	Lorraine	57	6	28	197	Ernestviller	513	12	525
41	Lorraine	57	3	14	198	Erstroff	209	2	211
41	Lorraine	57	7	05	199	Escherange	609	9	618
41	Lorraine	57	4	35	200	Les Étangs	424	6	430
41	Lorraine	57	6	26	201	Etting	760	17	777
41	Lorraine	57	3	51	202	Etzling	1136	21	1157
41	Lorraine	57	7	05	203	Évrange	232	4	236
41	Lorraine	57	4	35	204	Failly	562	13	575
41	Lorraine	57	1	04	205	Falck	2559	47	2606
41	Lorraine	57	8	45	206	Fameck	12637	192	12829
41	Lorraine	57	3	41	207	Farébersviller	5741	51	5792
41	Lorraine	57	3	47	208	Farschviller	1513	20	1533
41	Lorraine	57	1	09	209	Faulquemont	5549	78	5627
41	Lorraine	57	5	10	210	Fénétrange	732	15	747
41	Lorraine	57	4	48	211	Fèves	915	10	925
41	Lorraine	57	4	33	212	Féy	596	19	615
41	Lorraine	57	1	04	213	Filstroff	869	13	882
41	Lorraine	57	7	05	214	Fixem	382	10	392
41	Lorraine	57	7	31	215	Flastroff	309	9	318
41	Lorraine	57	5	10	216	Fleisheim	126	0	126
41	Lorraine	57	1	09	217	Flétrange	901	17	918
41	Lorraine	57	4	33	218	Fleury	1034	29	1063
41	Lorraine	57	4	35	219	Flévy	570	7	577
41	Lorraine	57	4	23	220	Flocourt	124	2	126
41	Lorraine	57	8	39	221	Florange	11454	126	11580
41	Lorraine	57	3	47	222	Folkling	1358	52	1410
41	Lorraine	57	3	27	224	Folschviller	4217	70	4287
41	Lorraine	57	2	07	225	Fonteny	130	1	131
41	Lorraine	57	8	11	226	Fontoy	3100	50	3150
41	Lorraine	57	3	98	227	Forbach	21510	410	21920
41	Lorraine	57	2	07	228	Fossieux	160	0	160
41	Lorraine	57	5	25	229	Foulcrey	191	5	196
41	Lorraine	57	1	09	230	Fouligny	210	2	212
41	Lorraine	57	4	33	231	Foville	93	0	93
41	Lorraine	57	2	01	232	Francaltroff	758	19	777
41	Lorraine	57	5	16	233	Fraquelfing	86	0	86
41	Lorraine	57	6	50	234	Frauenberg	547	8	555
41	Lorraine	57	1	04	235	Freistroff	1083	23	1106
41	Lorraine	57	2	07	236	Frémery	63	2	65
41	Lorraine	57	3	14	237	Frémestroff	295	6	301
41	Lorraine	57	2	06	238	Fresnes-en-Saulnois	184	4	188
41	Lorraine	57	3	14	239	Freybouse	420	12	432
41	Lorraine	57	3	41	240	Freyming-Merlebach	13229	252	13481
41	Lorraine	57	5	25	241	Fribourg	170	1	171
41	Lorraine	57	8	22	242	Gandrange	2908	27	2935
41	Lorraine	57	5	24	244	Garrebourg	523	3	526
41	Lorraine	57	7	05	245	Gavisse	592	12	604
41	Lorraine	57	2	08	246	Gelucourt	236	6	242
41	Lorraine	57	2	06	247	Gerbécourt	110	4	114
41	Lorraine	57	2	01	248	Givrycourt	101	1	102
41	Lorraine	57	4	35	249	Glatigny	280	4	284
41	Lorraine	57	6	02	250	Goetzenbruck	1699	28	1727
41	Lorraine	57	4	33	251	Goin	333	3	336
41	Lorraine	57	1	03	252	Gomelange	559	10	569
41	Lorraine	57	5	25	253	Gondrexange	482	16	498
41	Lorraine	57	4	13	254	Gorze	1220	10	1230
41	Lorraine	57	5	10	255	Gosselming	618	14	632
41	Lorraine	57	4	13	256	Gravelotte	711	7	718
41	Lorraine	57	2	06	257	Grémecey	102	3	105
41	Lorraine	57	3	14	258	Gréning	142	3	145
41	Lorraine	57	7	31	259	Grindorff-Bizing	318	15	333
41	Lorraine	57	6	26	261	Gros-Réderching	1314	28	1342
41	Lorraine	57	6	50	260	Grosbliederstroff	3302	51	3353
41	Lorraine	57	3	14	262	Grostenquin	566	11	577
41	Lorraine	57	6	50	263	Grundviller	666	11	677
41	Lorraine	57	6	50	264	Guebenhouse	405	8	413
41	Lorraine	57	2	08	265	Guébestroff	65	0	65
41	Lorraine	57	2	08	266	Guéblange-lès-Dieuze	180	2	182
41	Lorraine	57	2	08	268	Guébling	140	3	143
41	Lorraine	57	7	21	269	Guénange	7127	93	7220
41	Lorraine	57	3	41	271	Guenviller	671	19	690
41	Lorraine	57	5	25	272	Guermange	92	6	98
41	Lorraine	57	1	04	273	Guerstling	422	4	426
41	Lorraine	57	1	03	274	Guerting	879	21	900
41	Lorraine	57	3	14	275	Guessling-Hémering	933	25	958
41	Lorraine	57	1	09	276	Guinglange	299	4	303
41	Lorraine	57	1	03	277	Guinkirchen	184	2	186
41	Lorraine	57	2	01	278	Guinzeling	76	1	77
41	Lorraine	57	5	24	280	Guntzviller	385	5	390
41	Lorraine	57	2	06	281	Haboudange	271	2	273
41	Lorraine	57	7	05	282	Hagen	254	6	260
41	Lorraine	57	4	43	283	Hagondange	9414	137	9551
41	Lorraine	57	1	09	284	Hallering	115	4	119
41	Lorraine	57	7	31	286	Halstroff	286	3	289
41	Lorraine	57	1	03	288	Ham-sous-Varsberg	2778	52	2830
41	Lorraine	57	6	50	289	Hambach	2736	55	2791
41	Lorraine	57	2	06	290	Hampont	201	9	210
41	Lorraine	57	1	09	293	Han-sur-Nied	241	4	245
41	Lorraine	57	5	24	291	Hangviller	281	3	284
41	Lorraine	57	2	07	292	Hannocourt	19	0	19
41	Lorraine	57	6	02	294	Hanviller	248	4	252
41	Lorraine	57	2	06	295	Haraucourt-sur-Seille	117	4	121
41	Lorraine	57	1	04	296	Hargarten-aux-Mines	1145	26	1171
41	Lorraine	57	3	14	297	Harprich	206	4	210
41	Lorraine	57	5	29	298	Harreberg	391	8	399
41	Lorraine	57	5	29	299	Hartzviller	918	18	936
41	Lorraine	57	5	24	300	Haselbourg	321	10	331
41	Lorraine	57	6	02	301	Haspelschiedt	277	7	284
41	Lorraine	57	5	16	302	Hattigny	211	4	215
41	Lorraine	57	4	43	303	Hauconcourt	542	7	549
41	Lorraine	57	5	29	304	Haut-Clocher	339	15	354
41	Lorraine	57	7	31	371	Haute-Kontz	528	8	536
41	Lorraine	57	1	09	714	Haute-Vigneulles	429	6	435
41	Lorraine	57	8	11	305	Havange	456	8	464
41	Lorraine	57	8	15	306	Hayange	15604	231	15835
41	Lorraine	57	4	35	307	Hayes	240	3	243
41	Lorraine	57	6	28	308	Hazembourg	112	2	114
41	Lorraine	57	1	04	309	Heining-lès-Bouzonville	489	2	491
41	Lorraine	57	5	10	310	Hellering-lès-Fénétrange	208	5	213
41	Lorraine	57	3	14	311	Hellimer	621	15	636
41	Lorraine	57	1	03	312	Helstroff	472	6	478
41	Lorraine	57	1	09	313	Hémilly	144	1	145
41	Lorraine	57	5	16	314	Héming	499	19	518
41	Lorraine	57	5	24	315	Henridorff	658	14	672
41	Lorraine	57	3	41	316	Henriville	719	17	736
41	Lorraine	57	5	24	317	Hérange	111	6	117
41	Lorraine	57	5	16	318	Hermelange	251	5	256
41	Lorraine	57	1	09	319	Herny	469	6	475
41	Lorraine	57	5	25	320	Hertzing	190	5	195
41	Lorraine	57	5	29	321	Hesse	603	22	625
41	Lorraine	57	1	04	322	Hestroff	440	4	444
41	Lorraine	57	7	05	323	Hettange-Grande	7489	162	7651
41	Lorraine	57	5	10	324	Hilbesheim	613	11	624
41	Lorraine	57	6	28	325	Hilsprich	903	16	919
41	Lorraine	57	1	03	326	Hinckange	304	3	307
41	Lorraine	57	1	09	328	Holacourt	68	2	70
41	Lorraine	57	1	03	329	Holling	445	5	450
41	Lorraine	57	6	28	330	Holving	1259	31	1290
41	Lorraine	57	7	21	331	Hombourg-Budange	511	10	521
41	Lorraine	57	3	49	332	Hombourg-Haut	7440	99	7539
41	Lorraine	57	5	29	333	Hommarting	875	13	888
41	Lorraine	57	5	29	334	Hommert	356	5	361
41	Lorraine	57	2	01	335	Honskirch	222	3	225
41	Lorraine	57	3	49	336	L; Hôpital	5434	77	5511
41	Lorraine	57	3	41	337	Hoste	651	16	667
41	Lorraine	57	6	36	338	Hottviller	595	14	609
41	Lorraine	57	5	24	339	Hultehouse	353	5	358
41	Lorraine	57	6	50	340	Hundling	1358	39	1397
41	Lorraine	57	7	31	341	Hunting	645	20	665
41	Lorraine	57	5	25	342	Ibigny	97	8	105
41	Lorraine	57	7	38	343	Illange	1979	47	2026
41	Lorraine	57	5	29	344	Imling	688	18	706
41	Lorraine	57	7	21	345	Inglange	397	42	439
41	Lorraine	57	2	01	346	Insming	606	21	627
41	Lorraine	57	2	01	347	Insviller	197	7	204
41	Lorraine	57	6	50	348	Ippling	785	23	808
41	Lorraine	57	2	07	349	Jallaucourt	162	0	162
41	Lorraine	57	4	13	350	Jouy-aux-Arches	1561	41	1602
41	Lorraine	57	4	33	351	Jury	1129	18	1147
41	Lorraine	57	4	13	352	Jussy	485	13	498
41	Lorraine	57	2	34	353	Juvelize	87	2	89
41	Lorraine	57	2	07	354	Juville	111	3	114
41	Lorraine	57	6	26	355	Kalhausen	853	9	862
41	Lorraine	57	7	05	356	Kanfen	1044	24	1068
41	Lorraine	57	6	28	357	Kappelkinger	399	7	406
41	Lorraine	57	7	21	358	Kédange-sur-Canner	1085	17	1102
41	Lorraine	57	7	21	359	Kemplich	158	3	161
41	Lorraine	57	3	51	360	Kerbach	1188	34	1222
41	Lorraine	57	7	31	361	Kerling-lès-Sierck	528	12	540
41	Lorraine	57	5	29	362	Kerprich-aux-Bois	141	3	144
41	Lorraine	57	7	31	364	Kirsch-lès-Sierck	297	9	306
41	Lorraine	57	7	31	365	Kirschnaumen	469	14	483
41	Lorraine	57	6	28	366	Kirviller	147	0	147
41	Lorraine	57	7	21	367	Klang	244	1	245
41	Lorraine	57	8	44	368	Knutange	3304	64	3368
41	Lorraine	57	7	21	370	Koenigsmacker	2080	30	2110
41	Lorraine	57	7	21	372	Kuntzig	1153	19	1172
41	Lorraine	57	3	49	373	Lachambre	793	20	813
41	Lorraine	57	5	16	374	Lafrimbolle	213	4	217
41	Lorraine	57	2	34	375	Lagarde	188	3	191
41	Lorraine	57	6	26	376	Lambach	547	11	558
41	Lorraine	57	5	16	377	Landange	248	3	251
41	Lorraine	57	3	14	379	Landroff	288	5	293
41	Lorraine	57	2	07	381	Laneuveville-en-Saulnois	274	5	279
41	Lorraine	57	5	16	380	Laneuveville-lès-Lorquin	97	1	98
41	Lorraine	57	5	29	382	Langatte	529	6	535
41	Lorraine	57	5	25	383	Languimberg	186	6	192
41	Lorraine	57	3	14	384	Laning	550	15	565
41	Lorraine	57	4	23	385	Laquenexy	1020	22	1042
41	Lorraine	57	1	09	386	Laudrefang	364	14	378
41	Lorraine	57	7	31	387	Laumesfeld	252	3	255
41	Lorraine	57	7	31	388	Launstroff	258	4	262
41	Lorraine	57	3	14	389	Lelling	503	11	514
41	Lorraine	57	6	02	390	Lemberg	1516	33	1549
41	Lorraine	57	2	07	391	Lemoncourt	74	3	77
41	Lorraine	57	4	23	392	Lemud	299	6	305
41	Lorraine	57	6	36	393	Lengelsheim	220	4	224
41	Lorraine	57	2	01	394	Léning	301	3	304
41	Lorraine	57	2	07	395	Lesse	192	1	193
41	Lorraine	57	4	13	396	Lessy	800	114	914
41	Lorraine	57	2	34	397	Ley	108	6	114
41	Lorraine	57	3	14	398	Leyviller	461	11	472
41	Lorraine	57	2	34	399	Lezey	102	3	105
41	Lorraine	57	2	01	410	Lhor	137	2	139
41	Lorraine	57	2	08	401	Lidrezing	88	0	88
41	Lorraine	57	6	02	402	Liederschiedt	133	4	137
41	Lorraine	57	4	33	403	Liéhon	107	4	111
41	Lorraine	57	2	08	404	Lindre-Basse	223	11	234
41	Lorraine	57	2	08	405	Lindre-Haute	57	5	62
41	Lorraine	57	2	07	406	Liocourt	144	2	146
41	Lorraine	57	5	24	407	Lixheim	585	10	595
41	Lorraine	57	6	50	408	Lixing-lès-Rouhling	930	25	955
41	Lorraine	57	3	14	409	Lixing-lès-Saint-Avold	733	21	754
41	Lorraine	57	8	11	411	Lommerange	285	7	292
41	Lorraine	57	4	37	412	Longeville-lès-Metz	3826	81	3907
41	Lorraine	57	1	09	413	Longeville-lès-Saint-Avold	3794	76	3870
41	Lorraine	57	5	16	414	Lorquin	1310	20	1330
41	Lorraine	57	4	37	415	Lorry-lès-Metz	1516	94	1610
41	Lorraine	57	4	33	416	Lorry-Mardigny	611	10	621
41	Lorraine	57	2	01	417	Lostroff	72	2	74
41	Lorraine	57	2	01	418	Loudrefing	302	4	306
41	Lorraine	57	6	50	419	Loupershouse	966	26	992
41	Lorraine	57	6	36	421	Loutzviller	159	1	160
41	Lorraine	57	4	33	422	Louvigny	822	7	829
41	Lorraine	57	2	06	423	Lubécourt	55	1	56
41	Lorraine	57	2	07	424	Lucy	207	0	207
41	Lorraine	57	4	23	425	Luppy	516	13	529
41	Lorraine	57	7	21	426	Luttange	905	20	925
41	Lorraine	57	5	24	427	Lutzelbourg	625	13	638
41	Lorraine	57	3	49	428	Macheren	2920	85	3005
41	Lorraine	57	1	09	430	Mainvillers	268	6	274
41	Lorraine	57	4	23	431	Maizeroy	339	4	343
41	Lorraine	57	4	23	432	Maizery	199	3	202
41	Lorraine	57	4	43	433	Maizières-lès-Metz	10710	132	10842
41	Lorraine	57	2	34	434	Maizières-lès-Vic	491	6	497
41	Lorraine	57	2	07	436	Malaucourt-sur-Seille	141	6	147
41	Lorraine	57	7	31	437	Malling	557	15	572
41	Lorraine	57	4	35	438	Malroy	386	11	397
41	Lorraine	57	7	31	439	Manderen	421	9	430
41	Lorraine	57	2	06	440	Manhoué	134	0	134
41	Lorraine	57	7	38	441	Manom	2642	81	2723
41	Lorraine	57	1	09	442	Many	261	3	264
41	Lorraine	57	4	48	443	Marange-Silvange	5842	83	5925
41	Lorraine	57	1	09	444	Marange-Zondrange	311	7	318
41	Lorraine	57	4	33	445	Marieulles	643	19	662
41	Lorraine	57	2	01	446	Marimont-lès-Bénestroff	46	0	46
41	Lorraine	57	4	33	447	Marly	9707	277	9984
41	Lorraine	57	2	34	448	Marsal	260	13	273
41	Lorraine	57	4	23	449	Marsilly	501	14	515
41	Lorraine	57	2	07	451	Marthille	184	5	189
41	Lorraine	57	4	37	452	La Maxe	859	11	870
41	Lorraine	57	3	14	453	Maxstadt	317	1	318
41	Lorraine	57	4	33	454	Mécleuves	1162	19	1181
41	Lorraine	57	1	03	455	Mégange	182	5	187
41	Lorraine	57	6	02	456	Meisenthal	716	16	732
41	Lorraine	57	1	04	457	Menskirch	155	3	158
41	Lorraine	57	7	31	459	Merschweiller	183	4	187
41	Lorraine	57	1	04	460	Merten	1529	24	1553
41	Lorraine	57	5	16	461	Métairies-Saint-Quirin	303	3	306
41	Lorraine	57	5	24	462	Metting	360	3	363
41	Lorraine	57	9	99	463	Metz	120738	2190	122928
41	Lorraine	57	7	21	464	Metzeresche	828	12	840
41	Lorraine	57	7	21	465	Metzervisse	1826	25	1851
41	Lorraine	57	3	47	466	Metzing	630	11	641
41	Lorraine	57	4	20	467	Mey	301	9	310
41	Lorraine	57	5	24	468	Mittelbronn	665	15	680
41	Lorraine	57	5	10	469	Mittersheim	603	13	616
41	Lorraine	57	2	01	470	Molring	9	0	9
41	Lorraine	57	1	03	471	Momerstroff	288	5	293
41	Lorraine	57	4	33	472	Moncheux	149	4	153
41	Lorraine	57	2	34	473	Moncourt	83	4	87
41	Lorraine	57	8	45	474	Mondelange	6009	56	6065
41	Lorraine	57	7	05	475	Mondorff	575	4	579
41	Lorraine	57	7	21	476	Monneren	391	4	395
41	Lorraine	57	6	26	477	Montbronn	1678	39	1717
41	Lorraine	57	2	01	478	Montdidier	64	6	70
41	Lorraine	57	7	31	479	Montenach	431	10	441
41	Lorraine	57	4	20	480	Montigny-lès-Metz	22540	509	23049
41	Lorraine	57	4	48	481	Montois-la-Montagne	2364	27	2391
41	Lorraine	57	4	23	482	Montoy-Flanville	1115	23	1138
41	Lorraine	57	3	14	483	Morhange	3772	165	3937
41	Lorraine	57	3	47	484	Morsbach	2581	44	2625
41	Lorraine	57	2	06	485	Morville-lès-Vic	127	3	130
41	Lorraine	57	2	07	486	Morville-sur-Nied	126	4	130
41	Lorraine	57	4	37	487	Moulins-lès-Metz	5110	93	5203
41	Lorraine	57	5	25	488	Moussey	647	9	656
41	Lorraine	57	6	02	489	Mouterhouse	289	5	294
41	Lorraine	57	2	34	490	Moyenvic	371	7	378
41	Lorraine	57	8	22	491	Moyeuvre-Grande	7939	99	8038
41	Lorraine	57	8	22	492	Moyeuvre-Petite	507	8	515
41	Lorraine	57	2	08	493	Mulcey	222	5	227
41	Lorraine	57	2	01	494	Munster	222	2	224
41	Lorraine	57	1	03	495	Narbéfontaine	137	2	139
41	Lorraine	57	2	01	496	Nébing	371	1	372
41	Lorraine	57	6	28	497	Nelling	289	1	290
41	Lorraine	57	8	44	498	Neufchef	2538	43	2581
41	Lorraine	57	6	50	499	Neufgrange	1433	28	1461
41	Lorraine	57	5	16	500	Neufmoulins	38	1	39
41	Lorraine	57	2	01	501	Neufvillage	38	0	38
41	Lorraine	57	1	04	502	Neunkirchen-lès-Bouzonville	338	6	344
41	Lorraine	57	5	16	504	Niderhoff	297	6	303
41	Lorraine	57	5	29	505	Niderviller	1173	20	1193
41	Lorraine	57	5	10	506	Niederstinzel	258	9	267
41	Lorraine	57	1	03	507	Niedervisse	244	7	251
41	Lorraine	57	8	44	508	Nilvange	4839	44	4883
41	Lorraine	57	5	16	509	Nitting	464	12	476
41	Lorraine	57	4	35	510	Noisseville	1017	20	1037
41	Lorraine	57	4	48	511	Norroy-le-Veneur	1068	37	1105
41	Lorraine	57	4	35	512	Nouilly	501	8	509
41	Lorraine	57	6	36	513	Nousseviller-lès-Bitche	150	5	155
41	Lorraine	57	3	47	514	Nousseviller-Saint-Nabor	1170	25	1195
41	Lorraine	57	4	13	515	Novéant-sur-Moselle	1961	25	1986
41	Lorraine	57	1	04	516	Oberdorff	361	18	379
41	Lorraine	57	6	36	517	Obergailbach	318	2	320
41	Lorraine	57	5	10	518	Oberstinzel	325	6	331
41	Lorraine	57	1	03	519	Obervisse	158	8	166
41	Lorraine	57	2	06	520	Obreck	52	2	54
41	Lorraine	57	3	47	521	OEting	2544	94	2638
41	Lorraine	57	4	23	523	Ogy	563	14	577
41	Lorraine	57	2	34	524	Ommeray	108	0	108
41	Lorraine	57	2	07	525	Oriocourt	61	1	62
41	Lorraine	57	6	36	526	Ormersviller	366	0	366
41	Lorraine	57	4	33	527	Orny	371	6	377
41	Lorraine	57	2	07	528	Oron	104	4	108
41	Lorraine	57	8	11	529	Ottange	2696	77	2773
41	Lorraine	57	1	03	530	Ottonville	409	11	420
41	Lorraine	57	7	21	531	Oudrenne	747	19	766
41	Lorraine	57	4	33	532	Pagny-lès-Goin	239	3	242
41	Lorraine	57	4	23	533	Pange	930	18	948
41	Lorraine	57	4	33	534	Peltre	1801	148	1949
41	Lorraine	57	6	26	535	Petit-Réderching	1495	43	1538
41	Lorraine	57	3	14	536	Petit-Tenquin	228	5	233
41	Lorraine	57	3	51	537	Petite-Rosselle	6593	92	6685
41	Lorraine	57	2	06	538	Pettoncourt	291	7	298
41	Lorraine	57	2	06	539	Pévange	52	0	52
41	Lorraine	57	5	24	540	Phalsbourg	4736	270	5006
41	Lorraine	57	6	02	541	Philippsbourg	596	6	602
41	Lorraine	57	1	03	542	Piblange	1012	14	1026
41	Lorraine	57	4	48	543	Pierrevillers	1495	27	1522
41	Lorraine	57	5	29	544	Plaine-de-Walsch	618	15	633
41	Lorraine	57	4	37	545	Plappeville	2135	94	2229
41	Lorraine	57	4	48	546	Plesnois	775	31	806
41	Lorraine	57	4	33	547	Pommérieux	698	12	710
41	Lorraine	57	4	33	548	Pontoy	413	4	417
41	Lorraine	57	1	09	549	Pontpierre	774	17	791
41	Lorraine	57	3	27	550	Porcelette	2570	78	2648
41	Lorraine	57	5	10	551	Postroff	208	3	211
41	Lorraine	57	4	33	552	Pouilly	673	12	685
41	Lorraine	57	4	33	553	Pournoy-la-Chétive	657	10	667
41	Lorraine	57	4	33	554	Pournoy-la-Grasse	580	25	605
41	Lorraine	57	2	07	555	Prévocourt	104	3	107
41	Lorraine	57	6	28	556	Puttelange-aux-Lacs	3147	44	3191
41	Lorraine	57	7	05	557	Puttelange-lès-Thionville	900	11	911
41	Lorraine	57	2	06	558	Puttigny	75	0	75
41	Lorraine	57	2	07	559	Puzieux	173	4	177
41	Lorraine	57	3	14	560	Racrange	633	17	650
41	Lorraine	57	6	26	561	Rahling	813	27	840
41	Lorraine	57	8	15	562	Ranguevaux	774	10	784
41	Lorraine	57	4	23	563	Raville	259	2	261
41	Lorraine	57	5	25	564	Réchicourt-le-Château	595	11	606
41	Lorraine	57	8	11	565	Rédange	984	8	992
41	Lorraine	57	5	29	566	Réding	2470	50	2520
41	Lorraine	57	1	04	567	Rémelfang	125	3	128
41	Lorraine	57	6	50	568	Rémelfing	1448	25	1473
41	Lorraine	57	7	31	569	Rémeling	315	4	319
41	Lorraine	57	1	04	570	Rémering	458	10	468
41	Lorraine	57	6	28	571	Rémering-lès-Puttelange	1135	21	1156
41	Lorraine	57	4	23	572	Rémilly	2121	121	2242
41	Lorraine	57	2	01	573	Réning	129	1	130
41	Lorraine	57	4	23	575	Retonfey	1339	33	1372
41	Lorraine	57	7	31	576	Rettel	740	57	797
41	Lorraine	57	6	02	577	Reyersviller	371	8	379
41	Lorraine	57	4	13	578	Rezonville	333	6	339
41	Lorraine	57	5	29	579	Rhodes	93	4	97
41	Lorraine	57	2	06	580	Riche	189	3	192
41	Lorraine	57	6	28	581	Richeling	356	7	363
41	Lorraine	57	8	45	582	Richemont	1894	71	1965
41	Lorraine	57	5	25	583	Richeval	136	3	139
41	Lorraine	57	6	36	584	Rimling	561	7	568
41	Lorraine	57	7	31	585	Ritzing	136	2	138
41	Lorraine	57	8	11	586	Rochonvillers	214	2	216
41	Lorraine	57	2	01	587	Rodalbe	204	0	204
41	Lorraine	57	7	05	588	Rodemack	1103	34	1137
41	Lorraine	57	6	26	589	Rohrbach-lès-Bitche	2126	68	2194
41	Lorraine	57	6	36	590	Rolbing	279	10	289
41	Lorraine	57	4	42	591	Rombas	9937	108	10045
41	Lorraine	57	5	10	592	Romelfing	365	8	373
41	Lorraine	57	4	48	593	Roncourt	834	13	847
41	Lorraine	57	6	02	594	Roppeviller	137	0	137
41	Lorraine	57	2	08	595	Rorbach-lès-Dieuze	58	2	60
41	Lorraine	57	3	47	596	Rosbruck	764	14	778
41	Lorraine	57	8	22	597	Rosselange	2897	34	2931
41	Lorraine	57	6	50	598	Rouhling	2035	48	2083
41	Lorraine	57	1	03	599	Roupeldange	378	6	384
41	Lorraine	57	7	05	600	Roussy-le-Village	1215	20	1235
41	Lorraine	57	4	13	601	Rozérieulles	1404	52	1456
41	Lorraine	57	7	21	602	Rurange-lès-Thionville	2211	48	2259
41	Lorraine	57	8	11	603	Russange	1074	18	1092
41	Lorraine	57	7	31	604	Rustroff	546	9	555
41	Lorraine	57	4	33	605	Sailly-Achâtel	225	2	227
41	Lorraine	57	3	96	606	Saint-Avold	16273	450	16723
41	Lorraine	57	2	07	609	Saint-Epvre	164	1	165
41	Lorraine	57	1	04	610	Saint-François-Lacroix	300	10	310
41	Lorraine	57	5	25	611	Saint-Georges	213	4	217
41	Lorraine	57	4	35	612	Saint-Hubert	214	2	216
41	Lorraine	57	5	10	613	Saint-Jean-de-Bassel	332	9	341
41	Lorraine	57	5	24	614	Saint-Jean-Kourtzerode	764	4	768
41	Lorraine	57	6	28	615	Saint-Jean-Rohrbach	1003	11	1014
41	Lorraine	57	4	20	616	Saint-Julien-lès-Metz	2991	76	3067
41	Lorraine	57	4	33	617	Saint-Jure	316	0	316
41	Lorraine	57	5	24	618	Saint-Louis	683	12	695
41	Lorraine	57	6	02	619	Saint-Louis-lès-Bitche	534	9	543
41	Lorraine	57	2	08	621	Saint-Médard	105	1	106
41	Lorraine	57	4	48	622	Saint-Privat-la-Montagne	1668	21	1689
41	Lorraine	57	5	16	623	Saint-Quirin	783	89	872
41	Lorraine	57	4	35	607	Sainte-Barbe	725	15	740
41	Lorraine	57	4	48	620	Sainte-Marie-aux-Chênes	3795	45	3840
41	Lorraine	57	4	13	624	Sainte-Ruffine	524	29	553
41	Lorraine	57	2	06	625	Salonnes	173	2	175
41	Lorraine	57	4	35	626	Sanry-lès-Vigy	525	9	534
41	Lorraine	57	4	23	627	Sanry-sur-Nied	321	5	326
41	Lorraine	57	6	28	628	Sarralbe	4547	76	4623
41	Lorraine	57	5	10	629	Sarraltroff	767	18	785
41	Lorraine	57	5	29	630	Sarrebourg	12565	321	12886
41	Lorraine	57	6	30	631	Sarreguemines	21540	554	22094
41	Lorraine	57	6	50	633	Sarreinsming	1294	25	1319
41	Lorraine	57	4	48	634	Saulny	1492	44	1536
41	Lorraine	57	5	10	635	Schalbach	301	2	303
41	Lorraine	57	6	26	636	Schmittviller	347	7	354
41	Lorraine	57	5	29	637	Schneckenbusch	301	8	309
41	Lorraine	57	3	51	638	Schoeneck	2794	53	2847
41	Lorraine	57	6	02	639	Schorbach	576	24	600
41	Lorraine	57	1	04	640	Schwerdorff	448	10	458
41	Lorraine	57	6	36	641	Schweyen	313	5	318
41	Lorraine	57	4	37	642	Scy-Chazelles	2726	79	2805
41	Lorraine	57	4	33	643	Secourt	209	1	210
41	Lorraine	57	3	41	644	Seingbouse	1907	40	1947
41	Lorraine	57	4	43	645	Semécourt	872	14	886
41	Lorraine	57	8	15	647	Serémange-Erzange	4177	73	4250
41	Lorraine	57	4	23	648	Servigny-lès-Raville	360	4	364
41	Lorraine	57	4	35	649	Servigny-lès-Sainte-Barbe	438	7	445
41	Lorraine	57	7	31	650	Sierck-les-Bains	1707	28	1735
41	Lorraine	57	6	26	651	Siersthal	632	15	647
41	Lorraine	57	4	33	652	Sillegny	449	9	458
41	Lorraine	57	4	33	653	Silly-en-Saulnois	38	2	40
41	Lorraine	57	4	23	654	Silly-sur-Nied	679	16	695
41	Lorraine	57	4	33	655	Solgne	1060	66	1126
41	Lorraine	57	4	23	656	Sorbey	326	10	336
41	Lorraine	57	2	06	657	Sotzeling	22	1	23
41	Lorraine	57	6	26	658	Soucht	1178	28	1206
41	Lorraine	57	3	51	659	Spicheren	3212	50	3262
41	Lorraine	57	3	51	660	Stiring-Wendel	12438	171	12609
41	Lorraine	57	7	21	767	Stuckange	1027	27	1054
41	Lorraine	57	6	02	661	Sturzelbronn	187	5	192
41	Lorraine	57	3	14	662	Suisse	103	9	112
41	Lorraine	57	4	43	663	Talange	7515	225	7740
41	Lorraine	57	2	08	664	Tarquimpol	68	2	70
41	Lorraine	57	3	47	665	Tenteling	1008	32	1040
41	Lorraine	57	7	38	666	Terville	6445	110	6555
41	Lorraine	57	1	03	667	Téterchen	729	8	737
41	Lorraine	57	1	09	668	Teting-sur-Nied	1379	30	1409
41	Lorraine	57	3	47	669	Théding	2452	39	2491
41	Lorraine	57	1	09	670	Thicourt	146	2	148
41	Lorraine	57	4	23	671	Thimonville	161	1	162
41	Lorraine	57	7	97	672	Thionville	41015	956	41971
41	Lorraine	57	1	09	673	Thonville	43	3	46
41	Lorraine	57	2	07	674	Tincry	181	13	194
41	Lorraine	57	2	01	675	Torcheville	134	1	135
41	Lorraine	57	4	23	676	Tragny	114	1	115
41	Lorraine	57	4	35	677	Trémery	1087	21	1108
41	Lorraine	57	8	11	678	Tressange	1970	39	2009
41	Lorraine	57	1	09	679	Tritteling-Redlach	511	12	523
41	Lorraine	57	5	29	680	Troisfontaines	1319	30	1349
41	Lorraine	57	1	04	681	Tromborn	346	7	353
41	Lorraine	57	5	16	682	Turquestein-Blancrupt	23	1	24
41	Lorraine	57	8	39	683	Uckange	6906	73	6979
41	Lorraine	57	3	14	684	Vahl-Ebersing	547	13	560
41	Lorraine	57	2	01	685	Vahl-lès-Bénestroff	126	5	131
41	Lorraine	57	1	09	686	Vahl-lès-Faulquemont	245	6	251
41	Lorraine	57	2	08	270	Val-de-Bride	626	17	643
41	Lorraine	57	6	28	267	Le Val-de-Guéblange	863	22	885
41	Lorraine	57	3	14	687	Vallerange	223	1	224
41	Lorraine	57	7	21	689	Valmestroff	253	6	259
41	Lorraine	57	3	27	690	Valmont	3333	77	3410
41	Lorraine	57	1	03	691	Valmunster	93	2	95
41	Lorraine	57	2	06	692	Vannecourt	88	3	91
41	Lorraine	57	4	20	693	Vantoux	923	30	953
41	Lorraine	57	4	20	694	Vany	332	7	339
41	Lorraine	57	1	03	695	Varize	519	3	522
41	Lorraine	57	1	03	696	Varsberg	952	22	974
41	Lorraine	57	5	16	697	Vasperviller	305	4	309
41	Lorraine	57	1	09	698	Vatimont	332	5	337
41	Lorraine	57	1	04	700	Vaudreching	574	9	583
41	Lorraine	57	4	13	701	Vaux	865	22	887
41	Lorraine	57	2	06	702	Vaxy	149	0	149
41	Lorraine	57	5	10	703	Veckersviller	275	4	279
41	Lorraine	57	7	21	704	Veckring	680	12	692
41	Lorraine	57	1	03	705	Velving	248	3	251
41	Lorraine	57	2	08	706	Vergaville	566	7	573
41	Lorraine	57	4	13	707	Vernéville	581	16	597
41	Lorraine	57	4	33	708	Verny	1931	105	2036
41	Lorraine	57	5	24	709	Vescheim	245	5	250
41	Lorraine	57	2	01	711	Vibersviller	451	3	454
41	Lorraine	57	2	34	712	Vic-sur-Seille	1344	113	1457
41	Lorraine	57	5	10	713	Vieux-Lixheim	255	3	258
41	Lorraine	57	4	33	715	Vigny	308	3	311
41	Lorraine	57	4	35	716	Vigy	1446	25	1471
41	Lorraine	57	3	14	717	Viller	191	2	193
41	Lorraine	57	4	23	718	Villers-Stoncourt	239	2	241
41	Lorraine	57	2	07	719	Villers-sur-Nied	84	0	84
41	Lorraine	57	1	04	720	Villing	497	8	505
41	Lorraine	57	5	24	721	Vilsberg	365	4	369
41	Lorraine	57	4	13	722	Vionville	175	3	178
41	Lorraine	57	2	01	723	Virming	265	7	272
41	Lorraine	57	8	22	724	Vitry-sur-Orne	2898	45	2943
41	Lorraine	57	2	01	725	Vittersbourg	338	7	345
41	Lorraine	57	1	09	726	Vittoncourt	393	3	396
41	Lorraine	57	2	07	727	Viviers	108	4	112
41	Lorraine	57	1	04	749	Voelfling-lès-Bouzonville	181	7	188
41	Lorraine	57	1	09	728	Voimhaut	266	0	266
41	Lorraine	57	1	03	730	Volmerange-lès-Boulay	573	7	580
41	Lorraine	57	7	05	731	Volmerange-les-Mines	1987	35	2022
41	Lorraine	57	6	36	732	Volmunster	864	24	888
41	Lorraine	57	7	21	733	Volstroff	1442	34	1476
41	Lorraine	57	5	16	734	Voyer	430	10	440
41	Lorraine	57	4	35	736	Vry	547	8	555
41	Lorraine	57	4	33	737	Vulmont	42	0	42
41	Lorraine	57	6	36	738	Waldhouse	391	10	401
41	Lorraine	57	7	31	739	Waldweistroff	462	12	474
41	Lorraine	57	7	31	740	Waldwisse	730	12	742
41	Lorraine	57	6	36	741	Walschbronn	524	17	541
41	Lorraine	57	5	29	742	Walscheid	1636	25	1661
41	Lorraine	57	5	24	743	Waltembourg	234	10	244
41	Lorraine	57	6	50	745	Wiesviller	1031	24	1055
41	Lorraine	57	6	28	746	Willerwald	1500	40	1540
41	Lorraine	57	5	24	747	Wintersbourg	253	5	258
41	Lorraine	57	6	50	748	Wittring	806	18	824
41	Lorraine	57	6	50	750	Woelfling-lès-Sarreguemines	691	10	701
41	Lorraine	57	4	37	751	Woippy	13046	157	13203
41	Lorraine	57	6	50	752	Woustviller	3258	63	3321
41	Lorraine	57	2	06	753	Wuisse	62	4	66
41	Lorraine	57	2	34	754	Xanrey	116	3	119
41	Lorraine	57	2	07	755	Xocourt	79	0	79
41	Lorraine	57	5	29	756	Xouaxange	342	10	352
41	Lorraine	57	7	38	757	Yutz	16171	304	16475
41	Lorraine	57	2	08	759	Zarbeling	67	0	67
41	Lorraine	57	6	50	760	Zetting	845	15	860
41	Lorraine	57	5	24	761	Zilling	270	2	272
41	Lorraine	57	1	03	762	Zimming	644	9	653
41	Lorraine	57	2	08	763	Zommange	36	3	39
41	Lorraine	57	7	05	764	Zoufftgen	872	8	880
26	Bourgogne	58	1	04	001	Achun	142	2	144
26	Bourgogne	58	4	07	002	Alligny-Cosne	876	19	895
26	Bourgogne	58	1	14	003	Alligny-en-Morvan	659	16	675
26	Bourgogne	58	1	04	004	Alluy	414	6	420
26	Bourgogne	58	2	24	005	Amazy	240	6	246
26	Bourgogne	58	3	21	006	Anlezy	284	4	288
26	Bourgogne	58	4	31	007	Annay	315	7	322
26	Bourgogne	58	2	06	008	Anthien	172	4	176
26	Bourgogne	58	4	19	009	Arbourse	117	3	120
26	Bourgogne	58	1	03	010	Arleuf	812	24	836
26	Bourgogne	58	2	05	011	Armes	288	10	298
26	Bourgogne	58	4	20	012	Arquian	603	14	617
26	Bourgogne	58	4	19	013	Arthel	94	1	95
26	Bourgogne	58	4	19	014	Arzembouy	76	0	76
26	Bourgogne	58	2	01	015	Asnan	127	7	134
26	Bourgogne	58	2	24	016	Asnois	157	5	162
26	Bourgogne	58	1	04	017	Aunay-en-Bazois	272	2	274
26	Bourgogne	58	2	01	018	Authiou	36	0	36
26	Bourgogne	58	1	13	019	Avrée	95	1	96
26	Bourgogne	58	3	08	020	Avril-sur-Loire	244	8	252
26	Bourgogne	58	3	22	021	Azy-le-Vif	228	5	233
26	Bourgogne	58	3	26	022	Balleray	197	10	207
26	Bourgogne	58	2	12	023	Bazoches	161	8	169
26	Bourgogne	58	1	04	024	Bazolles	289	6	295
26	Bourgogne	58	3	27	025	Béard	162	4	166
26	Bourgogne	58	2	01	026	Beaulieu	33	0	33
26	Bourgogne	58	4	02	027	Beaumont-la-Ferrière	133	3	136
26	Bourgogne	58	3	21	028	Beaumont-Sardolles	119	4	123
26	Bourgogne	58	2	01	029	Beuvron	105	3	108
26	Bourgogne	58	1	04	030	Biches	326	0	326
26	Bourgogne	58	3	21	031	Billy-Chevannes	358	6	364
26	Bourgogne	58	2	05	032	Billy-sur-Oisy	416	2	418
26	Bourgogne	58	4	20	033	Bitry	321	3	324
26	Bourgogne	58	1	03	034	Blismes	166	3	169
26	Bourgogne	58	3	23	035	Bona	307	8	315
26	Bourgogne	58	4	20	036	Bouhy	452	7	459
26	Bourgogne	58	2	12	037	Brassy	637	27	664
26	Bourgogne	58	2	05	038	Breugnon	171	6	177
26	Bourgogne	58	2	05	039	Brèves	296	4	300
26	Bourgogne	58	1	04	040	Brinay	161	2	163
26	Bourgogne	58	2	01	041	Brinon-sur-Beuvron	220	4	224
26	Bourgogne	58	4	18	042	Bulcy	146	5	151
26	Bourgogne	58	2	01	043	Bussy-la-Pesle	42	1	43
26	Bourgogne	58	4	31	044	La Celle-sur-Loire	844	28	872
26	Bourgogne	58	4	02	045	La Celle-sur-Nièvre	169	5	174
26	Bourgogne	58	1	11	046	Cercy-la-Tour	1952	39	1991
26	Bourgogne	58	2	06	047	Cervon	596	20	616
26	Bourgogne	58	4	09	048	Cessy-les-Bois	122	5	127
26	Bourgogne	58	2	12	049	Chalaux	73	0	73
26	Bourgogne	58	2	01	050	Challement	61	1	62
26	Bourgogne	58	3	30	051	Challuy	1607	135	1742
26	Bourgogne	58	2	01	052	Champallement	52	0	52
26	Bourgogne	58	4	19	053	Champlemy	343	3	346
26	Bourgogne	58	4	19	054	Champlin	39	1	40
26	Bourgogne	58	3	08	055	Champvert	818	13	831
26	Bourgogne	58	4	02	056	Champvoux	306	6	312
26	Bourgogne	58	3	22	057	Chantenay-Saint-Imbert	1281	21	1302
26	Bourgogne	58	2	25	058	La Chapelle-Saint-André	334	6	340
26	Bourgogne	58	4	02	059	La Charité-sur-Loire	5129	92	5221
26	Bourgogne	58	1	11	060	Charrin	618	9	627
26	Bourgogne	58	4	02	061	Chasnay	114	7	121
26	Bourgogne	58	1	03	063	Château-Chinon (Campagne)	608	11	619
26	Bourgogne	58	1	03	062	Château-Chinon (Ville)	2129	286	2415
26	Bourgogne	58	4	09	064	Châteauneuf-Val-de-Bargis	586	20	606
26	Bourgogne	58	1	04	065	Châtillon-en-Bazois	964	21	985
26	Bourgogne	58	1	03	066	Châtin	102	1	103
26	Bourgogne	58	4	02	067	Chaulgnes	1384	36	1420
26	Bourgogne	58	1	14	068	Chaumard	215	4	219
26	Bourgogne	58	2	06	069	Chaumot	175	8	183
26	Bourgogne	58	2	01	070	Chazeuil	59	3	62
26	Bourgogne	58	2	01	071	Chevannes-Changy	147	9	156
26	Bourgogne	58	3	32	072	Chevenon	608	16	624
26	Bourgogne	58	2	05	073	Chevroches	137	7	144
26	Bourgogne	58	1	13	074	Chiddes	328	15	343
26	Bourgogne	58	2	06	075	Chitry-les-Mines	233	4	237
26	Bourgogne	58	1	04	076	Chougny	86	2	88
26	Bourgogne	58	4	09	077	Ciez	376	7	383
26	Bourgogne	58	3	21	078	Cizely	61	0	61
26	Bourgogne	58	2	05	079	Clamecy	4248	336	4584
26	Bourgogne	58	2	06	080	La Collancelle	176	4	180
26	Bourgogne	58	4	09	081	Colméry	334	4	338
26	Bourgogne	58	1	03	082	Corancy	320	10	330
26	Bourgogne	58	2	06	083	Corbigny	1604	156	1760
26	Bourgogne	58	2	01	084	Corvol-d;Embernard	103	1	104
26	Bourgogne	58	2	25	085	Corvol-l;Orgueilleux	750	6	756
26	Bourgogne	58	4	98	086	Cosne-Cours-sur-Loire	10653	378	11031
26	Bourgogne	58	3	10	087	Cossaye	779	16	795
26	Bourgogne	58	3	28	088	Coulanges-lès-Nevers	3557	210	3767
26	Bourgogne	58	4	09	089	Couloutre	218	7	225
26	Bourgogne	58	2	25	090	Courcelles	212	5	217
26	Bourgogne	58	3	23	092	Crux-la-Ville	417	7	424
26	Bourgogne	58	2	25	093	Cuncy-lès-Varzy	146	5	151
26	Bourgogne	58	4	20	094	Dampierre-sous-Bouhy	487	6	493
26	Bourgogne	58	3	08	095	Decize	5777	186	5963
26	Bourgogne	58	3	08	096	Devay	488	9	497
26	Bourgogne	58	3	21	097	Diennes-Aubigny	113	1	114
26	Bourgogne	58	2	24	098	Dirol	130	3	133
26	Bourgogne	58	1	03	099	Dommartin	182	3	185
26	Bourgogne	58	2	01	100	Dompierre-sur-Héry	77	0	77
26	Bourgogne	58	4	19	101	Dompierre-sur-Nièvre	181	3	184
26	Bourgogne	58	4	09	102	Donzy	1624	38	1662
26	Bourgogne	58	2	05	103	Dornecy	547	18	565
26	Bourgogne	58	3	10	104	Dornes	1315	29	1344
26	Bourgogne	58	3	27	105	Druy-Parigny	348	4	352
26	Bourgogne	58	2	12	106	Dun-les-Places	354	15	369
26	Bourgogne	58	1	04	107	Dun-sur-Grandry	149	1	150
26	Bourgogne	58	2	12	108	Empury	93	1	94
26	Bourgogne	58	2	25	109	Entrains-sur-Nohain	907	20	927
26	Bourgogne	58	2	06	110	Epiry	214	7	221
26	Bourgogne	58	1	03	111	Fâchin	116	0	116
26	Bourgogne	58	3	21	112	La Fermeté	684	15	699
26	Bourgogne	58	3	21	113	Fertrève	126	3	129
26	Bourgogne	58	1	13	114	Fléty	123	2	125
26	Bourgogne	58	3	08	115	Fleury-sur-Loire	239	1	240
26	Bourgogne	58	2	24	116	Flez-Cuzy	123	1	124
26	Bourgogne	58	3	17	117	Fourchambault	4635	154	4789
26	Bourgogne	58	1	11	118	Fours	762	16	778
26	Bourgogne	58	3	21	119	Frasnay-Reugny	74	1	75
26	Bourgogne	58	2	06	120	Gâcogne	274	10	284
26	Bourgogne	58	3	17	121	Garchizy	3828	162	3990
26	Bourgogne	58	4	18	122	Garchy	423	24	447
26	Bourgogne	58	2	01	123	Germenay	139	4	143
26	Bourgogne	58	3	17	124	Germigny-sur-Loire	710	10	720
26	Bourgogne	58	1	14	125	Gien-sur-Cure	118	3	121
26	Bourgogne	58	3	32	126	Gimouille	471	17	488
26	Bourgogne	58	4	19	127	Giry	217	2	219
26	Bourgogne	58	1	03	128	Glux-en-Glenne	105	0	105
26	Bourgogne	58	1	14	129	Gouloux	195	1	196
26	Bourgogne	58	2	01	130	Grenois	112	4	116
26	Bourgogne	58	3	26	131	Guérigny	2566	44	2610
26	Bourgogne	58	2	01	132	Guipy	264	56	320
26	Bourgogne	58	2	01	133	Héry	65	0	65
26	Bourgogne	58	3	32	134	Imphy	3739	93	3832
26	Bourgogne	58	1	15	135	Isenay	122	2	124
26	Bourgogne	58	3	23	136	Jailly	68	4	72
26	Bourgogne	58	3	10	137	Lamenay-sur-Loire	63	2	65
26	Bourgogne	58	3	22	138	Langeron	397	3	400
26	Bourgogne	58	1	13	139	Lanty	125	1	126
26	Bourgogne	58	1	13	140	Larochemillay	287	6	293
26	Bourgogne	58	1	03	141	Lavault-de-Frétoy	73	0	73
26	Bourgogne	58	1	04	142	Limanton	245	4	249
26	Bourgogne	58	3	21	143	Limon	166	6	172
26	Bourgogne	58	3	22	144	Livry	689	10	699
26	Bourgogne	58	2	12	145	Lormes	1380	23	1403
26	Bourgogne	58	3	10	146	Lucenay-lès-Aix	1042	18	1060
26	Bourgogne	58	4	19	147	Lurcy-le-Bourg	301	7	308
26	Bourgogne	58	3	22	148	Luthenay-Uxeloup	597	19	616
26	Bourgogne	58	1	13	149	Luzy	2006	69	2075
26	Bourgogne	58	2	24	150	Lys	113	3	116
26	Bourgogne	58	3	27	151	La Machine	3527	59	3586
26	Bourgogne	58	3	32	152	Magny-Cours	1447	33	1480
26	Bourgogne	58	2	06	153	Magny-Lormes	73	3	76
26	Bourgogne	58	2	24	154	La Maison-Dieu	138	5	143
26	Bourgogne	58	4	02	155	La Marche	578	25	603
26	Bourgogne	58	2	25	156	Marcy	164	4	168
26	Bourgogne	58	2	12	157	Marigny-l;Église	325	5	330
26	Bourgogne	58	2	06	159	Marigny-sur-Yonne	210	7	217
26	Bourgogne	58	3	22	158	Mars-sur-Allier	283	5	288
26	Bourgogne	58	3	30	160	Marzy	3576	195	3771
26	Bourgogne	58	1	15	161	Maux	137	2	139
26	Bourgogne	58	4	09	162	Menestreau	126	2	128
26	Bourgogne	58	2	25	163	Menou	182	6	188
26	Bourgogne	58	4	18	164	Mesves-sur-Loire	664	36	700
26	Bourgogne	58	2	24	165	Metz-le-Comte	179	6	185
26	Bourgogne	58	2	06	166	Mhère	252	7	259
26	Bourgogne	58	2	01	167	Michaugues	63	0	63
26	Bourgogne	58	1	13	168	Millay	442	8	450
26	Bourgogne	58	2	24	169	Moissy-Moulinot	26	1	27
26	Bourgogne	58	2	24	170	Monceaux-le-Comte	159	9	168
26	Bourgogne	58	1	04	175	Mont-et-Marré	186	5	191
26	Bourgogne	58	1	11	172	Montambert	136	0	136
26	Bourgogne	58	3	23	171	Montapas	288	1	289
26	Bourgogne	58	1	15	173	Montaron	166	3	169
26	Bourgogne	58	4	19	174	Montenoison	126	1	127
26	Bourgogne	58	3	21	176	Montigny-aux-Amognes	543	16	559
26	Bourgogne	58	1	03	177	Montigny-en-Morvan	320	1	321
26	Bourgogne	58	1	04	178	Montigny-sur-Canne	166	4	170
26	Bourgogne	58	1	03	179	Montreuillon	295	7	302
26	Bourgogne	58	1	14	180	Montsauche-les-Settons	528	14	542
26	Bourgogne	58	2	01	181	Moraches	122	1	123
26	Bourgogne	58	1	15	182	Moulins-Engilbert	1607	19	1626
26	Bourgogne	58	2	06	183	Mouron-sur-Yonne	99	2	101
26	Bourgogne	58	4	19	184	Moussy	118	0	118
26	Bourgogne	58	1	14	185	Moux-en-Morvan	606	13	619
26	Bourgogne	58	4	02	186	Murlin	97	2	99
26	Bourgogne	58	4	31	187	Myennes	583	13	596
26	Bourgogne	58	4	02	188	Nannay	100	3	103
26	Bourgogne	58	4	02	189	Narcy	558	17	575
26	Bourgogne	58	2	24	190	Neuffontaines	122	2	124
26	Bourgogne	58	2	01	191	Neuilly	132	0	132
26	Bourgogne	58	3	10	192	Neuville-lès-Decize	274	6	280
26	Bourgogne	58	4	31	193	Neuvy-sur-Loire	1470	42	1512
26	Bourgogne	58	3	99	194	Nevers	36762	1590	38352
26	Bourgogne	58	1	11	195	La Nocle-Maulaix	297	2	299
26	Bourgogne	58	3	26	196	Nolay	368	2	370
26	Bourgogne	58	2	24	197	Nuars	146	11	157
26	Bourgogne	58	2	05	198	Oisy	339	13	352
26	Bourgogne	58	1	15	199	Onlay	160	5	165
26	Bourgogne	58	2	05	200	Ouagne	164	3	167
26	Bourgogne	58	2	25	201	Oudan	135	1	136
26	Bourgogne	58	1	04	202	Ougny	35	1	36
26	Bourgogne	58	4	19	203	Oulon	75	3	78
26	Bourgogne	58	3	26	204	Ourouër	350	6	356
26	Bourgogne	58	1	14	205	Ouroux-en-Morvan	654	16	670
26	Bourgogne	58	2	25	206	Parigny-la-Rose	37	2	39
26	Bourgogne	58	3	17	207	Parigny-les-Vaux	972	31	1003
26	Bourgogne	58	2	06	208	Pazy	326	8	334
26	Bourgogne	58	4	09	209	Perroy	199	6	205
26	Bourgogne	58	1	14	210	Planchez	356	4	360
26	Bourgogne	58	1	13	211	Poil	155	6	161
26	Bourgogne	58	3	26	212	Poiseux	332	6	338
26	Bourgogne	58	4	07	213	Pougny	483	12	495
26	Bourgogne	58	3	17	214	Pougues-les-Eaux	2459	68	2527
26	Bourgogne	58	4	18	215	Pouilly-sur-Loire	1732	58	1790
26	Bourgogne	58	2	12	216	Pouques-Lormes	163	3	166
26	Bourgogne	58	2	05	217	Pousseaux	221	9	230
26	Bourgogne	58	4	19	218	Prémery	2031	33	2064
26	Bourgogne	58	1	15	219	Préporché	210	4	214
26	Bourgogne	58	4	02	220	Raveau	684	14	698
26	Bourgogne	58	1	13	221	Rémilly	168	3	171
26	Bourgogne	58	2	05	222	Rix	200	0	200
26	Bourgogne	58	3	23	223	Rouy	621	17	638
26	Bourgogne	58	2	24	224	Ruages	115	8	123
26	Bourgogne	58	3	32	225	Saincaize-Meauce	432	5	437
26	Bourgogne	58	1	14	226	Saint-Agnan	159	3	162
26	Bourgogne	58	4	20	227	Saint-Amand-en-Puisaye	1297	23	1320
26	Bourgogne	58	4	18	228	Saint-Andelain	565	8	573
26	Bourgogne	58	2	12	229	Saint-André-en-Morvan	295	9	304
26	Bourgogne	58	2	24	230	Saint-Aubin-des-Chaumes	79	0	79
26	Bourgogne	58	4	02	231	Saint-Aubin-les-Forges	439	8	447
26	Bourgogne	58	3	21	232	Saint-Benin-d;Azy	1287	35	1322
26	Bourgogne	58	3	23	233	Saint-Benin-des-Bois	187	1	188
26	Bourgogne	58	4	19	234	Saint-Bonnot	130	0	130
26	Bourgogne	58	1	14	235	Saint-Brisson	279	3	282
26	Bourgogne	58	2	24	237	Saint-Didier	33	2	35
26	Bourgogne	58	3	29	238	Saint-Éloi	2137	120	2257
26	Bourgogne	58	3	21	239	Saint-Firmin	156	1	157
26	Bourgogne	58	3	23	240	Saint-Franchy	73	4	77
26	Bourgogne	58	3	08	241	Saint-Germain-Chassenay	355	2	357
26	Bourgogne	58	2	24	242	Saint-Germain-des-Bois	110	4	114
26	Bourgogne	58	1	11	243	Saint-Gratien-Savigny	117	8	125
26	Bourgogne	58	1	03	244	Saint-Hilaire-en-Morvan	214	9	223
26	Bourgogne	58	1	11	245	Saint-Hilaire-Fontaine	201	2	203
26	Bourgogne	58	1	15	246	Saint-Honoré-les-Bains	840	20	860
26	Bourgogne	58	3	21	247	Saint-Jean-aux-Amognes	474	12	486
26	Bourgogne	58	4	18	248	Saint-Laurent-l;Abbaye	240	4	244
26	Bourgogne	58	1	03	249	Saint-Léger-de-Fougeret	285	8	293
26	Bourgogne	58	3	27	250	Saint-Léger-des-Vignes	2034	36	2070
26	Bourgogne	58	4	07	251	Saint-Loup	463	11	474
26	Bourgogne	58	4	09	252	Saint-Malo-en-Donziois	133	3	136
26	Bourgogne	58	3	26	254	Saint-Martin-d;Heuille	595	21	616
26	Bourgogne	58	2	12	255	Saint-Martin-du-Puy	289	9	298
26	Bourgogne	58	4	18	256	Saint-Martin-sur-Nohain	395	13	408
26	Bourgogne	58	3	23	257	Saint-Maurice	58	5	63
26	Bourgogne	58	3	27	258	Saint-Ouen-sur-Loire	535	14	549
26	Bourgogne	58	3	10	259	Saint-Parize-en-Viry	171	2	173
26	Bourgogne	58	3	22	260	Saint-Parize-le-Châtel	1280	26	1306
26	Bourgogne	58	4	07	261	Saint-Père	1169	30	1199
26	Bourgogne	58	1	03	262	Saint-Péreuse	281	7	288
26	Bourgogne	58	2	25	263	Saint-Pierre-du-Mont	206	3	209
26	Bourgogne	58	3	22	264	Saint-Pierre-le-Moûtier	2010	34	2044
26	Bourgogne	58	4	18	265	Saint-Quentin-sur-Nohain	124	3	127
26	Bourgogne	58	2	01	266	Saint-Révérien	196	3	199
26	Bourgogne	58	3	23	267	Saint-Saulge	854	98	952
26	Bourgogne	58	1	11	268	Saint-Seine	237	4	241
26	Bourgogne	58	3	21	269	Saint-Sulpice	453	14	467
26	Bourgogne	58	4	20	270	Saint-Vérain	346	7	353
26	Bourgogne	58	4	09	236	Sainte-Colombe-des-Bois	130	1	131
26	Bourgogne	58	3	23	253	Sainte-Marie	95	2	97
26	Bourgogne	58	2	24	271	Saizy	213	2	215
26	Bourgogne	58	2	06	272	Sardy-lès-Épiry	145	2	147
26	Bourgogne	58	3	32	273	Sauvigny-les-Bois	1532	25	1557
26	Bourgogne	58	1	13	274	Savigny-Poil-Fol	136	3	139
26	Bourgogne	58	3	23	275	Saxi-Bourdon	301	1	302
26	Bourgogne	58	1	13	276	Sémelay	264	8	272
26	Bourgogne	58	1	15	277	Sermages	211	4	215
26	Bourgogne	58	3	30	278	Sermoise-sur-Loire	1635	73	1708
26	Bourgogne	58	4	19	279	Sichamps	176	1	177
26	Bourgogne	58	3	27	280	Sougy-sur-Loire	602	14	616
26	Bourgogne	58	4	18	281	Suilly-la-Tour	588	18	606
26	Bourgogne	58	2	05	282	Surgy	436	14	450
26	Bourgogne	58	2	01	283	Taconnay	70	1	71
26	Bourgogne	58	2	24	284	Talon	48	2	50
26	Bourgogne	58	1	04	285	Tamnay-en-Bazois	182	5	187
26	Bourgogne	58	2	24	286	Tannay	620	15	635
26	Bourgogne	58	1	13	287	Tazilly	250	3	253
26	Bourgogne	58	2	24	288	Teigny	110	5	115
26	Bourgogne	58	1	11	289	Ternant	211	3	214
26	Bourgogne	58	1	11	290	Thaix	64	4	68
26	Bourgogne	58	3	27	291	Thianges	176	12	188
26	Bourgogne	58	1	04	292	Tintury	197	0	197
26	Bourgogne	58	3	10	293	Toury-Lurcy	431	3	434
26	Bourgogne	58	3	10	294	Toury-sur-Jour	124	3	127
26	Bourgogne	58	4	18	295	Tracy-sur-Loire	960	23	983
26	Bourgogne	58	3	10	296	Tresnay	182	0	182
26	Bourgogne	58	3	21	297	Trois-Vèvres	234	4	238
26	Bourgogne	58	4	02	298	Tronsanges	370	10	380
26	Bourgogne	58	2	05	299	Trucy-l;Orgueilleux	236	7	243
26	Bourgogne	58	3	26	300	Urzy	1807	41	1848
26	Bourgogne	58	1	15	301	Vandenesse	340	9	349
26	Bourgogne	58	4	02	302	Varennes-lès-Narcy	883	19	902
26	Bourgogne	58	3	26	303	Varennes-Vauzelles	9623	268	9891
26	Bourgogne	58	2	25	304	Varzy	1314	200	1514
26	Bourgogne	58	2	06	305	Vauclaix	121	2	123
26	Bourgogne	58	3	08	306	Verneuil	323	7	330
26	Bourgogne	58	4	18	307	Vielmanay	189	7	196
26	Bourgogne	58	2	24	308	Vignol	76	8	84
26	Bourgogne	58	1	15	309	Villapourçon	453	6	459
26	Bourgogne	58	3	21	311	Ville-Langy	291	7	298
26	Bourgogne	58	2	25	310	Villiers-le-Sec	50	0	50
26	Bourgogne	58	2	05	312	Villiers-sur-Yonne	309	10	319
26	Bourgogne	58	2	01	313	Vitry-Laché	111	2	113
31	Nord-Pas-de-Calais	59	2	14	001	Abancourt	448	13	461
31	Nord-Pas-de-Calais	59	6	21	002	Abscon	4228	41	4269
31	Nord-Pas-de-Calais	59	1	59	003	Aibes	361	4	365
31	Nord-Pas-de-Calais	59	3	47	004	Aix	1101	18	1119
31	Nord-Pas-de-Calais	59	5	57	005	Allennes-les-Marais	3337	46	3383
31	Nord-Pas-de-Calais	59	1	08	006	Amfroipret	222	1	223
31	Nord-Pas-de-Calais	59	3	22	007	Anhiers	968	12	980
31	Nord-Pas-de-Calais	59	3	24	008	Aniche	10347	122	10469
31	Nord-Pas-de-Calais	59	2	43	010	Anneux	243	6	249
31	Nord-Pas-de-Calais	59	5	57	011	Annoeullin	9663	112	9775
31	Nord-Pas-de-Calais	59	1	64	012	Anor	3280	49	3329
31	Nord-Pas-de-Calais	59	5	33	013	Anstaing	1267	15	1282
31	Nord-Pas-de-Calais	59	6	71	014	Anzin	13412	227	13639
31	Nord-Pas-de-Calais	59	3	01	015	Arleux	2935	30	2965
31	Nord-Pas-de-Calais	59	4	09	016	Armbouts-Cappel	2497	51	2548
31	Nord-Pas-de-Calais	59	5	02	017	Armentières	25375	411	25786
31	Nord-Pas-de-Calais	59	4	16	018	Arnèke	1583	30	1613
31	Nord-Pas-de-Calais	59	6	67	019	Artres	1034	11	1045
31	Nord-Pas-de-Calais	59	1	44	021	Assevent	1757	19	1776
31	Nord-Pas-de-Calais	59	5	48	022	Attiches	2309	32	2341
31	Nord-Pas-de-Calais	59	2	14	023	Aubencheul-au-Bac	465	12	477
31	Nord-Pas-de-Calais	59	3	24	024	Auberchicourt	4573	34	4607
31	Nord-Pas-de-Calais	59	5	07	025	Aubers	1528	39	1567
31	Nord-Pas-de-Calais	59	3	01	026	Aubigny-au-Bac	1217	17	1234
31	Nord-Pas-de-Calais	59	6	66	027	Aubry-du-Hainaut	1468	21	1489
31	Nord-Pas-de-Calais	59	3	77	028	Auby	7535	46	7581
31	Nord-Pas-de-Calais	59	3	47	029	Auchy-lez-Orchies	1478	19	1497
31	Nord-Pas-de-Calais	59	1	08	031	Audignies	297	9	306
31	Nord-Pas-de-Calais	59	6	67	032	Aulnoy-lez-Valenciennes	7280	86	7366
31	Nord-Pas-de-Calais	59	1	10	033	Aulnoye-Aymeries	8642	206	8848
31	Nord-Pas-de-Calais	59	5	48	034	Avelin	2559	35	2594
31	Nord-Pas-de-Calais	59	1	04	035	Avesnelles	2505	46	2551
31	Nord-Pas-de-Calais	59	6	11	038	Avesnes-le-Sec	1358	13	1371
31	Nord-Pas-de-Calais	59	2	15	037	Avesnes-les-Aubert	3672	40	3712
31	Nord-Pas-de-Calais	59	1	86	036	Avesnes-sur-Helpe	4976	261	5237
31	Nord-Pas-de-Calais	59	2	13	039	Awoingt	693	16	709
31	Nord-Pas-de-Calais	59	1	10	041	Bachant	2398	31	2429
31	Nord-Pas-de-Calais	59	5	20	042	Bachy	1448	19	1467
31	Nord-Pas-de-Calais	59	4	87	043	Bailleul	14480	292	14772
31	Nord-Pas-de-Calais	59	5	33	044	Baisieux	4452	36	4488
31	Nord-Pas-de-Calais	59	1	64	045	Baives	157	0	157
31	Nord-Pas-de-Calais	59	4	31	046	Bambecque	729	18	747
31	Nord-Pas-de-Calais	59	2	43	047	Banteux	323	6	329
31	Nord-Pas-de-Calais	59	2	14	048	Bantigny	470	10	480
31	Nord-Pas-de-Calais	59	2	43	049	Bantouzelle	409	3	412
31	Nord-Pas-de-Calais	59	1	03	050	Bas-Lieu	313	12	325
31	Nord-Pas-de-Calais	59	5	07	051	La Bassée	6235	50	6285
31	Nord-Pas-de-Calais	59	5	57	052	Bauvin	5265	58	5323
31	Nord-Pas-de-Calais	59	1	08	053	Bavay	3516	87	3603
31	Nord-Pas-de-Calais	59	4	16	054	Bavinchove	921	27	948
31	Nord-Pas-de-Calais	59	2	17	055	Bazuel	566	6	572
31	Nord-Pas-de-Calais	59	5	74	056	Beaucamps-Ligny	889	34	923
31	Nord-Pas-de-Calais	59	1	49	057	Beaudignies	571	13	584
31	Nord-Pas-de-Calais	59	1	69	058	Beaufort	961	31	992
31	Nord-Pas-de-Calais	59	2	17	059	Beaumont-en-Cambrésis	466	3	469
31	Nord-Pas-de-Calais	59	2	58	060	Beaurain	228	2	230
31	Nord-Pas-de-Calais	59	1	04	061	Beaurepaire-sur-Sambre	255	6	261
31	Nord-Pas-de-Calais	59	1	59	062	Beaurieux	168	1	169
31	Nord-Pas-de-Calais	59	2	15	063	Beauvois-en-Cambrésis	2143	23	2166
31	Nord-Pas-de-Calais	59	6	66	064	Bellaing	1194	12	1206
31	Nord-Pas-de-Calais	59	1	08	065	Bellignies	894	13	907
31	Nord-Pas-de-Calais	59	1	59	066	Bérelles	165	3	168
31	Nord-Pas-de-Calais	59	4	09	067	Bergues	3886	102	3988
31	Nord-Pas-de-Calais	59	1	10	068	Berlaimont	3193	51	3244
31	Nord-Pas-de-Calais	59	2	58	069	Bermerain	651	9	660
31	Nord-Pas-de-Calais	59	1	08	070	Bermeries	404	12	416
31	Nord-Pas-de-Calais	59	5	48	071	Bersée	2262	30	2292
31	Nord-Pas-de-Calais	59	1	44	072	Bersillies	264	6	270
31	Nord-Pas-de-Calais	59	4	06	073	Berthen	506	10	516
31	Nord-Pas-de-Calais	59	2	18	074	Bertry	2210	33	2243
31	Nord-Pas-de-Calais	59	2	15	075	Béthencourt	749	8	757
31	Nord-Pas-de-Calais	59	1	44	076	Bettignies	262	5	267
31	Nord-Pas-de-Calais	59	1	08	077	Bettrechies	247	3	250
31	Nord-Pas-de-Calais	59	1	03	078	Beugnies	581	9	590
31	Nord-Pas-de-Calais	59	6	71	079	Beuvrages	6652	56	6708
31	Nord-Pas-de-Calais	59	3	47	080	Beuvry-la-Forêt	2737	41	2778
31	Nord-Pas-de-Calais	59	2	15	081	Bévillers	555	10	565
31	Nord-Pas-de-Calais	59	4	09	082	Bierne	1644	35	1679
31	Nord-Pas-de-Calais	59	4	09	083	Bissezeele	213	4	217
31	Nord-Pas-de-Calais	59	4	29	084	Blaringhem	2000	47	2047
31	Nord-Pas-de-Calais	59	2	14	085	Blécourt	360	11	371
31	Nord-Pas-de-Calais	59	4	60	086	Boeschepe	2197	44	2241
31	Nord-Pas-de-Calais	59	4	30	087	Boëseghem	712	12	724
31	Nord-Pas-de-Calais	59	5	02	088	Bois-Grenier	1521	36	1557
31	Nord-Pas-de-Calais	59	4	68	089	Bollezeele	1403	20	1423
31	Nord-Pas-de-Calais	59	5	70	090	Bondues	9930	200	10130
31	Nord-Pas-de-Calais	59	4	30	091	Borre	573	11	584
31	Nord-Pas-de-Calais	59	6	11	092	Bouchain	4053	49	4102
31	Nord-Pas-de-Calais	59	1	04	093	Boulogne-sur-Helpe	328	5	333
31	Nord-Pas-de-Calais	59	4	12	094	Bourbourg	6911	93	7004
31	Nord-Pas-de-Calais	59	5	20	096	Bourghelles	1563	27	1590
31	Nord-Pas-de-Calais	59	2	43	097	Boursies	339	5	344
31	Nord-Pas-de-Calais	59	5	61	098	Bousbecque	4702	50	4752
31	Nord-Pas-de-Calais	59	1	32	099	Bousies	1699	17	1716
31	Nord-Pas-de-Calais	59	6	56	100	Bousignies	315	6	321
31	Nord-Pas-de-Calais	59	1	59	101	Bousignies-sur-Roc	432	10	442
31	Nord-Pas-de-Calais	59	2	15	102	Boussières-en-Cambrésis	428	5	433
31	Nord-Pas-de-Calais	59	1	69	103	Boussières-sur-Sambre	523	5	528
31	Nord-Pas-de-Calais	59	1	45	104	Boussois	3259	25	3284
31	Nord-Pas-de-Calais	59	3	42	105	Bouvignies	1517	28	1545
31	Nord-Pas-de-Calais	59	5	20	106	Bouvines	709	21	730
31	Nord-Pas-de-Calais	59	4	25	107	Bray-Dunes	4666	61	4727
31	Nord-Pas-de-Calais	59	2	58	108	Briastre	720	4	724
31	Nord-Pas-de-Calais	59	6	56	109	Brillon	735	20	755
31	Nord-Pas-de-Calais	59	4	12	110	Brouckerque	1281	27	1308
31	Nord-Pas-de-Calais	59	4	68	111	Broxeele	304	9	313
31	Nord-Pas-de-Calais	59	6	71	112	Bruay-sur-l;Escaut	12276	137	12413
31	Nord-Pas-de-Calais	59	3	42	113	Bruille-lez-Marchiennes	1338	15	1353
31	Nord-Pas-de-Calais	59	6	55	114	Bruille-Saint-Amand	1614	23	1637
31	Nord-Pas-de-Calais	59	3	01	115	Brunémont	635	6	641
31	Nord-Pas-de-Calais	59	1	50	116	Bry	376	3	379
31	Nord-Pas-de-Calais	59	3	01	117	Bugnicourt	952	15	967
31	Nord-Pas-de-Calais	59	2	18	118	Busigny	2559	34	2593
31	Nord-Pas-de-Calais	59	4	16	119	Buysscheure	513	13	526
31	Nord-Pas-de-Calais	59	4	29	120	Caëstre	1812	34	1846
31	Nord-Pas-de-Calais	59	2	13	121	Cagnoncles	539	12	551
31	Nord-Pas-de-Calais	59	2	88	122	Cambrai	32584	761	33345
31	Nord-Pas-de-Calais	59	5	57	123	Camphin-en-Carembault	1636	25	1661
31	Nord-Pas-de-Calais	59	5	20	124	Camphin-en-Pévèle	1977	27	2004
31	Nord-Pas-de-Calais	59	2	43	125	Cantaing-sur-Escaut	423	18	441
31	Nord-Pas-de-Calais	59	3	01	126	Cantin	1450	17	1467
31	Nord-Pas-de-Calais	59	2	58	127	Capelle	161	2	163
31	Nord-Pas-de-Calais	59	5	02	128	Capinghem	1620	24	1644
31	Nord-Pas-de-Calais	59	4	12	130	Cappelle-Brouck	1148	20	1168
31	Nord-Pas-de-Calais	59	5	20	129	Cappelle-en-Pévèle	2119	31	2150
31	Nord-Pas-de-Calais	59	4	26	131	Cappelle-la-Grande	8173	89	8262
31	Nord-Pas-de-Calais	59	2	15	132	Carnières	1070	14	1084
31	Nord-Pas-de-Calais	59	5	57	133	Carnin	989	22	1011
31	Nord-Pas-de-Calais	59	1	04	134	Cartignies	1249	22	1271
31	Nord-Pas-de-Calais	59	4	16	135	Cassel	2287	99	2386
31	Nord-Pas-de-Calais	59	2	17	136	Le Cateau-Cambrésis	7039	146	7185
31	Nord-Pas-de-Calais	59	2	17	137	Catillon-sur-Sambre	837	8	845
31	Nord-Pas-de-Calais	59	2	15	138	Cattenières	676	15	691
31	Nord-Pas-de-Calais	59	2	18	139	Caudry	14393	239	14632
31	Nord-Pas-de-Calais	59	2	18	140	Caullery	466	11	477
31	Nord-Pas-de-Calais	59	2	13	141	Cauroir	572	8	580
31	Nord-Pas-de-Calais	59	1	45	142	Cerfontaine	586	18	604
31	Nord-Pas-de-Calais	59	5	02	143	La Chapelle-d;Armentières	8259	86	8345
31	Nord-Pas-de-Calais	59	6	55	144	Château-l;Abbaye	868	11	879
31	Nord-Pas-de-Calais	59	5	57	145	Chemy	645	10	655
31	Nord-Pas-de-Calais	59	5	33	146	Chéreng	3014	63	3077
31	Nord-Pas-de-Calais	59	1	59	147	Choisies	67	4	71
31	Nord-Pas-de-Calais	59	1	59	148	Clairfayts	368	7	375
31	Nord-Pas-de-Calais	59	2	18	149	Clary	1146	23	1169
31	Nord-Pas-de-Calais	59	5	20	150	Cobrieux	527	14	541
31	Nord-Pas-de-Calais	59	1	45	151	Colleret	1679	33	1712
31	Nord-Pas-de-Calais	59	5	51	152	Comines	12372	97	12469
31	Nord-Pas-de-Calais	59	6	19	153	Condé-sur-l;Escaut	9731	98	9829
31	Nord-Pas-de-Calais	59	4	72	155	Coudekerque-Branche	22474	444	22918
31	Nord-Pas-de-Calais	59	4	72	154	Coudekerque-Village	1167	58	1225
31	Nord-Pas-de-Calais	59	3	23	156	Courchelettes	2712	23	2735
31	Nord-Pas-de-Calais	59	1	59	157	Cousolre	2395	46	2441
31	Nord-Pas-de-Calais	59	3	47	158	Coutiches	2738	69	2807
31	Nord-Pas-de-Calais	59	4	27	159	Craywick	597	18	615
31	Nord-Pas-de-Calais	59	6	19	160	Crespin	4465	19	4484
31	Nord-Pas-de-Calais	59	2	43	161	Crèvecoeur-sur-l;Escaut	678	36	714
31	Nord-Pas-de-Calais	59	4	09	162	Crochte	713	16	729
31	Nord-Pas-de-Calais	59	5	54	163	Croix	20676	286	20962
31	Nord-Pas-de-Calais	59	1	32	164	Croix-Caluyau	245	2	247
31	Nord-Pas-de-Calais	59	3	23	165	Cuincy	6626	107	6733
31	Nord-Pas-de-Calais	59	6	65	166	Curgies	1091	18	1109
31	Nord-Pas-de-Calais	59	2	14	167	Cuvillers	201	5	206
31	Nord-Pas-de-Calais	59	5	20	168	Cysoing	4563	68	4631
31	Nord-Pas-de-Calais	59	1	45	169	Damousies	229	4	233
31	Nord-Pas-de-Calais	59	3	24	170	Dechy	5135	41	5176
31	Nord-Pas-de-Calais	59	2	18	171	Dehéries	43	0	43
31	Nord-Pas-de-Calais	59	6	21	172	Denain	20351	172	20523
31	Nord-Pas-de-Calais	59	5	51	173	Deûlémont	1690	21	1711
31	Nord-Pas-de-Calais	59	1	59	174	Dimechaux	351	5	356
31	Nord-Pas-de-Calais	59	1	59	175	Dimont	326	6	332
31	Nord-Pas-de-Calais	59	2	43	176	Doignies	296	6	302
31	Nord-Pas-de-Calais	59	1	03	177	Dompierre-sur-Helpe	925	11	936
31	Nord-Pas-de-Calais	59	5	57	670	Don	1365	14	1379
31	Nord-Pas-de-Calais	59	3	89	178	Douai	42197	1333	43530
31	Nord-Pas-de-Calais	59	6	21	179	Douchy-les-Mines	10425	61	10486
31	Nord-Pas-de-Calais	59	4	46	180	Le Doulieu	1402	41	1443
31	Nord-Pas-de-Calais	59	1	03	181	Dourlers	551	13	564
31	Nord-Pas-de-Calais	59	4	12	182	Drincham	259	3	262
31	Nord-Pas-de-Calais	59	4	90	183	Dunkerque	92005	1484	93489
31	Nord-Pas-de-Calais	59	4	29	184	Ebblinghem	657	8	665
31	Nord-Pas-de-Calais	59	3	24	185	Écaillon	2002	33	2035
31	Nord-Pas-de-Calais	59	1	59	186	Eccles	100	4	104
31	Nord-Pas-de-Calais	59	1	69	187	Éclaibes	280	8	288
31	Nord-Pas-de-Calais	59	1	10	188	Écuélin	111	2	113
31	Nord-Pas-de-Calais	59	4	60	189	Eecke	1166	17	1183
31	Nord-Pas-de-Calais	59	1	44	190	Élesmes	909	34	943
31	Nord-Pas-de-Calais	59	2	18	191	Élincourt	635	7	642
31	Nord-Pas-de-Calais	59	6	11	192	Émerchicourt	884	63	947
31	Nord-Pas-de-Calais	59	5	28	193	Emmerin	3199	34	3233
31	Nord-Pas-de-Calais	59	1	49	194	Englefontaine	1305	17	1322
31	Nord-Pas-de-Calais	59	5	74	195	Englos	563	5	568
31	Nord-Pas-de-Calais	59	5	74	196	Ennetières-en-Weppes	1190	11	1201
31	Nord-Pas-de-Calais	59	5	48	197	Ennevelin	2157	44	2201
31	Nord-Pas-de-Calais	59	1	64	198	Eppe-Sauvage	268	2	270
31	Nord-Pas-de-Calais	59	3	01	199	Erchin	766	14	780
31	Nord-Pas-de-Calais	59	4	09	200	Eringhem	470	8	478
31	Nord-Pas-de-Calais	59	5	74	201	Erquinghem-le-Sec	534	3	537
31	Nord-Pas-de-Calais	59	5	02	202	Erquinghem-Lys	4535	39	4574
31	Nord-Pas-de-Calais	59	3	42	203	Erre	1448	12	1460
31	Nord-Pas-de-Calais	59	2	58	204	Escarmain	434	6	440
31	Nord-Pas-de-Calais	59	6	21	205	Escaudain	9149	57	9206
31	Nord-Pas-de-Calais	59	2	13	206	Escaudoeuvres	3415	28	3443
31	Nord-Pas-de-Calais	59	6	19	207	Escautpont	4237	71	4308
31	Nord-Pas-de-Calais	59	5	74	208	Escobecques	307	8	315
31	Nord-Pas-de-Calais	59	2	18	209	Esnes	660	10	670
31	Nord-Pas-de-Calais	59	4	68	210	Esquelbecq	2145	51	2196
31	Nord-Pas-de-Calais	59	3	23	211	Esquerchin	884	12	896
31	Nord-Pas-de-Calais	59	4	46	212	Estaires	5992	151	6143
31	Nord-Pas-de-Calais	59	2	15	213	Estourmel	453	11	464
31	Nord-Pas-de-Calais	59	3	01	214	Estrées	967	28	995
31	Nord-Pas-de-Calais	59	6	65	215	Estreux	961	23	984
31	Nord-Pas-de-Calais	59	2	13	219	Estrun	673	8	681
31	Nord-Pas-de-Calais	59	2	13	216	Eswars	354	4	358
31	Nord-Pas-de-Calais	59	1	50	217	Eth	328	14	342
31	Nord-Pas-de-Calais	59	1	04	218	Étroeungt	1390	21	1411
31	Nord-Pas-de-Calais	59	5	40	220	Faches-Thumesnil	17407	174	17581
31	Nord-Pas-de-Calais	59	6	67	221	Famars	2519	66	2585
31	Nord-Pas-de-Calais	59	3	47	222	Faumont	2096	46	2142
31	Nord-Pas-de-Calais	59	1	32	223	Le Favril	481	7	488
31	Nord-Pas-de-Calais	59	3	01	224	Féchain	1849	24	1873
31	Nord-Pas-de-Calais	59	1	08	225	Feignies	7222	110	7332
31	Nord-Pas-de-Calais	59	1	03	226	Felleries	1606	25	1631
31	Nord-Pas-de-Calais	59	3	42	227	Fenain	5355	47	5402
31	Nord-Pas-de-Calais	59	3	24	228	Férin	1462	18	1480
31	Nord-Pas-de-Calais	59	1	64	229	Féron	548	8	556
31	Nord-Pas-de-Calais	59	1	45	230	Ferrière-la-Grande	5464	88	5552
31	Nord-Pas-de-Calais	59	1	45	231	Ferrière-la-Petite	1018	11	1029
31	Nord-Pas-de-Calais	59	1	08	232	La Flamengrie	423	9	432
31	Nord-Pas-de-Calais	59	1	03	233	Flaumont-Waudrechies	371	3	374
31	Nord-Pas-de-Calais	59	3	77	234	Flers-en-Escrebieux	5624	59	5683
31	Nord-Pas-de-Calais	59	2	43	236	Flesquières	276	5	281
31	Nord-Pas-de-Calais	59	4	06	237	Flêtre	923	17	940
31	Nord-Pas-de-Calais	59	6	55	238	Flines-lès-Mortagne	1645	14	1659
31	Nord-Pas-de-Calais	59	3	22	239	Flines-lez-Raches	5443	87	5530
31	Nord-Pas-de-Calais	59	1	03	240	Floursies	138	0	138
31	Nord-Pas-de-Calais	59	1	04	241	Floyon	513	6	519
31	Nord-Pas-de-Calais	59	1	32	242	Fontaine-au-Bois	661	5	666
31	Nord-Pas-de-Calais	59	2	15	243	Fontaine-au-Pire	1192	17	1209
31	Nord-Pas-de-Calais	59	2	14	244	Fontaine-Notre-Dame	1717	21	1738
31	Nord-Pas-de-Calais	59	1	32	246	Forest-en-Cambrésis	549	4	553
31	Nord-Pas-de-Calais	59	5	33	247	Forest-sur-Marque	1446	22	1468
31	Nord-Pas-de-Calais	59	1	64	249	Fourmies	12687	254	12941
31	Nord-Pas-de-Calais	59	5	07	250	Fournes-en-Weppes	2035	97	2132
31	Nord-Pas-de-Calais	59	1	50	251	Frasnoy	342	4	346
31	Nord-Pas-de-Calais	59	5	02	252	Frelinghien	2483	26	2509
31	Nord-Pas-de-Calais	59	6	19	253	Fresnes-sur-Escaut	7676	63	7739
31	Nord-Pas-de-Calais	59	3	01	254	Fressain	873	15	888
31	Nord-Pas-de-Calais	59	2	14	255	Fressies	559	10	569
31	Nord-Pas-de-Calais	59	5	48	256	Fretin	3309	27	3336
31	Nord-Pas-de-Calais	59	5	07	257	Fromelles	861	23	884
31	Nord-Pas-de-Calais	59	5	20	258	Genech	2605	450	3055
31	Nord-Pas-de-Calais	59	1	49	259	Ghissignies	483	6	489
31	Nord-Pas-de-Calais	59	4	31	260	Ghyvelde	3266	50	3316
31	Nord-Pas-de-Calais	59	1	64	261	Glageon	1833	16	1849
31	Nord-Pas-de-Calais	59	4	60	262	Godewaersvelde	2026	48	2074
31	Nord-Pas-de-Calais	59	3	01	263	Goeulzin	1057	29	1086
31	Nord-Pas-de-Calais	59	1	44	264	Gognies-Chaussée	789	13	802
31	Nord-Pas-de-Calais	59	1	50	265	Gommegnies	2265	39	2304
31	Nord-Pas-de-Calais	59	5	57	266	Gondecourt	3967	60	4027
31	Nord-Pas-de-Calais	59	2	43	267	Gonnelieu	329	1	330
31	Nord-Pas-de-Calais	59	4	46	268	La Gorgue	5956	63	6019
31	Nord-Pas-de-Calais	59	2	43	269	Gouzeaucourt	1432	18	1450
31	Nord-Pas-de-Calais	59	1	04	270	Grand-Fayt	515	7	522
31	Nord-Pas-de-Calais	59	4	27	272	Grand-Fort-Philippe	5434	72	5506
31	Nord-Pas-de-Calais	59	4	73	271	Grande-Synthe	20991	244	21235
31	Nord-Pas-de-Calais	59	4	27	273	Gravelines	11516	352	11868
31	Nord-Pas-de-Calais	59	2	17	274	La Groise	469	13	482
31	Nord-Pas-de-Calais	59	5	33	275	Gruson	1145	46	1191
31	Nord-Pas-de-Calais	59	3	24	276	Guesnain	4660	27	4687
31	Nord-Pas-de-Calais	59	1	08	277	Gussignies	350	10	360
31	Nord-Pas-de-Calais	59	5	74	278	Hallennes-lez-Haubourdin	3997	30	4027
31	Nord-Pas-de-Calais	59	5	61	279	Halluin	20199	171	20370
31	Nord-Pas-de-Calais	59	3	01	280	Hamel	780	9	789
31	Nord-Pas-de-Calais	59	5	07	281	Hantay	1046	15	1061
31	Nord-Pas-de-Calais	59	4	16	282	Hardifort	382	6	388
31	Nord-Pas-de-Calais	59	1	10	283	Hargnies	583	10	593
31	Nord-Pas-de-Calais	59	6	55	284	Hasnon	3721	30	3751
31	Nord-Pas-de-Calais	59	6	11	285	Haspres	2800	30	2830
31	Nord-Pas-de-Calais	59	5	28	286	Haubourdin	14455	114	14569
31	Nord-Pas-de-Calais	59	2	18	287	Haucourt-en-Cambrésis	209	6	215
31	Nord-Pas-de-Calais	59	6	67	288	Haulchin	2371	31	2402
31	Nord-Pas-de-Calais	59	2	58	289	Haussy	1550	86	1636
31	Nord-Pas-de-Calais	59	1	04	290	Haut-Lieu	389	4	393
31	Nord-Pas-de-Calais	59	1	69	291	Hautmont	14239	119	14358
31	Nord-Pas-de-Calais	59	6	21	292	Haveluy	3088	28	3116
31	Nord-Pas-de-Calais	59	4	46	293	Haverskerque	1472	18	1490
31	Nord-Pas-de-Calais	59	2	14	294	Haynecourt	594	7	601
31	Nord-Pas-de-Calais	59	4	91	295	Hazebrouck	21598	488	22086
31	Nord-Pas-de-Calais	59	1	49	296	Hecq	353	10	363
31	Nord-Pas-de-Calais	59	6	21	297	Hélesmes	1942	25	1967
31	Nord-Pas-de-Calais	59	5	33	299	Hem	17369	169	17538
31	Nord-Pas-de-Calais	59	2	14	300	Hem-Lenglet	580	9	589
31	Nord-Pas-de-Calais	59	6	19	301	Hergnies	4276	29	4305
31	Nord-Pas-de-Calais	59	6	67	302	Hérin	3840	29	3869
31	Nord-Pas-de-Calais	59	5	07	303	Herlies	2147	39	2186
31	Nord-Pas-de-Calais	59	5	57	304	Herrin	403	14	417
31	Nord-Pas-de-Calais	59	4	68	305	Herzeele	1518	43	1561
31	Nord-Pas-de-Calais	59	1	59	306	Hestrud	291	7	298
31	Nord-Pas-de-Calais	59	4	12	307	Holque	935	11	946
31	Nord-Pas-de-Calais	59	1	08	310	Hon-Hergies	830	13	843
31	Nord-Pas-de-Calais	59	4	29	308	Hondeghem	931	22	953
31	Nord-Pas-de-Calais	59	4	31	309	Hondschoote	4106	119	4225
31	Nord-Pas-de-Calais	59	2	17	311	Honnechy	528	6	534
31	Nord-Pas-de-Calais	59	2	43	312	Honnecourt-sur-Escaut	743	13	756
31	Nord-Pas-de-Calais	59	6	11	313	Hordain	1472	9	1481
31	Nord-Pas-de-Calais	59	3	42	314	Hornaing	3426	38	3464
31	Nord-Pas-de-Calais	59	1	08	315	Houdain-lez-Bavay	868	15	883
31	Nord-Pas-de-Calais	59	5	78	316	Houplin-Ancoisne	3431	50	3481
31	Nord-Pas-de-Calais	59	5	02	317	Houplines	7611	132	7743
31	Nord-Pas-de-Calais	59	4	60	318	Houtkerque	991	17	1008
31	Nord-Pas-de-Calais	59	4	09	319	Hoymille	3192	169	3361
31	Nord-Pas-de-Calais	59	5	07	320	Illies	1419	25	1444
31	Nord-Pas-de-Calais	59	2	17	321	Inchy	729	8	737
31	Nord-Pas-de-Calais	59	2	13	322	Iwuy	3200	40	3240
31	Nord-Pas-de-Calais	59	1	50	323	Jenlain	1054	23	1077
31	Nord-Pas-de-Calais	59	1	44	324	Jeumont	9772	163	9935
31	Nord-Pas-de-Calais	59	1	49	325	Jolimetz	890	24	914
31	Nord-Pas-de-Calais	59	4	31	326	Killem	964	26	990
31	Nord-Pas-de-Calais	59	3	22	327	Lallaing	6525	39	6564
31	Nord-Pas-de-Calais	59	5	38	328	Lambersart	28504	366	28870
31	Nord-Pas-de-Calais	59	3	23	329	Lambres-lez-Douai	5092	106	5198
31	Nord-Pas-de-Calais	59	3	47	330	Landas	2377	36	2413
31	Nord-Pas-de-Calais	59	1	32	331	Landrecies	3581	96	3677
31	Nord-Pas-de-Calais	59	5	33	332	Lannoy	1718	7	1725
31	Nord-Pas-de-Calais	59	1	04	333	Larouillies	271	5	276
31	Nord-Pas-de-Calais	59	3	23	334	Lauwin-Planque	1806	29	1835
31	Nord-Pas-de-Calais	59	6	56	335	Lecelles	2653	45	2698
31	Nord-Pas-de-Calais	59	3	01	336	Lécluse	1442	13	1455
31	Nord-Pas-de-Calais	59	4	68	337	Lederzeele	592	10	602
31	Nord-Pas-de-Calais	59	4	68	338	Ledringhem	673	22	695
31	Nord-Pas-de-Calais	59	5	33	339	Leers	9286	70	9356
31	Nord-Pas-de-Calais	59	4	25	340	Leffrinckoucke	4482	146	4628
31	Nord-Pas-de-Calais	59	2	43	341	Lesdain	408	9	417
31	Nord-Pas-de-Calais	59	5	78	343	Lesquin	6394	48	6442
31	Nord-Pas-de-Calais	59	1	10	344	Leval	2326	13	2339
31	Nord-Pas-de-Calais	59	3	24	345	Lewarde	2739	41	2780
31	Nord-Pas-de-Calais	59	1	59	342	Lez-Fontaine	215	5	220
31	Nord-Pas-de-Calais	59	5	40	346	Lezennes	3064	35	3099
31	Nord-Pas-de-Calais	59	1	59	347	Liessies	556	9	565
31	Nord-Pas-de-Calais	59	6	11	348	Lieu-Saint-Amand	1260	14	1274
31	Nord-Pas-de-Calais	59	2	18	349	Ligny-en-Cambrésis	1787	49	1836
31	Nord-Pas-de-Calais	59	5	92	350	Lille	227560	6498	234058
31	Nord-Pas-de-Calais	59	1	69	351	Limont-Fontaine	575	8	583
31	Nord-Pas-de-Calais	59	5	61	352	Linselles	8257	114	8371
31	Nord-Pas-de-Calais	59	1	49	353	Locquignol	346	4	350
31	Nord-Pas-de-Calais	59	3	24	354	Loffre	755	15	770
31	Nord-Pas-de-Calais	59	5	51	356	Lompret	2335	55	2390
31	Nord-Pas-de-Calais	59	1	08	357	La Longueville	2181	29	2210
31	Nord-Pas-de-Calais	59	4	12	358	Looberghe	1180	28	1208
31	Nord-Pas-de-Calais	59	4	27	359	Loon-Plage	6302	86	6388
31	Nord-Pas-de-Calais	59	5	28	360	Loos	21592	489	22081
31	Nord-Pas-de-Calais	59	6	11	361	Lourches	3908	25	3933
31	Nord-Pas-de-Calais	59	1	49	363	Louvignies-Quesnoy	955	9	964
31	Nord-Pas-de-Calais	59	5	20	364	Louvil	850	21	871
31	Nord-Pas-de-Calais	59	1	45	365	Louvroil	6830	64	6894
31	Nord-Pas-de-Calais	59	4	29	366	Lynde	691	10	701
31	Nord-Pas-de-Calais	59	5	33	367	Lys-lez-Lannoy	12950	117	13067
31	Nord-Pas-de-Calais	59	5	36	368	La Madeleine	22442	316	22758
31	Nord-Pas-de-Calais	59	6	67	369	Maing	3987	44	4031
31	Nord-Pas-de-Calais	59	1	44	370	Mairieux	774	18	792
31	Nord-Pas-de-Calais	59	5	74	371	Le Maisnil	609	24	633
31	Nord-Pas-de-Calais	59	2	18	372	Malincourt	508	7	515
31	Nord-Pas-de-Calais	59	1	04	374	Marbaix	472	11	483
31	Nord-Pas-de-Calais	59	3	42	375	Marchiennes	4742	70	4812
31	Nord-Pas-de-Calais	59	2	43	377	Marcoing	1830	35	1865
31	Nord-Pas-de-Calais	59	5	70	378	Marcq-en-Baroeul	38947	835	39782
31	Nord-Pas-de-Calais	59	3	01	379	Marcq-en-Ostrevent	585	11	596
31	Nord-Pas-de-Calais	59	1	50	381	Maresches	895	20	915
31	Nord-Pas-de-Calais	59	2	18	382	Maretz	1487	16	1503
31	Nord-Pas-de-Calais	59	6	65	383	Marly	11871	87	11958
31	Nord-Pas-de-Calais	59	1	32	384	Maroilles	1436	21	1457
31	Nord-Pas-de-Calais	59	1	44	385	Marpent	2669	36	2705
31	Nord-Pas-de-Calais	59	6	11	387	Marquette-en-Ostrevant	1676	16	1692
31	Nord-Pas-de-Calais	59	5	38	386	Marquette-lez-Lille	9797	80	9877
31	Nord-Pas-de-Calais	59	5	07	388	Marquillies	1992	25	2017
31	Nord-Pas-de-Calais	59	2	43	389	Masnières	2626	40	2666
31	Nord-Pas-de-Calais	59	3	24	390	Masny	4361	49	4410
31	Nord-Pas-de-Calais	59	6	11	391	Mastaing	909	17	926
31	Nord-Pas-de-Calais	59	1	93	392	Maubeuge	31046	389	31435
31	Nord-Pas-de-Calais	59	6	56	393	Maulde	957	11	968
31	Nord-Pas-de-Calais	59	2	17	394	Maurois	422	5	427
31	Nord-Pas-de-Calais	59	2	17	395	Mazinghien	321	4	325
31	Nord-Pas-de-Calais	59	1	08	396	Mecquignies	652	11	663
31	Nord-Pas-de-Calais	59	4	68	397	Merckeghem	574	9	583
31	Nord-Pas-de-Calais	59	5	48	398	Mérignies	2485	149	2634
31	Nord-Pas-de-Calais	59	4	06	399	Merris	1065	26	1091
31	Nord-Pas-de-Calais	59	4	46	400	Merville	8993	107	9100
31	Nord-Pas-de-Calais	59	4	06	401	Méteren	2146	35	2181
31	Nord-Pas-de-Calais	59	4	12	402	Millam	783	21	804
31	Nord-Pas-de-Calais	59	6	56	403	Millonfosse	664	6	670
31	Nord-Pas-de-Calais	59	4	31	404	Les Moëres	808	9	817
31	Nord-Pas-de-Calais	59	2	43	405	Moeuvres	447	7	454
31	Nord-Pas-de-Calais	59	1	10	406	Monceau-Saint-Waast	512	3	515
31	Nord-Pas-de-Calais	59	6	67	407	Monchaux-sur-Écaillon	551	13	564
31	Nord-Pas-de-Calais	59	5	48	408	Moncheaux	1448	34	1482
31	Nord-Pas-de-Calais	59	3	01	409	Monchecourt	2575	38	2613
31	Nord-Pas-de-Calais	59	5	37	410	Mons-en-Baroeul	21887	149	22036
31	Nord-Pas-de-Calais	59	5	48	411	Mons-en-Pévèle	2139	39	2178
31	Nord-Pas-de-Calais	59	2	17	412	Montay	350	4	354
31	Nord-Pas-de-Calais	59	2	18	413	Montigny-en-Cambrésis	585	8	593
31	Nord-Pas-de-Calais	59	3	24	414	Montigny-en-Ostrevent	4872	55	4927
31	Nord-Pas-de-Calais	59	2	58	415	Montrécourt	233	3	236
31	Nord-Pas-de-Calais	59	4	30	416	Morbecque	2658	57	2715
31	Nord-Pas-de-Calais	59	6	55	418	Mortagne-du-Nord	1621	16	1637
31	Nord-Pas-de-Calais	59	5	20	419	Mouchin	1368	26	1394
31	Nord-Pas-de-Calais	59	1	64	420	Moustier-en-Fagne	61	5	66
31	Nord-Pas-de-Calais	59	5	63	421	Mouvaux	13566	186	13752
31	Nord-Pas-de-Calais	59	2	13	422	Naves	605	11	616
31	Nord-Pas-de-Calais	59	4	46	423	Neuf-Berquin	1241	27	1268
31	Nord-Pas-de-Calais	59	1	69	424	Neuf-Mesnil	1254	15	1269
31	Nord-Pas-de-Calais	59	5	48	427	La Neuville	680	15	695
31	Nord-Pas-de-Calais	59	1	49	425	Neuville-en-Avesnois	291	11	302
31	Nord-Pas-de-Calais	59	5	62	426	Neuville-en-Ferrain	10132	91	10223
31	Nord-Pas-de-Calais	59	2	14	428	Neuville-Saint-Rémy	3744	49	3793
31	Nord-Pas-de-Calais	59	6	11	429	Neuville-sur-Escaut	2560	22	2582
31	Nord-Pas-de-Calais	59	2	17	430	Neuvilly	1049	5	1054
31	Nord-Pas-de-Calais	59	4	05	431	Nieppe	7587	88	7675
31	Nord-Pas-de-Calais	59	2	13	432	Niergnies	497	19	516
31	Nord-Pas-de-Calais	59	4	68	433	Nieurlet	980	9	989
31	Nord-Pas-de-Calais	59	6	56	434	Nivelle	1283	19	1302
31	Nord-Pas-de-Calais	59	3	47	435	Nomain	2464	41	2505
31	Nord-Pas-de-Calais	59	4	16	436	Noordpeene	788	12	800
31	Nord-Pas-de-Calais	59	5	78	437	Noyelles-lès-Seclin	879	17	896
31	Nord-Pas-de-Calais	59	2	43	438	Noyelles-sur-Escaut	766	17	783
31	Nord-Pas-de-Calais	59	1	10	439	Noyelles-sur-Sambre	314	7	321
31	Nord-Pas-de-Calais	59	6	11	440	Noyelles-sur-Selle	768	8	776
31	Nord-Pas-de-Calais	59	1	08	441	Obies	704	21	725
31	Nord-Pas-de-Calais	59	1	45	442	Obrechies	259	10	269
31	Nord-Pas-de-Calais	59	4	16	443	Ochtezeele	341	5	346
31	Nord-Pas-de-Calais	59	6	19	444	Odomez	898	10	908
31	Nord-Pas-de-Calais	59	1	64	445	Ohain	1292	20	1312
31	Nord-Pas-de-Calais	59	6	67	446	Oisy	564	8	572
31	Nord-Pas-de-Calais	59	6	65	447	Onnaing	8709	78	8787
31	Nord-Pas-de-Calais	59	4	31	448	Oost-Cappel	528	4	532
31	Nord-Pas-de-Calais	59	3	47	449	Orchies	8178	185	8363
31	Nord-Pas-de-Calais	59	2	17	450	Ors	653	18	671
31	Nord-Pas-de-Calais	59	1	50	451	Orsinval	524	8	532
31	Nord-Pas-de-Calais	59	5	48	452	Ostricourt	5225	45	5270
31	Nord-Pas-de-Calais	59	4	60	453	Oudezeele	668	11	679
31	Nord-Pas-de-Calais	59	4	16	454	Oxelaëre	510	9	519
31	Nord-Pas-de-Calais	59	2	14	455	Paillencourt	991	12	1003
31	Nord-Pas-de-Calais	59	3	42	456	Pecquencourt	6154	227	6381
31	Nord-Pas-de-Calais	59	5	51	457	Pérenchies	8104	58	8162
31	Nord-Pas-de-Calais	59	5	20	458	Péronne-en-Mélantois	871	9	880
31	Nord-Pas-de-Calais	59	1	04	461	Petit-Fayt	295	9	304
31	Nord-Pas-de-Calais	59	6	66	459	Petite-Forêt	4958	58	5016
31	Nord-Pas-de-Calais	59	5	48	462	Phalempin	4457	75	4532
31	Nord-Pas-de-Calais	59	4	09	463	Pitgam	918	28	946
31	Nord-Pas-de-Calais	59	1	49	464	Poix-du-Nord	2107	17	2124
31	Nord-Pas-de-Calais	59	2	17	465	Pommereuil	761	1	762
31	Nord-Pas-de-Calais	59	5	48	466	Pont-à-Marcq	2634	106	2740
31	Nord-Pas-de-Calais	59	1	10	467	Pont-sur-Sambre	2586	38	2624
31	Nord-Pas-de-Calais	59	1	49	468	Potelle	361	5	366
31	Nord-Pas-de-Calais	59	4	30	469	Pradelles	365	4	369
31	Nord-Pas-de-Calais	59	5	02	470	Prémesques	2164	17	2181
31	Nord-Pas-de-Calais	59	6	65	471	Préseau	1870	37	1907
31	Nord-Pas-de-Calais	59	1	32	472	Preux-au-Bois	837	4	841
31	Nord-Pas-de-Calais	59	1	50	473	Preux-au-Sart	289	2	291
31	Nord-Pas-de-Calais	59	1	32	474	Prisches	996	26	1022
31	Nord-Pas-de-Calais	59	6	67	475	Prouvy	2290	38	2328
31	Nord-Pas-de-Calais	59	2	14	476	Proville	3350	91	3441
31	Nord-Pas-de-Calais	59	5	57	477	Provin	4129	20	4149
31	Nord-Pas-de-Calais	59	4	09	478	Quaëdypre	1146	18	1164
31	Nord-Pas-de-Calais	59	6	65	479	Quarouble	3091	32	3123
31	Nord-Pas-de-Calais	59	6	67	480	Quérénaing	945	11	956
31	Nord-Pas-de-Calais	59	1	94	481	Le Quesnoy	4994	153	5147
31	Nord-Pas-de-Calais	59	5	51	482	Quesnoy-sur-Deûle	7126	90	7216
31	Nord-Pas-de-Calais	59	1	45	483	Quiévelon	154	4	158
31	Nord-Pas-de-Calais	59	6	65	484	Quiévrechain	5998	37	6035
31	Nord-Pas-de-Calais	59	2	15	485	Quiévy	1742	21	1763
31	Nord-Pas-de-Calais	59	3	77	486	Râches	2740	35	2775
31	Nord-Pas-de-Calais	59	5	74	487	Radinghem-en-Weppes	1343	34	1377
31	Nord-Pas-de-Calais	59	2	14	488	Raillencourt-Sainte-Olle	2358	42	2400
31	Nord-Pas-de-Calais	59	3	77	489	Raimbeaucourt	4126	53	4179
31	Nord-Pas-de-Calais	59	1	04	490	Rainsars	211	9	220
31	Nord-Pas-de-Calais	59	6	55	491	Raismes	12754	106	12860
31	Nord-Pas-de-Calais	59	2	13	492	Ramillies	588	12	600
31	Nord-Pas-de-Calais	59	1	03	493	Ramousies	241	0	241
31	Nord-Pas-de-Calais	59	1	49	494	Raucourt-au-Bois	176	1	177
31	Nord-Pas-de-Calais	59	1	45	495	Recquignies	2347	29	2376
31	Nord-Pas-de-Calais	59	2	17	496	Rejet-de-Beaulieu	246	2	248
31	Nord-Pas-de-Calais	59	4	29	497	Renescure	2071	40	2111
31	Nord-Pas-de-Calais	59	2	17	498	Reumont	379	1	380
31	Nord-Pas-de-Calais	59	4	31	499	Rexpoëde	1849	32	1881
31	Nord-Pas-de-Calais	59	2	43	500	Ribécourt-la-Tour	373	5	378
31	Nord-Pas-de-Calais	59	3	42	501	Rieulay	1382	28	1410
31	Nord-Pas-de-Calais	59	2	15	502	Rieux-en-Cambrésis	1524	16	1540
31	Nord-Pas-de-Calais	59	1	32	503	Robersart	186	6	192
31	Nord-Pas-de-Calais	59	6	11	504	Roeulx	3686	27	3713
31	Nord-Pas-de-Calais	59	6	65	505	Rombies-et-Marchipont	761	9	770
31	Nord-Pas-de-Calais	59	2	58	506	Romeries	435	1	436
31	Nord-Pas-de-Calais	59	5	40	507	Ronchin	18120	115	18235
31	Nord-Pas-de-Calais	59	5	61	508	Roncq	12848	168	13016
31	Nord-Pas-de-Calais	59	3	77	509	Roost-Warendin	6193	76	6269
31	Nord-Pas-de-Calais	59	6	56	511	Rosult	1863	30	1893
31	Nord-Pas-de-Calais	59	5	95	512	Roubaix	94713	793	95506
31	Nord-Pas-de-Calais	59	3	24	513	Roucourt	394	10	404
31	Nord-Pas-de-Calais	59	1	45	514	Rousies	4222	84	4306
31	Nord-Pas-de-Calais	59	6	67	515	Rouvignies	659	4	663
31	Nord-Pas-de-Calais	59	4	16	516	Rubrouck	940	19	959
31	Nord-Pas-de-Calais	59	2	43	517	Les Rues-des-Vignes	697	12	709
31	Nord-Pas-de-Calais	59	1	49	518	Ruesnes	440	7	447
31	Nord-Pas-de-Calais	59	6	56	519	Rumegies	1580	19	1599
31	Nord-Pas-de-Calais	59	2	43	520	Rumilly-en-Cambrésis	1449	10	1459
31	Nord-Pas-de-Calais	59	2	14	521	Sailly-lez-Cambrai	450	43	493
31	Nord-Pas-de-Calais	59	5	33	522	Sailly-lez-Lannoy	1776	38	1814
31	Nord-Pas-de-Calais	59	5	20	523	Sainghin-en-Mélantois	2493	53	2546
31	Nord-Pas-de-Calais	59	5	07	524	Sainghin-en-Weppes	5533	70	5603
31	Nord-Pas-de-Calais	59	1	04	525	Sains-du-Nord	3004	59	3063
31	Nord-Pas-de-Calais	59	6	96	526	Saint-Amand-les-Eaux	16697	197	16894
31	Nord-Pas-de-Calais	59	5	38	527	Saint-André-lez-Lille	11336	169	11505
31	Nord-Pas-de-Calais	59	2	15	528	Saint-Aubert	1520	13	1533
31	Nord-Pas-de-Calais	59	1	03	529	Saint-Aubin	374	14	388
31	Nord-Pas-de-Calais	59	6	19	530	Saint-Aybert	358	6	364
31	Nord-Pas-de-Calais	59	2	17	531	Saint-Benin	355	3	358
31	Nord-Pas-de-Calais	59	4	27	532	Saint-Georges-sur-l;Aa	308	11	319
31	Nord-Pas-de-Calais	59	2	15	533	Saint-Hilaire-lez-Cambrai	1643	20	1663
31	Nord-Pas-de-Calais	59	1	03	534	Saint-Hilaire-sur-Helpe	780	30	810
31	Nord-Pas-de-Calais	59	4	05	535	Saint-Jans-Cappel	1632	52	1684
31	Nord-Pas-de-Calais	59	2	58	537	Saint-Martin-sur-Écaillon	526	1	527
31	Nord-Pas-de-Calais	59	4	12	538	Saint-Momelin	412	8	420
31	Nord-Pas-de-Calais	59	4	12	539	Saint-Pierre-Brouck	984	14	998
31	Nord-Pas-de-Calais	59	2	58	541	Saint-Python	991	8	999
31	Nord-Pas-de-Calais	59	1	10	542	Saint-Remy-Chaussée	492	6	498
31	Nord-Pas-de-Calais	59	1	69	543	Saint-Remy-du-Nord	1193	8	1201
31	Nord-Pas-de-Calais	59	6	71	544	Saint-Saulve	10983	151	11134
31	Nord-Pas-de-Calais	59	2	17	545	Saint-Souplet	1290	13	1303
31	Nord-Pas-de-Calais	59	4	60	546	Saint-Sylvestre-Cappel	1105	25	1130
31	Nord-Pas-de-Calais	59	2	58	547	Saint-Vaast-en-Cambrésis	887	10	897
31	Nord-Pas-de-Calais	59	1	08	548	Saint-Waast	614	18	632
31	Nord-Pas-de-Calais	59	4	16	536	Sainte-Marie-Cappel	834	24	858
31	Nord-Pas-de-Calais	59	1	49	549	Salesches	315	2	317
31	Nord-Pas-de-Calais	59	5	07	550	Salomé	2981	11	2992
31	Nord-Pas-de-Calais	59	3	47	551	Saméon	1514	21	1535
31	Nord-Pas-de-Calais	59	2	14	552	Sancourt	201	2	203
31	Nord-Pas-de-Calais	59	5	28	553	Santes	5618	75	5693
31	Nord-Pas-de-Calais	59	6	56	554	Sars-et-Rosières	528	6	534
31	Nord-Pas-de-Calais	59	1	59	555	Sars-Poteries	1473	19	1492
31	Nord-Pas-de-Calais	59	1	10	556	Sassegnies	270	1	271
31	Nord-Pas-de-Calais	59	6	65	557	Saultain	2058	24	2082
31	Nord-Pas-de-Calais	59	2	58	558	Saulzoir	1701	17	1718
31	Nord-Pas-de-Calais	59	6	65	559	Sebourg	1890	40	1930
31	Nord-Pas-de-Calais	59	5	85	560	Seclin	12295	134	12429
31	Nord-Pas-de-Calais	59	1	03	562	Sémeries	540	12	552
31	Nord-Pas-de-Calais	59	1	03	563	Semousies	240	2	242
31	Nord-Pas-de-Calais	59	6	67	564	La Sentinelle	3322	86	3408
31	Nord-Pas-de-Calais	59	1	50	565	Sepmeries	587	5	592
31	Nord-Pas-de-Calais	59	5	74	566	Sequedin	4385	33	4418
31	Nord-Pas-de-Calais	59	2	13	567	Séranvillers-Forenville	330	4	334
31	Nord-Pas-de-Calais	59	4	29	568	Sercus	411	6	417
31	Nord-Pas-de-Calais	59	3	22	569	Sin-le-Noble	16257	106	16363
31	Nord-Pas-de-Calais	59	4	09	570	Socx	964	51	1015
31	Nord-Pas-de-Calais	59	2	58	571	Solesmes	4605	149	4754
31	Nord-Pas-de-Calais	59	1	59	572	Solre-le-Château	1801	41	1842
31	Nord-Pas-de-Calais	59	1	59	573	Solrinnes	125	2	127
31	Nord-Pas-de-Calais	59	3	42	574	Somain	12506	96	12602
31	Nord-Pas-de-Calais	59	2	58	575	Sommaing	338	12	350
31	Nord-Pas-de-Calais	59	4	12	576	Spycker	1594	18	1612
31	Nord-Pas-de-Calais	59	4	29	577	Staple	681	5	686
31	Nord-Pas-de-Calais	59	4	30	578	Steenbecque	1743	31	1774
31	Nord-Pas-de-Calais	59	4	09	579	Steene	1272	32	1304
31	Nord-Pas-de-Calais	59	4	60	580	Steenvoorde	4055	77	4132
31	Nord-Pas-de-Calais	59	4	05	581	Steenwerck	3471	60	3531
31	Nord-Pas-de-Calais	59	4	30	582	Strazeele	773	9	782
31	Nord-Pas-de-Calais	59	1	03	583	Taisnières-en-Thiérache	466	17	483
31	Nord-Pas-de-Calais	59	1	08	584	Taisnières-sur-Hon	926	14	940
31	Nord-Pas-de-Calais	59	5	78	585	Templemars	3158	41	3199
31	Nord-Pas-de-Calais	59	5	20	586	Templeuve	5786	91	5877
31	Nord-Pas-de-Calais	59	4	60	587	Terdeghem	554	10	564
31	Nord-Pas-de-Calais	59	4	25	588	Téteghem	7072	245	7317
31	Nord-Pas-de-Calais	59	6	67	589	Thiant	2560	40	2600
31	Nord-Pas-de-Calais	59	4	30	590	Thiennes	796	13	809
31	Nord-Pas-de-Calais	59	6	19	591	Thivencelle	820	5	825
31	Nord-Pas-de-Calais	59	5	48	592	Thumeries	3916	54	3970
31	Nord-Pas-de-Calais	59	2	13	593	Thun-l;Évêque	658	13	671
31	Nord-Pas-de-Calais	59	6	56	594	Thun-Saint-Amand	1136	18	1154
31	Nord-Pas-de-Calais	59	2	13	595	Thun-Saint-Martin	531	8	539
31	Nord-Pas-de-Calais	59	2	14	597	Tilloy-lez-Cambrai	589	14	603
31	Nord-Pas-de-Calais	59	3	42	596	Tilloy-lez-Marchiennes	556	8	564
31	Nord-Pas-de-Calais	59	5	33	598	Toufflers	3989	26	4015
31	Nord-Pas-de-Calais	59	5	97	599	Tourcoing	91923	697	92620
31	Nord-Pas-de-Calais	59	5	48	600	Tourmignies	687	10	697
31	Nord-Pas-de-Calais	59	1	64	601	Trélon	3090	111	3201
31	Nord-Pas-de-Calais	59	5	33	602	Tressin	1262	57	1319
31	Nord-Pas-de-Calais	59	6	67	603	Trith-Saint-Léger	6446	81	6527
31	Nord-Pas-de-Calais	59	2	17	604	Troisvilles	823	10	833
31	Nord-Pas-de-Calais	59	4	25	605	Uxem	1324	22	1346
31	Nord-Pas-de-Calais	59	6	98	606	Valenciennes	43335	1027	44362
31	Nord-Pas-de-Calais	59	1	49	607	Vendegies-au-Bois	493	5	498
31	Nord-Pas-de-Calais	59	2	58	608	Vendegies-sur-Écaillon	1121	13	1134
31	Nord-Pas-de-Calais	59	5	78	609	Vendeville	1634	17	1651
31	Nord-Pas-de-Calais	59	6	67	610	Verchain-Maugré	903	18	921
31	Nord-Pas-de-Calais	59	5	51	611	Verlinghem	2385	34	2419
31	Nord-Pas-de-Calais	59	2	58	612	Vertain	467	15	482
31	Nord-Pas-de-Calais	59	6	19	613	Vicq	1438	21	1459
31	Nord-Pas-de-Calais	59	2	58	614	Viesly	1458	9	1467
31	Nord-Pas-de-Calais	59	4	06	615	Vieux-Berquin	2504	37	2541
31	Nord-Pas-de-Calais	59	6	19	616	Vieux-Condé	10494	96	10590
31	Nord-Pas-de-Calais	59	1	10	617	Vieux-Mesnil	577	8	585
31	Nord-Pas-de-Calais	59	1	44	618	Vieux-Reng	853	17	870
31	Nord-Pas-de-Calais	59	5	84	009	Villeneuve-d;Ascq	63572	756	64328
31	Nord-Pas-de-Calais	59	1	50	619	Villereau	944	14	958
31	Nord-Pas-de-Calais	59	3	01	620	Villers-au-Tertre	608	13	621
31	Nord-Pas-de-Calais	59	2	15	622	Villers-en-Cauchies	1247	15	1262
31	Nord-Pas-de-Calais	59	2	43	623	Villers-Guislain	726	9	735
31	Nord-Pas-de-Calais	59	2	18	624	Villers-Outréaux	2182	57	2239
31	Nord-Pas-de-Calais	59	2	43	625	Villers-Plouich	414	8	422
31	Nord-Pas-de-Calais	59	1	50	626	Villers-Pol	1235	28	1263
31	Nord-Pas-de-Calais	59	1	44	627	Villers-Sire-Nicole	995	11	1006
31	Nord-Pas-de-Calais	59	4	68	628	Volckerinckhove	503	11	514
31	Nord-Pas-de-Calais	59	3	42	629	Vred	1348	19	1367
31	Nord-Pas-de-Calais	59	5	48	630	Wahagnies	2588	45	2633
31	Nord-Pas-de-Calais	59	2	18	631	Walincourt-Selvigny	2087	38	2125
31	Nord-Pas-de-Calais	59	6	66	632	Wallers	5577	35	5612
31	Nord-Pas-de-Calais	59	1	64	633	Wallers-en-Fagne	299	2	301
31	Nord-Pas-de-Calais	59	4	29	634	Wallon-Cappel	889	38	927
31	Nord-Pas-de-Calais	59	2	15	635	Wambaix	306	17	323
31	Nord-Pas-de-Calais	59	5	38	636	Wambrechies	9745	119	9864
31	Nord-Pas-de-Calais	59	3	42	637	Wandignies-Hamage	1254	12	1266
31	Nord-Pas-de-Calais	59	5	20	638	Wannehain	1031	8	1039
31	Nord-Pas-de-Calais	59	1	50	639	Wargnies-le-Grand	1067	10	1077
31	Nord-Pas-de-Calais	59	1	50	640	Wargnies-le-Petit	788	11	799
31	Nord-Pas-de-Calais	59	4	31	641	Warhem	2064	74	2138
31	Nord-Pas-de-Calais	59	3	42	642	Warlaing	566	7	573
31	Nord-Pas-de-Calais	59	5	51	643	Warneton	211	2	213
31	Nord-Pas-de-Calais	59	6	11	645	Wasnes-au-Bac	573	5	578
31	Nord-Pas-de-Calais	59	5	54	646	Wasquehal	20046	247	20293
31	Nord-Pas-de-Calais	59	4	12	647	Watten	2608	32	2640
31	Nord-Pas-de-Calais	59	5	78	648	Wattignies	13223	204	13427
31	Nord-Pas-de-Calais	59	1	45	649	Wattignies-la-Victoire	258	11	269
31	Nord-Pas-de-Calais	59	5	99	650	Wattrelos	41541	268	41809
31	Nord-Pas-de-Calais	59	6	21	651	Wavrechain-sous-Denain	1638	17	1655
31	Nord-Pas-de-Calais	59	6	11	652	Wavrechain-sous-Faulx	440	4	444
31	Nord-Pas-de-Calais	59	5	28	653	Wavrin	7641	67	7708
31	Nord-Pas-de-Calais	59	3	22	654	Waziers	7615	56	7671
31	Nord-Pas-de-Calais	59	4	16	655	Wemaers-Cappel	250	0	250
31	Nord-Pas-de-Calais	59	5	51	656	Wervicq-Sud	4696	67	4763
31	Nord-Pas-de-Calais	59	4	09	657	West-Cappel	586	12	598
31	Nord-Pas-de-Calais	59	5	07	658	Wicres	382	5	387
31	Nord-Pas-de-Calais	59	1	64	659	Wignehies	3099	47	3146
31	Nord-Pas-de-Calais	59	5	33	660	Willems	3015	27	3042
31	Nord-Pas-de-Calais	59	1	64	661	Willies	166	3	169
31	Nord-Pas-de-Calais	59	4	60	662	Winnezeele	1215	26	1241
31	Nord-Pas-de-Calais	59	4	68	663	Wormhout	5229	86	5315
31	Nord-Pas-de-Calais	59	4	12	664	Wulverdinghe	287	4	291
31	Nord-Pas-de-Calais	59	4	09	665	Wylder	320	5	325
31	Nord-Pas-de-Calais	59	4	68	666	Zegerscappel	1464	20	1484
31	Nord-Pas-de-Calais	59	4	16	667	Zermezeele	194	2	196
31	Nord-Pas-de-Calais	59	4	25	668	Zuydcoote	1669	71	1740
31	Nord-Pas-de-Calais	59	4	16	669	Zuytpeene	557	18	575
22	Picardie	60	1	15	001	Abancourt	646	13	659
22	Picardie	60	1	28	002	Abbecourt	775	13	788
22	Picardie	60	2	16	003	Abbeville-Saint-Lucien	529	11	540
22	Picardie	60	1	22	004	Achy	347	3	350
22	Picardie	60	4	05	005	Acy-en-Multien	782	13	795
22	Picardie	60	2	20	006	Les Ageux	1129	20	1149
22	Picardie	60	2	08	007	Agnetz	2960	151	3111
22	Picardie	60	2	08	008	Airion	489	97	586
22	Picardie	60	1	04	009	Allonne	1572	57	1629
22	Picardie	60	1	23	010	Amblainville	1730	20	1750
22	Picardie	60	3	19	011	Amy	369	13	382
22	Picardie	60	1	23	012	Andeville	3186	33	3219
22	Picardie	60	2	20	013	Angicourt	1588	27	1615
22	Picardie	60	2	33	014	Angivillers	183	4	187
22	Picardie	60	2	24	015	Angy	1195	13	1208
22	Picardie	60	2	24	016	Ansacq	272	7	279
22	Picardie	60	2	06	017	Ansauvillers	1217	25	1242
22	Picardie	60	1	23	018	Anserville	450	11	461
22	Picardie	60	3	31	019	Antheuil-Portes	420	12	432
22	Picardie	60	4	05	020	Antilly	319	11	330
22	Picardie	60	3	29	021	Appilly	506	15	521
22	Picardie	60	4	36	022	Apremont	713	26	739
22	Picardie	60	3	41	023	Armancourt	558	15	573
22	Picardie	60	3	14	024	Arsy	778	29	807
22	Picardie	60	3	01	025	Attichy	1931	18	1949
22	Picardie	60	1	13	026	Auchy-la-Montagne	500	3	503
22	Picardie	60	4	12	027	Auger-Saint-Vincent	511	7	518
22	Picardie	60	4	34	028	Aumont-en-Halatte	537	31	568
22	Picardie	60	1	02	029	Auneuil	2797	53	2850
22	Picardie	60	1	02	030	Auteuil	591	9	600
22	Picardie	60	4	05	031	Autheuil-en-Valois	284	3	287
22	Picardie	60	3	01	032	Autrêches	745	12	757
22	Picardie	60	4	34	033	Avilly-Saint-Léonard	983	33	1016
22	Picardie	60	2	08	034	Avrechy	1112	16	1128
22	Picardie	60	3	19	035	Avricourt	264	6	270
22	Picardie	60	2	08	036	Avrigny	350	4	354
22	Picardie	60	3	29	037	Baboeuf	520	9	529
22	Picardie	60	1	07	038	Bachivillers	432	6	438
22	Picardie	60	2	06	039	Bacouël	466	9	475
22	Picardie	60	2	08	040	Bailleul-le-Soc	660	4	664
22	Picardie	60	1	27	041	Bailleul-sur-Thérain	2097	36	2133
22	Picardie	60	2	20	042	Bailleval	1476	32	1508
22	Picardie	60	3	32	043	Bailly	670	11	681
22	Picardie	60	4	26	044	Balagny-sur-Thérain	1383	22	1405
22	Picardie	60	4	34	045	Barbery	538	19	557
22	Picardie	60	4	05	046	Bargny	287	1	288
22	Picardie	60	4	25	047	Baron	784	17	801
22	Picardie	60	3	31	048	Baugy	301	5	306
22	Picardie	60	1	35	049	Bazancourt	129	6	135
22	Picardie	60	2	20	050	Bazicourt	332	7	339
22	Picardie	60	1	17	051	Beaudéduit	189	6	195
22	Picardie	60	3	18	052	Beaugies-sous-Bois	86	0	86
22	Picardie	60	3	19	053	Beaulieu-les-Fontaines	590	54	644
22	Picardie	60	1	02	054	Beaumont-les-Nonains	361	5	366
22	Picardie	60	3	29	055	Beaurains-lès-Noyon	287	5	292
22	Picardie	60	4	30	056	Beaurepaire	56	1	57
22	Picardie	60	1	99	057	Beauvais	54711	1470	56181
22	Picardie	60	2	06	058	Beauvoir	292	2	294
22	Picardie	60	3	29	059	Béhéricourt	218	1	219
22	Picardie	60	4	26	060	Belle-Église	585	13	598
22	Picardie	60	3	31	061	Belloy	86	1	87
22	Picardie	60	3	18	062	Berlancourt	334	4	338
22	Picardie	60	1	02	063	Berneuil-en-Bray	789	34	823
22	Picardie	60	3	01	064	Berneuil-sur-Aisne	1019	14	1033
22	Picardie	60	1	28	065	Berthecourt	1601	26	1627
22	Picardie	60	4	12	066	Béthancourt-en-Valois	243	13	256
22	Picardie	60	4	12	067	Béthisy-Saint-Martin	1083	27	1110
22	Picardie	60	4	12	068	Béthisy-Saint-Pierre	3287	42	3329
22	Picardie	60	4	05	069	Betz	1076	24	1100
22	Picardie	60	3	09	070	Bienville	454	48	502
22	Picardie	60	3	31	071	Biermont	170	5	175
22	Picardie	60	3	01	072	Bitry	294	3	297
22	Picardie	60	1	10	073	Blacourt	528	8	536
22	Picardie	60	4	39	074	Blaincourt-lès-Précy	1195	19	1214
22	Picardie	60	1	13	075	Blancfossé	132	2	134
22	Picardie	60	1	15	076	Blargies	499	5	504
22	Picardie	60	1	22	077	Blicourt	312	6	318
22	Picardie	60	2	08	078	Blincourt	123	0	123
22	Picardie	60	4	25	079	Boissy-Fresnoy	936	10	946
22	Picardie	60	1	07	080	Boissy-le-Bois	192	4	196
22	Picardie	60	1	27	081	Bonlier	400	3	403
22	Picardie	60	4	12	083	Bonneuil-en-Valois	1058	14	1072
22	Picardie	60	2	06	082	Bonneuil-les-Eaux	817	8	825
22	Picardie	60	1	22	084	Bonnières	155	7	162
22	Picardie	60	2	06	085	Bonvillers	213	7	220
22	Picardie	60	4	26	086	Boran-sur-Oise	2099	52	2151
22	Picardie	60	4	25	087	Borest	352	19	371
22	Picardie	60	1	23	088	Bornel	3588	42	3630
22	Picardie	60	1	07	089	Boubiers	410	12	422
22	Picardie	60	1	07	090	Bouconvillers	369	2	371
22	Picardie	60	4	05	091	Bouillancy	379	10	389
22	Picardie	60	4	05	092	Boullarre	224	7	231
22	Picardie	60	3	31	093	Boulogne-la-Grasse	470	5	475
22	Picardie	60	4	05	094	Boursonne	289	6	295
22	Picardie	60	1	07	095	Boury-en-Vexin	341	8	349
22	Picardie	60	1	15	096	Boutavent	80	2	82
22	Picardie	60	1	07	097	Boutencourt	246	6	252
22	Picardie	60	1	15	098	Bouvresse	176	8	184
22	Picardie	60	3	31	099	Braisnes	168	8	176
22	Picardie	60	4	30	100	Brasseuse	100	2	102
22	Picardie	60	4	05	101	Brégy	595	11	606
22	Picardie	60	2	20	102	Brenouille	2132	53	2185
22	Picardie	60	1	27	103	Bresles	4260	69	4329
22	Picardie	60	2	06	104	Breteuil	4353	103	4456
22	Picardie	60	3	29	105	Brétigny	380	11	391
22	Picardie	60	2	08	106	Breuil-le-Sec	2395	57	2452
22	Picardie	60	2	08	107	Breuil-le-Vert	2867	135	3002
22	Picardie	60	1	17	108	Briot	312	9	321
22	Picardie	60	1	17	109	Brombos	254	4	258
22	Picardie	60	1	15	110	Broquiers	231	0	231
22	Picardie	60	2	06	111	Broyes	162	4	166
22	Picardie	60	2	33	112	Brunvillers-la-Motte	325	4	329
22	Picardie	60	2	16	113	Bucamps	162	2	164
22	Picardie	60	1	35	114	Buicourt	139	4	143
22	Picardie	60	2	08	115	Bulles	883	15	898
22	Picardie	60	2	24	116	Bury	2971	58	3029
22	Picardie	60	3	18	117	Bussy	311	9	320
22	Picardie	60	3	29	118	Caisnes	483	6	489
22	Picardie	60	2	24	120	Cambronne-lès-Clermont	1043	21	1064
22	Picardie	60	3	32	119	Cambronne-lès-Ribécourt	1938	42	1980
22	Picardie	60	3	18	121	Campagne	143	2	145
22	Picardie	60	1	15	122	Campeaux	546	5	551
22	Picardie	60	2	16	123	Campremy	389	8	397
22	Picardie	60	3	19	124	Candor	270	8	278
22	Picardie	60	3	14	125	Canly	784	18	802
22	Picardie	60	3	19	126	Cannectancourt	538	14	552
22	Picardie	60	3	19	127	Canny-sur-Matz	361	5	366
22	Picardie	60	1	15	128	Canny-sur-Thérain	211	2	213
22	Picardie	60	3	32	129	Carlepont	1433	32	1465
22	Picardie	60	2	20	130	Catenoy	1031	68	1099
22	Picardie	60	1	13	131	Catheux	115	4	119
22	Picardie	60	3	18	132	Catigny	200	10	210
22	Picardie	60	2	33	133	Catillon-Fumechon	595	5	600
22	Picardie	60	2	20	134	Cauffry	2421	41	2462
22	Picardie	60	1	28	135	Cauvigny	1439	30	1469
22	Picardie	60	1	17	136	Cempuis	450	103	553
22	Picardie	60	2	33	137	Cernoy	242	2	244
22	Picardie	60	4	34	138	Chamant	909	40	949
22	Picardie	60	4	26	139	Chambly	9438	123	9561
22	Picardie	60	1	07	140	Chambors	328	9	337
22	Picardie	60	4	36	141	Chantilly	10876	256	11132
22	Picardie	60	4	34	142	La Chapelle-en-Serval	2914	53	2967
22	Picardie	60	1	07	143	Chaumont-en-Vexin	3030	50	3080
22	Picardie	60	1	23	144	Chavençon	156	3	159
22	Picardie	60	3	01	145	Chelles	473	14	487
22	Picardie	60	2	06	146	Chepoix	386	6	392
22	Picardie	60	3	32	147	Chevincourt	848	15	863
22	Picardie	60	4	25	148	Chèvreville	461	15	476
22	Picardie	60	3	14	149	Chevrières	1743	53	1796
22	Picardie	60	3	32	150	Chiry-Ourscamp	1112	17	1129
22	Picardie	60	3	09	151	Choisy-au-Bac	3363	169	3532
22	Picardie	60	2	08	152	Choisy-la-Victoire	214	1	215
22	Picardie	60	1	13	153	Choqueuse-les-Bénards	109	1	110
22	Picardie	60	2	20	154	Cinqueux	1523	52	1575
22	Picardie	60	4	26	155	Cires-lès-Mello	3535	68	3603
22	Picardie	60	3	09	156	Clairoix	2116	90	2206
22	Picardie	60	2	08	157	Clermont	10573	189	10762
22	Picardie	60	2	21	158	Coivrel	255	2	257
22	Picardie	60	3	97	159	Compiègne	40517	1778	42295
22	Picardie	60	3	31	160	Conchy-les-Pots	608	8	616
22	Picardie	60	1	13	161	Conteville	81	1	82
22	Picardie	60	1	23	162	Corbeil-Cerf	326	2	328
22	Picardie	60	1	13	163	Cormeilles	359	3	362
22	Picardie	60	1	10	164	Le Coudray-Saint-Germer	888	23	911
22	Picardie	60	1	28	165	Le Coudray-sur-Thelle	528	13	541
22	Picardie	60	3	31	166	Coudun	901	52	953
22	Picardie	60	3	01	167	Couloisy	469	8	477
22	Picardie	60	2	21	168	Courcelles-Epayelles	193	0	193
22	Picardie	60	1	07	169	Courcelles-lès-Gisors	854	17	871
22	Picardie	60	4	34	170	Courteuil	627	33	660
22	Picardie	60	3	01	171	Courtieux	192	2	194
22	Picardie	60	4	36	172	Coye-la-Forêt	3749	236	3985
22	Picardie	60	4	39	173	Cramoisy	739	2	741
22	Picardie	60	3	19	174	Crapeaumesnil	163	3	166
22	Picardie	60	4	98	175	Creil	33601	400	34001
22	Picardie	60	4	12	176	Crépy-en-Valois	14058	306	14364
22	Picardie	60	2	33	177	Cressonsacq	431	4	435
22	Picardie	60	1	13	178	Crèvecoeur-le-Grand	3401	113	3514
22	Picardie	60	2	21	179	Crèvecoeur-le-Petit	111	1	112
22	Picardie	60	1	35	180	Crillon	440	4	444
22	Picardie	60	3	18	181	Crisolles	1031	14	1045
22	Picardie	60	1	13	182	Le Crocq	185	3	188
22	Picardie	60	1	13	183	Croissy-sur-Celle	275	2	277
22	Picardie	60	3	01	184	Croutoy	219	7	226
22	Picardie	60	4	26	185	Crouy-en-Thelle	1086	10	1096
22	Picardie	60	2	33	186	Cuignières	209	1	210
22	Picardie	60	1	10	187	Cuigy-en-Bray	1035	9	1044
22	Picardie	60	3	01	188	Cuise-la-Motte	2172	131	2303
22	Picardie	60	3	29	189	Cuts	946	30	976
22	Picardie	60	4	05	190	Cuvergnon	320	10	330
22	Picardie	60	3	31	191	Cuvilly	610	2	612
22	Picardie	60	3	19	192	Cuy	228	3	231
22	Picardie	60	1	17	193	Daméraucourt	227	2	229
22	Picardie	60	1	17	194	Dargies	245	4	249
22	Picardie	60	1	07	195	Delincourt	511	12	523
22	Picardie	60	1	28	196	Le Déluge	494	8	502
22	Picardie	60	4	26	197	Dieudonné	841	12	853
22	Picardie	60	3	19	198	Dives	344	6	350
22	Picardie	60	1	13	199	Doméliers	225	4	229
22	Picardie	60	2	21	200	Domfront	341	2	343
22	Picardie	60	2	21	201	Dompierre	241	3	244
22	Picardie	60	4	12	203	Duvy	472	7	479
22	Picardie	60	3	19	204	Écuvilly	244	9	253
22	Picardie	60	1	17	205	Élencourt	55	0	55
22	Picardie	60	3	19	206	Élincourt-Sainte-Marguerite	885	18	903
22	Picardie	60	4	12	207	Éméville	292	8	300
22	Picardie	60	1	07	209	Énencourt-le-Sec	202	4	206
22	Picardie	60	1	07	208	Énencourt-Léage	125	2	127
22	Picardie	60	2	08	210	Épineuse	269	1	270
22	Picardie	60	1	07	211	Éragny-sur-Epte	593	3	596
22	Picardie	60	4	26	212	Ercuis	1403	12	1415
22	Picardie	60	4	25	213	Ermenonville	969	17	986
22	Picardie	60	1	35	214	Ernemont-Boutavent	191	4	195
22	Picardie	60	2	08	215	Erquery	522	15	537
22	Picardie	60	2	33	216	Erquinvillers	166	1	167
22	Picardie	60	1	35	217	Escames	202	7	209
22	Picardie	60	1	23	218	Esches	1256	18	1274
22	Picardie	60	1	15	219	Escles-Saint-Pierre	138	4	142
22	Picardie	60	1	10	220	Espaubourg	457	8	465
22	Picardie	60	2	06	221	Esquennoy	745	5	750
22	Picardie	60	2	33	222	Essuiles	547	7	554
22	Picardie	60	3	14	223	Estrées-Saint-Denis	3573	151	3724
22	Picardie	60	4	05	224	Étavigny	163	3	166
22	Picardie	60	2	08	225	Étouy	809	17	826
22	Picardie	60	4	25	226	Ève	426	5	431
22	Picardie	60	3	19	227	Évricourt	194	3	197
22	Picardie	60	1	07	228	Fay-les-Étangs	429	6	435
22	Picardie	60	1	27	230	Le Fay-Saint-Quentin	545	10	555
22	Picardie	60	3	14	229	Le Fayel	228	4	232
22	Picardie	60	4	12	231	Feigneux	429	20	449
22	Picardie	60	2	21	232	Ferrières	486	4	490
22	Picardie	60	1	17	233	Feuquières	1626	26	1652
22	Picardie	60	2	08	234	Fitz-James	2449	44	2493
22	Picardie	60	1	10	235	Flavacourt	698	20	718
22	Picardie	60	3	18	236	Flavy-le-Meldeux	201	1	202
22	Picardie	60	2	06	237	Fléchy	97	1	98
22	Picardie	60	4	30	238	Fleurines	1835	86	1921
22	Picardie	60	1	07	239	Fleury	512	8	520
22	Picardie	60	1	13	240	Fontaine-Bonneleau	259	4	263
22	Picardie	60	4	25	241	Fontaine-Chaalis	375	13	388
22	Picardie	60	1	22	242	Fontaine-Lavaganne	451	6	457
22	Picardie	60	1	27	243	Fontaine-Saint-Lucien	150	2	152
22	Picardie	60	1	35	244	Fontenay-Torcy	131	4	135
22	Picardie	60	1	15	245	Formerie	2099	25	2124
22	Picardie	60	1	23	246	Fosseuse	736	10	746
22	Picardie	60	2	08	247	Fouilleuse	113	1	114
22	Picardie	60	1	15	248	Fouilloy	210	1	211
22	Picardie	60	4	26	249	Foulangues	202	4	206
22	Picardie	60	1	40	250	Fouquenies	437	18	455
22	Picardie	60	1	27	251	Fouquerolles	270	8	278
22	Picardie	60	2	33	252	Fournival	471	10	481
22	Picardie	60	1	13	253	Francastel	417	5	422
22	Picardie	60	3	14	254	Francières	509	11	520
22	Picardie	60	3	18	255	Fréniches	325	4	329
22	Picardie	60	1	07	257	Fresne-Léguillon	470	8	478
22	Picardie	60	1	23	256	Fresneaux-Montchevreuil	756	12	768
22	Picardie	60	3	19	258	Fresnières	181	0	181
22	Picardie	60	4	26	259	Fresnoy-en-Thelle	943	7	950
22	Picardie	60	4	12	260	Fresnoy-la-Rivière	601	13	614
22	Picardie	60	4	25	261	Fresnoy-le-Luat	484	13	497
22	Picardie	60	2	21	262	Le Frestoy-Vaux	226	2	228
22	Picardie	60	3	18	263	Frétoy-le-Château	262	6	268
22	Picardie	60	1	02	264	Frocourt	558	15	573
22	Picardie	60	2	16	265	Froissy	874	19	893
22	Picardie	60	1	13	267	Le Gallet	163	1	164
22	Picardie	60	2	33	268	Gannes	332	3	335
22	Picardie	60	1	22	269	Gaudechart	344	59	403
22	Picardie	60	3	29	270	Genvry	939	8	947
22	Picardie	60	1	35	271	Gerberoy	89	5	94
22	Picardie	60	4	12	272	Gilocourt	605	6	611
22	Picardie	60	3	31	273	Giraumont	546	19	565
22	Picardie	60	4	12	274	Glaignes	365	7	372
22	Picardie	60	1	35	275	Glatigny	209	1	210
22	Picardie	60	2	21	276	Godenvillers	167	1	168
22	Picardie	60	1	04	277	Goincourt	1236	27	1263
22	Picardie	60	3	18	278	Golancourt	383	11	394
22	Picardie	60	4	05	279	Gondreville	242	3	245
22	Picardie	60	1	15	280	Gourchelles	130	2	132
22	Picardie	60	3	31	281	Gournay-sur-Aronde	601	6	607
22	Picardie	60	4	36	282	Gouvieux	9434	385	9819
22	Picardie	60	2	06	283	Gouy-les-Groseillers	35	1	36
22	Picardie	60	3	14	284	Grandfresnoy	1636	75	1711
22	Picardie	60	3	29	287	Grandrû	295	4	299
22	Picardie	60	2	33	285	Grandvillers-aux-Bois	316	8	324
22	Picardie	60	1	17	286	Grandvilliers	3034	123	3157
22	Picardie	60	1	35	288	Grémévillers	390	3	393
22	Picardie	60	1	17	289	Grez	258	2	260
22	Picardie	60	1	27	290	Guignecourt	385	14	399
22	Picardie	60	3	18	291	Guiscard	1878	36	1914
22	Picardie	60	3	19	292	Gury	214	6	220
22	Picardie	60	1	07	293	Hadancourt-le-Haut-Clocher	361	10	371
22	Picardie	60	3	31	294	Hainvillers	95	2	97
22	Picardie	60	1	17	295	Halloy	457	2	459
22	Picardie	60	1	17	297	Le Hamel	174	4	178
22	Picardie	60	1	35	296	Hannaches	141	6	147
22	Picardie	60	1	35	298	Hanvoile	611	16	627
22	Picardie	60	2	16	299	Hardivillers	584	3	587
22	Picardie	60	1	07	300	Hardivillers-en-Vexin	125	1	126
22	Picardie	60	1	35	301	Haucourt	151	3	154
22	Picardie	60	1	27	302	Haudivillers	801	17	818
22	Picardie	60	1	17	303	Hautbos	140	5	145
22	Picardie	60	1	22	304	Haute-Épine	292	9	301
22	Picardie	60	3	01	305	Hautefontaine	264	22	286
22	Picardie	60	1	35	306	Hécourt	150	3	153
22	Picardie	60	2	24	307	Heilles	591	6	597
22	Picardie	60	3	14	308	Hémévillers	421	7	428
22	Picardie	60	1	23	309	Hénonville	795	14	809
22	Picardie	60	1	40	310	Herchies	614	11	625
22	Picardie	60	2	06	311	La Hérelle	189	1	190
22	Picardie	60	1	15	312	Héricourt-sur-Thérain	114	1	115
22	Picardie	60	1	28	313	Hermes	2565	25	2590
22	Picardie	60	1	22	314	Hétomesnil	221	3	224
22	Picardie	60	1	10	315	Hodenc-en-Bray	463	17	480
22	Picardie	60	1	28	316	Hodenc-l;Évêque	238	5	243
22	Picardie	60	2	24	317	Hondainville	611	5	616
22	Picardie	60	3	14	318	Houdancourt	584	12	596
22	Picardie	60	1	02	319	La Houssoye	574	16	590
22	Picardie	60	4	05	320	Ivors	245	3	248
22	Picardie	60	1	23	321	Ivry-le-Temple	651	8	659
22	Picardie	60	1	07	322	Jaméricourt	282	4	286
22	Picardie	60	3	09	323	Janville	723	6	729
22	Picardie	60	3	01	324	Jaulzy	906	21	927
22	Picardie	60	3	41	325	Jaux	2303	65	2368
22	Picardie	60	3	41	326	Jonquières	586	26	612
22	Picardie	60	1	02	327	Jouy-sous-Thelle	977	19	996
22	Picardie	60	1	27	328	Juvignies	290	6	296
22	Picardie	60	3	19	329	Laberlière	178	0	178
22	Picardie	60	1	28	330	Laboissière-en-Thelle	1266	20	1286
22	Picardie	60	1	10	331	Labosse	457	13	470
22	Picardie	60	2	20	332	Labruyère	645	12	657
22	Picardie	60	1	10	333	Lachapelle-aux-Pots	1608	44	1652
22	Picardie	60	1	28	334	Lachapelle-Saint-Pierre	876	25	901
22	Picardie	60	1	35	335	Lachapelle-sous-Gerberoy	163	3	166
22	Picardie	60	1	13	336	Lachaussée-du-Bois-d;Écu	212	6	218
22	Picardie	60	3	14	337	Lachelle	582	28	610
22	Picardie	60	3	37	338	Lacroix-Saint-Ouen	4484	263	4747
22	Picardie	60	1	27	339	Lafraye	348	6	354
22	Picardie	60	3	19	340	Lagny	533	9	542
22	Picardie	60	4	25	341	Lagny-le-Sec	1947	40	1987
22	Picardie	60	2	20	342	Laigneville	4089	70	4159
22	Picardie	60	1	10	343	Lalande-en-Son	681	12	693
22	Picardie	60	1	10	344	Lalandelle	438	11	449
22	Picardie	60	2	08	345	Lamécourt	225	1	226
22	Picardie	60	4	36	346	Lamorlaye	9300	245	9545
22	Picardie	60	1	15	347	Lannoy-Cuillère	221	5	226
22	Picardie	60	3	29	348	Larbroye	477	14	491
22	Picardie	60	3	19	350	Lassigny	1400	23	1423
22	Picardie	60	3	31	351	Lataule	117	3	120
22	Picardie	60	1	07	352	Lattainville	159	3	162
22	Picardie	60	1	17	353	Lavacquerie	208	1	209
22	Picardie	60	1	17	354	Laverrière	48	0	48
22	Picardie	60	1	27	355	Laversines	1148	64	1212
22	Picardie	60	1	07	356	Lavilletertre	503	15	518
22	Picardie	60	2	21	357	Léglantiers	556	3	559
22	Picardie	60	4	05	358	Lévignen	882	12	894
22	Picardie	60	1	35	359	Lhéraule	185	6	191
22	Picardie	60	2	20	360	Liancourt	7169	62	7231
22	Picardie	60	1	07	361	Liancourt-Saint-Pierre	553	13	566
22	Picardie	60	3	18	362	Libermont	211	2	213
22	Picardie	60	1	07	363	Lierville	223	6	229
22	Picardie	60	2	33	364	Lieuvillers	651	20	671
22	Picardie	60	1	22	365	Lihus	375	5	380
22	Picardie	60	2	08	366	Litz	356	3	359
22	Picardie	60	1	07	367	Loconville	351	9	360
22	Picardie	60	3	32	368	Longueil-Annel	2379	46	2425
22	Picardie	60	3	14	369	Longueil-Sainte-Marie	1757	30	1787
22	Picardie	60	1	23	370	Lormaison	1290	15	1305
22	Picardie	60	1	35	371	Loueuse	148	2	150
22	Picardie	60	1	13	372	Luchy	570	4	574
22	Picardie	60	3	32	373	Machemont	722	13	735
22	Picardie	60	2	21	374	Maignelay-Montigny	2631	49	2680
22	Picardie	60	2	08	375	Maimbeville	361	4	365
22	Picardie	60	1	27	376	Maisoncelle-Saint-Pierre	157	4	161
22	Picardie	60	2	16	377	Maisoncelle-Tuilerie	309	3	312
22	Picardie	60	1	04	703	Aux Marais	734	25	759
22	Picardie	60	3	32	378	Marest-sur-Matz	414	12	426
22	Picardie	60	3	19	379	Mareuil-la-Motte	612	18	630
22	Picardie	60	4	05	380	Mareuil-sur-Ourcq	1588	11	1599
22	Picardie	60	3	19	381	Margny-aux-Cerises	240	3	243
22	Picardie	60	3	09	382	Margny-lès-Compiègne	8021	188	8209
22	Picardie	60	3	31	383	Margny-sur-Matz	515	7	522
22	Picardie	60	4	05	385	Marolles	665	13	678
22	Picardie	60	3	31	386	Marquéglise	441	5	446
22	Picardie	60	1	22	387	Marseille-en-Beauvaisis	1230	13	1243
22	Picardie	60	1	35	388	Martincourt	149	3	152
22	Picardie	60	3	18	389	Maucourt	283	4	287
22	Picardie	60	1	13	390	Maulers	203	4	207
22	Picardie	60	4	39	391	Maysel	244	5	249
22	Picardie	60	3	32	392	Mélicocq	670	12	682
22	Picardie	60	4	39	393	Mello	587	16	603
22	Picardie	60	2	21	394	Ménévillers	100	2	102
22	Picardie	60	1	23	395	Méru	13269	204	13473
22	Picardie	60	2	21	396	Méry-la-Bataille	621	9	630
22	Picardie	60	1	17	397	Le Mesnil-Conteville	106	4	110
22	Picardie	60	4	26	398	Le Mesnil-en-Thelle	2288	25	2313
22	Picardie	60	2	06	399	Le Mesnil-Saint-Firmin	154	72	226
22	Picardie	60	2	33	400	Le Mesnil-sur-Bulles	229	2	231
22	Picardie	60	1	02	401	Le Mesnil-Théribus	825	40	865
22	Picardie	60	3	41	402	Le Meux	1992	139	2131
22	Picardie	60	1	22	403	Milly-sur-Thérain	1698	28	1726
22	Picardie	60	2	20	404	Mogneville	1493	44	1537
22	Picardie	60	1	15	405	Moliens	1096	7	1103
22	Picardie	60	2	20	406	Monceaux	753	28	781
22	Picardie	60	1	15	407	Monceaux-l;Abbaye	205	2	207
22	Picardie	60	3	31	408	Monchy-Humières	661	49	710
22	Picardie	60	2	20	409	Monchy-Saint-Éloi	1979	58	2037
22	Picardie	60	3	29	410	Mondescourt	275	8	283
22	Picardie	60	1	07	411	Monneville	833	21	854
22	Picardie	60	4	34	421	Mont-l;Évêque	422	12	434
22	Picardie	60	1	02	428	Le Mont-Saint-Adrien	580	18	598
22	Picardie	60	1	07	412	Montagny-en-Vexin	593	9	602
22	Picardie	60	4	25	413	Montagny-Sainte-Félicité	407	15	422
22	Picardie	60	4	39	414	Montataire	12500	161	12661
22	Picardie	60	4	34	415	Montépilloy	160	6	166
22	Picardie	60	2	21	416	Montgérain	157	2	159
22	Picardie	60	1	23	417	Montherlant	138	1	139
22	Picardie	60	2	33	418	Montiers	407	5	412
22	Picardie	60	1	07	420	Montjavoult	482	9	491
22	Picardie	60	4	25	422	Montlognon	224	10	234
22	Picardie	60	3	32	423	Montmacq	1087	23	1110
22	Picardie	60	3	14	424	Montmartin	204	6	210
22	Picardie	60	2	16	425	Montreuil-sur-Brêche	530	7	537
22	Picardie	60	1	28	426	Montreuil-sur-Thérain	244	1	245
22	Picardie	60	1	23	427	Monts	201	2	203
22	Picardie	60	4	26	429	Morangles	393	2	395
22	Picardie	60	4	12	430	Morienval	1022	23	1045
22	Picardie	60	3	29	431	Morlincourt	483	20	503
22	Picardie	60	4	34	432	Mortefontaine	870	26	896
22	Picardie	60	1	28	433	Mortefontaine-en-Thelle	839	25	864
22	Picardie	60	3	31	434	Mortemer	197	3	200
22	Picardie	60	1	35	435	Morvillers	443	11	454
22	Picardie	60	2	06	436	Mory-Montcrux	97	0	97
22	Picardie	60	1	28	437	Mouchy-le-Châtel	79	4	83
22	Picardie	60	3	01	438	Moulin-sous-Touvent	229	3	232
22	Picardie	60	2	24	439	Mouy	5282	86	5368
22	Picardie	60	2	33	440	Moyenneville	606	13	619
22	Picardie	60	3	14	441	Moyvillers	592	10	602
22	Picardie	60	1	13	442	Muidorge	143	2	145
22	Picardie	60	3	18	443	Muirancourt	554	8	562
22	Picardie	60	1	15	444	Mureaumont	149	3	152
22	Picardie	60	3	01	445	Nampcel	298	7	305
22	Picardie	60	4	25	446	Nanteuil-le-Haudouin	3516	73	3589
22	Picardie	60	4	12	447	Néry	698	11	709
22	Picardie	60	4	05	448	Neufchelles	369	5	374
22	Picardie	60	3	31	449	Neufvy-sur-Aronde	246	2	248
22	Picardie	60	4	26	450	Neuilly-en-Thelle	3098	67	3165
22	Picardie	60	2	24	451	Neuilly-sous-Clermont	1661	23	1684
22	Picardie	60	1	23	452	Neuville-Bosc	528	5	533
22	Picardie	60	1	28	453	La Neuville-d;Aumont	289	8	297
22	Picardie	60	2	08	454	La Neuville-en-Hez	972	15	987
22	Picardie	60	1	02	455	La Neuville-Garnier	267	6	273
22	Picardie	60	2	33	456	La Neuville-Roy	969	23	992
22	Picardie	60	2	16	457	La Neuville-Saint-Pierre	167	0	167
22	Picardie	60	1	22	458	La Neuville-sur-Oudeuil	343	5	348
22	Picardie	60	3	31	459	La Neuville-sur-Ressons	228	4	232
22	Picardie	60	1	22	460	La Neuville-Vault	177	7	184
22	Picardie	60	1	27	461	Nivillers	190	32	222
22	Picardie	60	1	28	462	Noailles	2748	49	2797
22	Picardie	60	4	11	463	Nogent-sur-Oise	18833	322	19155
22	Picardie	60	2	20	464	Nointel	1008	27	1035
22	Picardie	60	2	16	465	Noirémont	177	4	181
22	Picardie	60	2	33	466	Noroy	194	7	201
22	Picardie	60	2	33	468	Nourard-le-Franc	324	15	339
22	Picardie	60	1	28	469	Novillers	370	4	374
22	Picardie	60	2	16	470	Noyers-Saint-Martin	772	11	783
22	Picardie	60	3	29	471	Noyon	13478	429	13907
22	Picardie	60	1	17	472	Offoy	106	1	107
22	Picardie	60	4	25	473	Ognes	264	4	268
22	Picardie	60	3	18	474	Ognolles	289	8	297
22	Picardie	60	4	34	475	Ognon	145	1	146
22	Picardie	60	1	15	476	Omécourt	159	4	163
22	Picardie	60	1	02	477	Ons-en-Bray	1295	34	1329
22	Picardie	60	4	05	478	Ormoy-le-Davien	319	2	321
22	Picardie	60	4	12	479	Ormoy-Villers	643	7	650
22	Picardie	60	1	27	480	Oroër	544	16	560
22	Picardie	60	4	12	481	Orrouy	584	15	599
22	Picardie	60	4	34	482	Orry-la-Ville	3403	91	3494
22	Picardie	60	3	31	483	Orvillers-Sorel	503	88	591
22	Picardie	60	1	22	484	Oudeuil	255	6	261
22	Picardie	60	2	16	485	Oursel-Maison	261	6	267
22	Picardie	60	2	06	486	Paillart	601	5	606
22	Picardie	60	1	07	487	Parnes	351	14	365
22	Picardie	60	3	29	488	Passel	299	5	304
22	Picardie	60	4	25	489	Péroy-les-Gombries	1023	23	1046
22	Picardie	60	1	40	490	Pierrefitte-en-Beauvaisis	375	14	389
22	Picardie	60	3	01	491	Pierrefonds	1930	211	2141
22	Picardie	60	3	32	492	Pimprez	753	18	771
22	Picardie	60	1	22	493	Pisseleu	424	11	435
22	Picardie	60	4	34	494	Plailly	1671	42	1713
22	Picardie	60	2	33	495	Plainval	355	7	362
22	Picardie	60	2	06	496	Plainville	178	0	178
22	Picardie	60	2	33	497	Le Plessier-sur-Bulles	165	2	167
22	Picardie	60	2	33	498	Le Plessier-sur-Saint-Just	483	6	489
22	Picardie	60	4	25	500	Le Plessis-Belleville	3337	47	3384
22	Picardie	60	3	32	501	Le Plessis-Brion	1446	27	1473
22	Picardie	60	3	19	499	Plessis-de-Roye	234	11	245
22	Picardie	60	3	18	502	Le Plessis-Patte-d;Oie	100	2	102
22	Picardie	60	2	21	503	Le Ployron	115	2	117
22	Picardie	60	1	28	504	Ponchon	1095	29	1124
22	Picardie	60	3	29	506	Pont-l;Évêque	711	8	719
22	Picardie	60	4	30	509	Pont-Sainte-Maxence	11775	173	11948
22	Picardie	60	4	34	505	Pontarmé	819	15	834
22	Picardie	60	3	29	507	Pontoise-lès-Noyon	479	7	486
22	Picardie	60	4	30	508	Pontpoint	3136	52	3188
22	Picardie	60	1	02	510	Porcheux	315	2	317
22	Picardie	60	3	29	511	Porquéricourt	356	2	358
22	Picardie	60	1	23	512	Pouilly	163	5	168
22	Picardie	60	4	39	513	Précy-sur-Oise	3236	74	3310
22	Picardie	60	1	22	514	Prévillers	181	0	181
22	Picardie	60	2	33	515	Pronleroy	398	9	407
22	Picardie	60	1	10	516	Puiseux-en-Bray	410	3	413
22	Picardie	60	4	26	517	Puiseux-le-Hauberger	843	8	851
22	Picardie	60	2	16	518	Puits-la-Vallée	204	6	210
22	Picardie	60	3	18	519	Quesmy	182	3	185
22	Picardie	60	2	16	520	Le Quesnel-Aubry	173	5	178
22	Picardie	60	1	15	521	Quincampoix-Fleuzy	398	9	407
22	Picardie	60	2	33	522	Quinquempoix	334	2	336
22	Picardie	60	1	02	523	Rainvillers	872	26	898
22	Picardie	60	2	20	524	Rantigny	2559	26	2585
22	Picardie	60	4	30	525	Raray	159	0	159
22	Picardie	60	2	33	526	Ravenel	1156	11	1167
22	Picardie	60	4	05	527	Réez-Fosse-Martin	163	6	169
22	Picardie	60	1	07	528	Reilly	129	3	132
22	Picardie	60	2	08	529	Rémécourt	92	1	93
22	Picardie	60	2	08	530	Rémérangles	225	4	229
22	Picardie	60	3	14	531	Remy	1724	69	1793
22	Picardie	60	1	23	532	Ressons-l;Abbaye	90	1	91
22	Picardie	60	3	31	533	Ressons-sur-Matz	1591	52	1643
22	Picardie	60	3	01	534	Rethondes	724	26	750
22	Picardie	60	2	16	535	Reuil-sur-Brêche	304	7	311
22	Picardie	60	4	30	536	Rhuis	144	0	144
22	Picardie	60	3	32	537	Ribécourt-Dreslincourt	3978	219	4197
22	Picardie	60	3	31	538	Ricquebourg	231	2	233
22	Picardie	60	2	20	539	Rieux	1596	39	1635
22	Picardie	60	3	14	540	Rivecourt	522	7	529
22	Picardie	60	4	30	541	Roberval	384	5	389
22	Picardie	60	1	27	542	Rochy-Condé	1035	9	1044
22	Picardie	60	4	12	543	Rocquemont	103	4	107
22	Picardie	60	2	06	544	Rocquencourt	189	0	189
22	Picardie	60	1	15	545	Romescamps	550	6	556
22	Picardie	60	4	25	546	Rosières	140	0	140
22	Picardie	60	2	20	547	Rosoy	615	12	627
22	Picardie	60	4	05	548	Rosoy-en-Multien	501	1	502
22	Picardie	60	1	13	549	Rotangy	200	9	209
22	Picardie	60	1	22	550	Rothois	206	2	208
22	Picardie	60	2	24	551	Rousseloy	306	11	317
22	Picardie	60	4	12	552	Rouville	288	8	296
22	Picardie	60	2	33	553	Rouvillers	262	7	269
22	Picardie	60	4	05	554	Rouvres-en-Multien	482	6	488
22	Picardie	60	2	06	555	Rouvroy-les-Merles	64	14	78
22	Picardie	60	1	22	557	Roy-Boissy	338	0	338
22	Picardie	60	2	21	556	Royaucourt	221	1	222
22	Picardie	60	3	19	558	Roye-sur-Matz	450	6	456
22	Picardie	60	2	08	559	La Rue-Saint-Pierre	769	16	785
22	Picardie	60	4	30	560	Rully	737	37	774
22	Picardie	60	4	12	561	Russy-Bémont	183	4	187
22	Picardie	60	2	20	562	Sacy-le-Grand	1363	28	1391
22	Picardie	60	2	20	563	Sacy-le-Petit	539	10	549
22	Picardie	60	2	21	564	Sains-Morainvillers	273	2	275
22	Picardie	60	2	16	565	Saint-André-Farivillers	513	9	522
22	Picardie	60	1	15	566	Saint-Arnoult	187	4	191
22	Picardie	60	1	10	567	Saint-Aubin-en-Bray	1013	32	1045
22	Picardie	60	2	08	568	Saint-Aubin-sous-Erquery	325	4	329
22	Picardie	60	3	01	569	Saint-Crépin-aux-Bois	253	13	266
22	Picardie	60	1	23	570	Saint-Crépin-Ibouvillers	1207	10	1217
22	Picardie	60	1	35	571	Saint-Deniscourt	102	4	106
22	Picardie	60	3	01	572	Saint-Étienne-Roilaye	320	9	329
22	Picardie	60	2	24	574	Saint-Félix	607	7	614
22	Picardie	60	1	02	576	Saint-Germain-la-Poterie	420	6	426
22	Picardie	60	1	10	577	Saint-Germer-de-Fly	1762	37	1799
22	Picardie	60	3	37	579	Saint-Jean-aux-Bois	285	25	310
22	Picardie	60	2	33	581	Saint-Just-en-Chaussée	5496	84	5580
22	Picardie	60	3	32	582	Saint-Léger-aux-Bois	803	25	828
22	Picardie	60	1	02	583	Saint-Léger-en-Bray	378	10	388
22	Picardie	60	4	39	584	Saint-Leu-d;Esserent	4705	116	4821
22	Picardie	60	2	21	585	Saint-Martin-aux-Bois	291	6	297
22	Picardie	60	1	04	586	Saint-Martin-le-Noeud	1055	27	1082
22	Picardie	60	2	20	587	Saint-Martin-Longueau	1481	26	1507
22	Picardie	60	1	17	588	Saint-Maur	394	6	400
22	Picardie	60	4	36	589	Saint-Maximin	2493	135	2628
22	Picardie	60	1	22	590	Saint-Omer-en-Chaussée	1322	22	1344
22	Picardie	60	1	02	591	Saint-Paul	1579	59	1638
22	Picardie	60	1	10	592	Saint-Pierre-es-Champs	679	7	686
22	Picardie	60	3	01	593	Saint-Pierre-lès-Bitry	143	3	146
22	Picardie	60	1	35	594	Saint-Quentin-des-Prés	291	20	311
22	Picardie	60	2	33	595	Saint-Remy-en-l;Eau	426	7	433
22	Picardie	60	1	15	596	Saint-Samson-la-Poterie	253	1	254
22	Picardie	60	3	37	597	Saint-Sauveur	1562	74	1636
22	Picardie	60	1	28	598	Saint-Sulpice	922	108	1030
22	Picardie	60	1	17	599	Saint-Thibault	274	5	279
22	Picardie	60	4	30	600	Saint-Vaast-de-Longmont	620	16	636
22	Picardie	60	4	39	601	Saint-Vaast-lès-Mello	966	21	987
22	Picardie	60	1	15	602	Saint-Valery	61	1	62
22	Picardie	60	2	16	573	Sainte-Eusoye	274	6	280
22	Picardie	60	1	28	575	Sainte-Geneviève	2790	48	2838
22	Picardie	60	4	12	578	Saintines	920	12	932
22	Picardie	60	3	29	603	Salency	900	16	916
22	Picardie	60	1	17	604	Sarcus	278	3	281
22	Picardie	60	1	17	605	Sarnois	324	8	332
22	Picardie	60	1	13	608	Le Saulchoy	100	1	101
22	Picardie	60	1	40	609	Savignies	719	27	746
22	Picardie	60	3	29	610	Sempigny	852	19	871
22	Picardie	60	1	35	611	Senantes	672	19	691
22	Picardie	60	4	34	612	Senlis	16170	697	16867
22	Picardie	60	1	07	613	Senots	324	15	339
22	Picardie	60	1	07	614	Serans	234	2	236
22	Picardie	60	2	06	615	Sérévillers	125	3	128
22	Picardie	60	1	10	616	Sérifontaine	2768	47	2815
22	Picardie	60	3	18	617	Sermaize	245	7	252
22	Picardie	60	4	12	618	Séry-Magneval	298	11	309
22	Picardie	60	4	25	619	Silly-le-Long	1156	18	1174
22	Picardie	60	1	28	620	Silly-Tillard	484	10	494
22	Picardie	60	3	18	621	Solente	117	1	118
22	Picardie	60	1	17	622	Sommereux	398	12	410
22	Picardie	60	1	35	623	Songeons	1114	61	1175
22	Picardie	60	1	35	624	Sully	157	2	159
22	Picardie	60	3	29	625	Suzoy	534	8	542
22	Picardie	60	1	10	626	Talmontiers	748	13	761
22	Picardie	60	2	06	627	Tartigny	266	0	266
22	Picardie	60	1	27	628	Therdonne	935	20	955
22	Picardie	60	1	35	629	Thérines	190	4	194
22	Picardie	60	1	07	630	Thibivillers	206	3	209
22	Picardie	60	4	34	631	Thiers-sur-Thève	1106	27	1133
22	Picardie	60	3	19	632	Thiescourt	755	22	777
22	Picardie	60	1	17	633	Thieuloy-Saint-Antoine	340	6	346
22	Picardie	60	2	16	634	Thieux	418	10	428
22	Picardie	60	4	39	635	Thiverny	988	21	1009
22	Picardie	60	3	32	636	Thourotte	4736	123	4859
22	Picardie	60	4	05	637	Thury-en-Valois	474	4	478
22	Picardie	60	2	24	638	Thury-sous-Clermont	685	9	694
22	Picardie	60	1	27	639	Tillé	1102	17	1119
22	Picardie	60	1	07	640	Tourly	174	5	179
22	Picardie	60	3	01	641	Tracy-le-Mont	1716	32	1748
22	Picardie	60	3	32	642	Tracy-le-Val	1047	30	1077
22	Picardie	60	2	21	643	Tricot	1433	24	1457
22	Picardie	60	1	07	644	Trie-Château	1508	25	1533
22	Picardie	60	1	07	645	Trie-la-Ville	325	1	326
22	Picardie	60	1	27	646	Troissereux	1152	31	1183
22	Picardie	60	3	01	647	Trosly-Breuil	2093	62	2155
22	Picardie	60	2	06	648	Troussencourt	339	4	343
22	Picardie	60	1	02	649	Troussures	189	8	197
22	Picardie	60	4	12	650	Trumilly	568	8	576
22	Picardie	60	4	26	651	Ully-Saint-Georges	1916	41	1957
22	Picardie	60	1	02	652	Valdampierre	916	15	931
22	Picardie	60	2	33	653	Valescourt	275	2	277
22	Picardie	60	3	32	654	Vandélicourt	263	4	267
22	Picardie	60	3	29	655	Varesnes	393	19	412
22	Picardie	60	4	05	656	Varinfroy	237	4	241
22	Picardie	60	3	29	657	Vauchelles	311	1	312
22	Picardie	60	4	12	658	Vauciennes	637	10	647
22	Picardie	60	1	07	659	Vaudancourt	172	5	177
22	Picardie	60	1	10	660	Le Vaumain	343	4	347
22	Picardie	60	4	12	661	Vaumoise	892	106	998
22	Picardie	60	1	10	662	Le Vauroux	461	16	477
22	Picardie	60	1	27	663	Velennes	246	11	257
22	Picardie	60	2	06	664	Vendeuil-Caply	474	9	483
22	Picardie	60	3	41	665	Venette	2762	171	2933
22	Picardie	60	4	25	666	Ver-sur-Launette	1198	29	1227
22	Picardie	60	4	30	667	Verberie	3998	73	4071
22	Picardie	60	1	27	668	Verderel-lès-Sauqueuse	740	19	759
22	Picardie	60	2	20	669	Verderonne	554	20	574
22	Picardie	60	4	30	670	Verneuil-en-Halatte	4486	98	4584
22	Picardie	60	4	25	671	Versigny	395	6	401
22	Picardie	60	4	12	672	Vez	318	9	327
22	Picardie	60	1	13	673	Viefvillers	173	0	173
22	Picardie	60	3	37	674	Vieux-Moulin	598	27	625
22	Picardie	60	3	31	675	Vignemont	397	10	407
22	Picardie	60	3	29	676	Ville	779	9	788
22	Picardie	60	1	35	677	Villembray	247	7	254
22	Picardie	60	1	23	678	Villeneuve-les-Sablons	1281	16	1297
22	Picardie	60	4	05	679	La Villeneuve-sous-Thury	172	0	172
22	Picardie	60	4	30	680	Villeneuve-sur-Verberie	684	16	700
22	Picardie	60	1	02	681	Villers-Saint-Barthélemy	479	10	489
22	Picardie	60	4	34	682	Villers-Saint-Frambourg	589	42	631
22	Picardie	60	4	05	683	Villers-Saint-Genest	401	10	411
22	Picardie	60	4	11	684	Villers-Saint-Paul	6171	77	6248
22	Picardie	60	1	28	685	Villers-Saint-Sépulcre	950	15	965
22	Picardie	60	4	39	686	Villers-sous-Saint-Leu	2317	49	2366
22	Picardie	60	1	35	687	Villers-sur-Auchy	358	5	363
22	Picardie	60	1	22	688	Villers-sur-Bonnières	163	5	168
22	Picardie	60	3	31	689	Villers-sur-Coudun	1400	65	1465
22	Picardie	60	1	07	690	Villers-sur-Trie	345	9	354
22	Picardie	60	1	15	691	Villers-Vermont	126	1	127
22	Picardie	60	2	06	692	Villers-Vicomte	152	3	155
22	Picardie	60	3	18	693	Villeselve	378	3	381
22	Picardie	60	1	02	694	Villotran	288	10	298
22	Picardie	60	4	34	695	Vineuil-Saint-Firmin	1425	46	1471
22	Picardie	60	1	35	697	Vrocourt	39	0	39
22	Picardie	60	2	21	698	Wacquemoulin	296	1	297
22	Picardie	60	1	35	699	Wambez	150	2	152
22	Picardie	60	1	28	700	Warluis	1121	28	1149
22	Picardie	60	2	33	701	Wavignies	1160	14	1174
22	Picardie	60	2	21	702	Welles-Pérennes	244	4	248
25	Basse-Normandie	61	3	98	214	L; Aigle	7975	213	8188
25	Basse-Normandie	61	1	99	001	Alençon	26704	1159	27863
25	Basse-Normandie	61	2	24	002	Almenêches	692	8	700
25	Basse-Normandie	61	2	13	003	Anceins	227	1	228
25	Basse-Normandie	61	1	14	004	Antoigny	122	6	128
25	Basse-Normandie	61	3	06	005	Appenai-sous-Bellême	245	4	249
25	Basse-Normandie	61	2	97	006	Argentan	14369	713	15082
25	Basse-Normandie	61	3	25	422	Les Aspres	698	8	706
25	Basse-Normandie	61	2	04	007	Athis-de-l;Orne	2602	72	2674
25	Basse-Normandie	61	3	37	008	Aube	1412	56	1468
25	Basse-Normandie	61	2	35	009	Aubry-en-Exmes	300	11	311
25	Basse-Normandie	61	2	36	010	Aubry-le-Panthou	102	1	103
25	Basse-Normandie	61	2	15	011	Aubusson	426	16	442
25	Basse-Normandie	61	3	25	012	Auguaise	157	4	161
25	Basse-Normandie	61	1	20	013	Aunay-les-Bois	175	2	177
25	Basse-Normandie	61	2	03	014	Aunou-le-Faucon	263	10	273
25	Basse-Normandie	61	1	31	015	Aunou-sur-Orne	260	9	269
25	Basse-Normandie	61	3	34	016	Autheuil	145	2	147
25	Basse-Normandie	61	2	21	017	Les Authieux-du-Puits	69	3	72
25	Basse-Normandie	61	2	36	018	Avernes-Saint-Gourgon	69	4	73
25	Basse-Normandie	61	2	12	019	Avernes-sous-Exmes	72	0	72
25	Basse-Normandie	61	2	11	020	Avoine	246	4	250
25	Basse-Normandie	61	1	10	021	Avrilly	129	1	130
25	Basse-Normandie	61	1	17	483	Bagnoles-de-l;Orne	2405	68	2473
25	Basse-Normandie	61	2	35	023	Bailleul	619	16	635
25	Basse-Normandie	61	2	22	024	Banvou	646	9	655
25	Basse-Normandie	61	1	17	025	La Baroche-sous-Lucé	391	9	400
25	Basse-Normandie	61	3	28	026	Barville	204	5	209
25	Basse-Normandie	61	2	11	027	Batilly	167	6	173
25	Basse-Normandie	61	2	29	028	Bazoches-au-Houlme	462	11	473
25	Basse-Normandie	61	3	05	029	Bazoches-sur-Hoëne	953	12	965
25	Basse-Normandie	61	2	15	030	La Bazoque	247	7	254
25	Basse-Normandie	61	2	33	031	Beauchêne	246	3	249
25	Basse-Normandie	61	3	37	032	Beaufai	367	3	370
25	Basse-Normandie	61	1	17	033	Beaulandais	153	10	163
25	Basse-Normandie	61	3	34	034	Beaulieu	211	7	218
25	Basse-Normandie	61	1	08	035	Beauvain	280	11	291
25	Basse-Normandie	61	1	31	036	Belfonds	170	4	174
25	Basse-Normandie	61	3	28	037	Bellavilliers	163	1	164
25	Basse-Normandie	61	3	06	038	Bellême	1562	41	1603
25	Basse-Normandie	61	2	24	039	La Bellière	108	6	114
25	Basse-Normandie	61	2	22	040	Bellou-en-Houlme	1111	25	1136
25	Basse-Normandie	61	3	32	041	Bellou-le-Trichard	238	4	242
25	Basse-Normandie	61	3	30	042	Bellou-sur-Huisne	429	13	442
25	Basse-Normandie	61	3	26	043	Berd;huis	1073	22	1095
25	Basse-Normandie	61	2	04	044	Berjou	476	14	490
25	Basse-Normandie	61	3	34	045	Bivilliers	64	1	65
25	Basse-Normandie	61	3	19	046	Bizou	117	7	124
25	Basse-Normandie	61	2	13	047	Bocquencé	155	2	157
25	Basse-Normandie	61	3	05	048	Boëcé	127	3	130
25	Basse-Normandie	61	2	24	049	Boissei-la-Lande	113	2	115
25	Basse-Normandie	61	3	30	050	Boissy-Maugis	369	11	380
25	Basse-Normandie	61	1	20	051	Boitron	342	7	349
25	Basse-Normandie	61	3	25	052	Bonnefoi	172	2	174
25	Basse-Normandie	61	3	25	053	Bonsmoulins	233	3	236
25	Basse-Normandie	61	2	36	054	Le Bosc-Renoult	235	10	245
25	Basse-Normandie	61	2	11	055	Boucé	609	19	628
25	Basse-Normandie	61	1	31	056	Le Bouillon	154	5	159
25	Basse-Normandie	61	2	12	057	Le Bourg-Saint-Léonard	432	10	442
25	Basse-Normandie	61	2	04	058	Bréel	129	3	132
25	Basse-Normandie	61	3	34	059	Bresolettes	19	2	21
25	Basse-Normandie	61	3	25	060	Brethel	134	0	134
25	Basse-Normandie	61	3	30	061	Bretoncelles	1441	26	1467
25	Basse-Normandie	61	2	35	062	Brieux	90	3	93
25	Basse-Normandie	61	2	07	063	Briouze	1587	64	1651
25	Basse-Normandie	61	1	09	064	Brullemail	108	2	110
25	Basse-Normandie	61	3	34	065	Bubertré	146	4	150
25	Basse-Normandie	61	3	05	066	Buré	117	5	122
25	Basse-Normandie	61	1	09	067	Bures	174	5	179
25	Basse-Normandie	61	1	20	068	Bursard	198	7	205
25	Basse-Normandie	61	2	04	069	Cahan	164	5	169
25	Basse-Normandie	61	2	15	070	Caligny	849	32	881
25	Basse-Normandie	61	2	36	071	Camembert	200	6	206
25	Basse-Normandie	61	2	36	072	Canapville	195	1	196
25	Basse-Normandie	61	2	04	073	La Carneille	582	12	594
25	Basse-Normandie	61	1	08	074	Carrouges	734	15	749
25	Basse-Normandie	61	1	10	075	Ceaucé	1223	36	1259
25	Basse-Normandie	61	1	08	076	Le Cercueil	145	10	155
25	Basse-Normandie	61	1	38	077	Cerisé	732	20	752
25	Basse-Normandie	61	2	15	078	Cerisy-Belle-Étoile	739	47	786
25	Basse-Normandie	61	3	32	079	Ceton	1898	30	1928
25	Basse-Normandie	61	1	08	080	Chahains	101	2	103
25	Basse-Normandie	61	1	31	081	Chailloué	565	7	572
25	Basse-Normandie	61	1	09	082	Le Chalange	98	0	98
25	Basse-Normandie	61	2	35	083	Chambois	420	4	424
25	Basse-Normandie	61	1	08	085	Le Champ-de-la-Pierre	40	0	40
25	Basse-Normandie	61	2	21	088	Champ-Haut	50	1	51
25	Basse-Normandie	61	2	29	084	Champcerie	137	3	140
25	Basse-Normandie	61	2	36	086	Les Champeaux	136	6	142
25	Basse-Normandie	61	3	05	087	Champeaux-sur-Sarthe	183	5	188
25	Basse-Normandie	61	2	36	089	Champosoult	106	1	107
25	Basse-Normandie	61	3	34	090	Champs	108	1	109
25	Basse-Normandie	61	1	10	091	Champsecret	1014	30	1044
25	Basse-Normandie	61	3	18	092	Chandai	681	21	702
25	Basse-Normandie	61	2	33	093	Chanu	1305	37	1342
25	Basse-Normandie	61	2	40	094	La Chapelle-au-Moine	582	20	602
25	Basse-Normandie	61	2	40	095	La Chapelle-Biche	528	20	548
25	Basse-Normandie	61	1	17	096	La Chapelle-d;Andaine	1526	56	1582
25	Basse-Normandie	61	3	23	097	La Chapelle-Montligeon	636	18	654
25	Basse-Normandie	61	1	31	098	La Chapelle-près-Sées	434	25	459
25	Basse-Normandie	61	3	06	099	La Chapelle-Souëf	308	3	311
25	Basse-Normandie	61	3	25	100	La Chapelle-Viel	284	11	295
25	Basse-Normandie	61	2	24	101	Le Château-d;Almenêches	201	2	203
25	Basse-Normandie	61	2	22	102	Le Châtellier	398	8	406
25	Basse-Normandie	61	2	16	103	Chaumont	170	0	170
25	Basse-Normandie	61	1	08	104	La Chaux	54	4	58
25	Basse-Normandie	61	3	06	105	Chemilli	217	3	220
25	Basse-Normandie	61	2	29	106	Chênedouit	170	4	174
25	Basse-Normandie	61	1	08	107	Ciral	436	12	448
25	Basse-Normandie	61	2	16	108	Cisai-Saint-Aubin	192	6	198
25	Basse-Normandie	61	2	33	109	Clairefougère	135	1	136
25	Basse-Normandie	61	2	12	110	La Cochère	152	7	159
25	Basse-Normandie	61	1	02	111	Colombiers	339	11	350
25	Basse-Normandie	61	3	26	112	Colonard-Corubert	251	7	258
25	Basse-Normandie	61	3	23	113	Comblot	74	3	77
25	Basse-Normandie	61	2	39	114	Commeaux	125	11	136
25	Basse-Normandie	61	3	30	116	Condé-sur-Huisne	1313	26	1339
25	Basse-Normandie	61	1	02	117	Condé-sur-Sarthe	2202	88	2290
25	Basse-Normandie	61	3	30	115	Condeau	415	6	421
25	Basse-Normandie	61	3	23	118	Corbon	152	4	156
25	Basse-Normandie	61	2	35	120	Coudehard	87	3	90
25	Basse-Normandie	61	3	28	121	Coulimer	289	5	294
25	Basse-Normandie	61	2	16	122	Coulmer	98	2	100
25	Basse-Normandie	61	2	35	123	Coulonces	212	3	215
25	Basse-Normandie	61	2	22	124	La Coulonche	521	7	528
25	Basse-Normandie	61	3	30	125	Coulonges-les-Sablons	415	8	423
25	Basse-Normandie	61	1	20	126	Coulonges-sur-Sarthe	492	8	500
25	Basse-Normandie	61	2	11	127	La Courbe	59	4	63
25	Basse-Normandie	61	3	26	128	Courcerault	168	6	174
25	Basse-Normandie	61	3	23	129	Courgeon	366	10	376
25	Basse-Normandie	61	3	05	130	Courgeoût	465	9	474
25	Basse-Normandie	61	2	12	131	Courménil	125	0	125
25	Basse-Normandie	61	1	09	133	Courtomer	744	10	754
25	Basse-Normandie	61	1	14	135	Couterne	1009	26	1035
25	Basse-Normandie	61	2	13	136	Couvains	172	8	180
25	Basse-Normandie	61	2	07	137	Craménil	166	2	168
25	Basse-Normandie	61	2	16	138	Croisilles	210	1	211
25	Basse-Normandie	61	2	36	139	Crouttes	302	7	309
25	Basse-Normandie	61	3	18	140	Crulai	941	17	958
25	Basse-Normandie	61	1	02	141	Cuissai	422	14	436
25	Basse-Normandie	61	3	06	142	Dame-Marie	172	2	174
25	Basse-Normandie	61	1	02	143	Damigny	2806	121	2927
25	Basse-Normandie	61	3	26	144	Dancé	374	18	392
25	Basse-Normandie	61	1	10	145	Domfront	3830	147	3977
25	Basse-Normandie	61	2	22	146	Dompierre	373	8	381
25	Basse-Normandie	61	3	30	147	Dorceau	417	15	432
25	Basse-Normandie	61	2	04	148	Durcet	261	4	265
25	Basse-Normandie	61	2	22	149	Échalou	355	7	362
25	Basse-Normandie	61	2	21	150	Échauffour	736	15	751
25	Basse-Normandie	61	3	37	151	Écorcei	350	11	361
25	Basse-Normandie	61	2	35	152	Écorches	91	6	97
25	Basse-Normandie	61	2	11	153	Écouché	1306	34	1340
25	Basse-Normandie	61	3	28	154	Eperrais	111	1	112
25	Basse-Normandie	61	1	27	155	L; Épinay-le-Comte	179	7	186
25	Basse-Normandie	61	1	20	156	Essay	531	1	532
25	Basse-Normandie	61	2	12	157	Exmes	308	10	318
25	Basse-Normandie	61	2	07	158	Faverolles	146	3	149
25	Basse-Normandie	61	3	25	159	Fay	64	1	65
25	Basse-Normandie	61	3	23	160	Feings	221	5	226
25	Basse-Normandie	61	2	12	161	Fel	279	6	285
25	Basse-Normandie	61	3	25	162	La Ferrière-au-Doyen	195	7	202
25	Basse-Normandie	61	2	22	163	La Ferrière-aux-Étangs	1547	41	1588
25	Basse-Normandie	61	1	31	164	La Ferrière-Béchet	206	8	214
25	Basse-Normandie	61	1	02	165	La Ferrière-Bochard	693	23	716
25	Basse-Normandie	61	1	09	166	Ferrières-la-Verrerie	213	3	216
25	Basse-Normandie	61	2	13	167	La Ferté-Frênel	693	8	701
25	Basse-Normandie	61	1	14	168	La Ferté-Macé	5936	419	6355
25	Basse-Normandie	61	2	96	169	Flers	15356	481	15837
25	Basse-Normandie	61	2	11	170	Fleuré	239	5	244
25	Basse-Normandie	61	2	35	171	Fontaine-les-Bassets	112	2	114
25	Basse-Normandie	61	1	08	172	Fontenai-les-Louvets	248	10	258
25	Basse-Normandie	61	2	39	173	Fontenai-sur-Orne	246	12	258
25	Basse-Normandie	61	2	29	174	La Forêt-Auvray	201	4	205
25	Basse-Normandie	61	1	38	175	Forges	226	11	237
25	Basse-Normandie	61	2	24	176	Francheville	155	4	159
25	Basse-Normandie	61	2	33	177	Frênes	829	25	854
25	Basse-Normandie	61	2	16	178	La Fresnaie-Fayel	54	3	57
25	Basse-Normandie	61	2	36	180	Fresnay-le-Samson	111	1	112
25	Basse-Normandie	61	2	29	179	La Fresnaye-au-Sauvage	225	3	228
25	Basse-Normandie	61	2	16	181	Gacé	2102	66	2168
25	Basse-Normandie	61	1	02	182	Gandelain	414	7	421
25	Basse-Normandie	61	1	09	183	Gâprée	138	1	139
25	Basse-Normandie	61	2	13	184	Gauville	593	13	606
25	Basse-Normandie	61	3	32	185	Gémages	119	0	119
25	Basse-Normandie	61	1	17	186	Geneslay	280	6	286
25	Basse-Normandie	61	3	25	187	Les Genettes	176	5	181
25	Basse-Normandie	61	2	21	188	La Genevraie	100	4	104
25	Basse-Normandie	61	2	29	189	Giel-Courteilles	464	216	680
25	Basse-Normandie	61	2	12	190	Ginai	79	1	80
25	Basse-Normandie	61	2	13	191	Glos-la-Ferrière	561	13	574
25	Basse-Normandie	61	1	09	192	Godisson	114	2	116
25	Basse-Normandie	61	2	13	193	La Gonfrière	289	9	298
25	Basse-Normandie	61	2	11	194	Goulet	371	8	379
25	Basse-Normandie	61	2	07	195	Le Grais	210	6	216
25	Basse-Normandie	61	3	06	196	Le Gué-de-la-Chaîne	769	18	787
25	Basse-Normandie	61	2	35	197	Guêprei	149	7	156
25	Basse-Normandie	61	2	36	198	Guerquesalles	130	6	136
25	Basse-Normandie	61	2	29	199	Habloville	326	4	330
25	Basse-Normandie	61	1	17	200	Haleine	256	71	327
25	Basse-Normandie	61	1	10	201	La Haute-Chapelle	598	18	616
25	Basse-Normandie	61	1	20	202	Hauterive	489	6	495
25	Basse-Normandie	61	1	02	203	Héloup	1013	37	1050
25	Basse-Normandie	61	3	32	204	L; Hermitière	266	7	273
25	Basse-Normandie	61	2	13	205	Heugon	228	6	234
25	Basse-Normandie	61	3	19	206	L; Hôme-Chamondot	227	3	230
25	Basse-Normandie	61	3	06	207	Igé	687	16	703
25	Basse-Normandie	61	3	18	208	Irai	572	17	589
25	Basse-Normandie	61	1	08	209	Joué-du-Bois	428	5	433
25	Basse-Normandie	61	2	11	210	Joué-du-Plain	260	8	268
25	Basse-Normandie	61	1	17	211	Juvigny-sous-Andaine	1042	43	1085
25	Basse-Normandie	61	2	03	212	Juvigny-sur-Orne	111	2	113
25	Basse-Normandie	61	1	02	213	Lalacelle	281	6	287
25	Basse-Normandie	61	1	20	215	Laleu	369	3	372
25	Basse-Normandie	61	1	08	216	La Lande-de-Goult	147	8	155
25	Basse-Normandie	61	2	07	217	La Lande-de-Lougé	48	0	48
25	Basse-Normandie	61	2	40	218	La Lande-Patry	1795	39	1834
25	Basse-Normandie	61	2	04	219	La Lande-Saint-Siméon	147	3	150
25	Basse-Normandie	61	3	19	220	La Lande-sur-Eure	169	12	181
25	Basse-Normandie	61	2	40	221	Landigou	499	12	511
25	Basse-Normandie	61	2	40	222	Landisacq	771	25	796
25	Basse-Normandie	61	2	33	223	Larchamp	318	4	322
25	Basse-Normandie	61	1	38	224	Larré	416	15	431
25	Basse-Normandie	61	2	21	225	Lignères	26	1	27
25	Basse-Normandie	61	3	34	226	Lignerolles	167	1	168
25	Basse-Normandie	61	2	07	227	Lignou	137	3	140
25	Basse-Normandie	61	1	08	228	Livaie	194	2	196
25	Basse-Normandie	61	3	23	229	Loisail	131	3	134
25	Basse-Normandie	61	3	19	230	Longny-au-Perche	1540	32	1572
25	Basse-Normandie	61	1	08	231	Longuenoë	118	3	121
25	Basse-Normandie	61	1	10	232	Lonlay-l;Abbaye	1222	26	1248
25	Basse-Normandie	61	1	14	233	Lonlay-le-Tesson	246	7	253
25	Basse-Normandie	61	1	02	234	Lonrai	1036	30	1066
25	Basse-Normandie	61	1	17	235	Loré	149	5	154
25	Basse-Normandie	61	2	11	236	Loucé	111	4	115
25	Basse-Normandie	61	2	07	237	Lougé-sur-Maire	371	3	374
25	Basse-Normandie	61	2	35	238	Louvières-en-Auge	85	1	86
25	Basse-Normandie	61	1	17	239	Lucé	80	0	80
25	Basse-Normandie	61	1	31	240	Macé	483	7	490
25	Basse-Normandie	61	3	30	241	La Madeleine-Bouvet	409	6	415
25	Basse-Normandie	61	3	19	242	Le Mage	244	5	249
25	Basse-Normandie	61	1	14	243	Magny-le-Désert	1465	50	1515
25	Basse-Normandie	61	3	25	244	Mahéru	254	10	264
25	Basse-Normandie	61	3	30	245	Maison-Maugis	56	0	56
25	Basse-Normandie	61	3	32	246	Mâle	769	20	789
25	Basse-Normandie	61	3	19	247	Malétable	101	2	103
25	Basse-Normandie	61	1	27	248	Mantilly	564	14	578
25	Basse-Normandie	61	2	24	249	Marcei	207	4	211
25	Basse-Normandie	61	3	19	250	Marchainville	203	6	209
25	Basse-Normandie	61	1	20	251	Marchemaisons	153	3	156
25	Basse-Normandie	61	2	16	252	Mardilly	130	1	131
25	Basse-Normandie	61	2	24	253	Marmouillé	179	1	180
25	Basse-Normandie	61	3	23	255	Mauves-sur-Huisne	616	27	643
25	Basse-Normandie	61	2	24	256	Médavy	149	1	150
25	Basse-Normandie	61	1	14	257	Méhoudin	110	2	112
25	Basse-Normandie	61	1	20	258	Le Mêle-sur-Sarthe	771	16	787
25	Basse-Normandie	61	3	25	259	Le Ménil-Bérard	69	3	72
25	Basse-Normandie	61	1	20	261	Le Ménil-Broût	174	4	178
25	Basse-Normandie	61	2	33	262	Le Ménil-Ciboult	119	6	125
25	Basse-Normandie	61	2	07	260	Le Ménil-de-Briouze	542	16	558
25	Basse-Normandie	61	1	20	263	Ménil-Erreux	241	2	243
25	Basse-Normandie	61	2	21	264	Ménil-Froger	65	1	66
25	Basse-Normandie	61	2	29	265	Ménil-Gondouin	168	5	173
25	Basse-Normandie	61	1	09	266	Le Ménil-Guyon	89	0	89
25	Basse-Normandie	61	2	29	267	Ménil-Hermei	215	4	219
25	Basse-Normandie	61	2	16	268	Ménil-Hubert-en-Exmes	116	2	118
25	Basse-Normandie	61	2	04	269	Ménil-Hubert-sur-Orne	412	4	416
25	Basse-Normandie	61	2	29	270	Ménil-Jean	128	3	131
25	Basse-Normandie	61	1	08	271	Le Ménil-Scelleur	112	1	113
25	Basse-Normandie	61	2	21	272	Le Ménil-Vicomte	41	1	42
25	Basse-Normandie	61	2	29	273	Ménil-Vin	61	0	61
25	Basse-Normandie	61	3	19	274	Les Menus	197	3	200
25	Basse-Normandie	61	2	21	275	Le Merlerault	906	21	927
25	Basse-Normandie	61	2	35	276	Merri	153	2	155
25	Basse-Normandie	61	3	05	277	La Mesnière	315	1	316
25	Basse-Normandie	61	2	22	278	Messei	1964	67	2031
25	Basse-Normandie	61	1	02	279	Mieuxcé	607	24	631
25	Basse-Normandie	61	3	19	280	Monceaux-au-Perche	82	1	83
25	Basse-Normandie	61	2	33	281	Moncy	248	8	256
25	Basse-Normandie	61	2	13	282	Monnai	226	2	228
25	Basse-Normandie	61	2	35	289	Mont-Ormel	59	1	60
25	Basse-Normandie	61	2	35	283	Montabard	302	7	309
25	Basse-Normandie	61	1	09	284	Montchevrel	234	2	236
25	Basse-Normandie	61	2	11	285	Montgaroult	375	11	386
25	Basse-Normandie	61	3	28	286	Montgaudry	102	7	109
25	Basse-Normandie	61	2	15	287	Montilly-sur-Noireau	740	30	770
25	Basse-Normandie	61	2	24	288	Montmerrei	496	10	506
25	Basse-Normandie	61	2	07	290	Montreuil-au-Houlme	121	3	124
25	Basse-Normandie	61	2	35	291	Montreuil-la-Cambe	82	1	83
25	Basse-Normandie	61	2	33	292	Montsecret	573	11	584
25	Basse-Normandie	61	3	23	293	Mortagne-au-Perche	4093	288	4381
25	Basse-Normandie	61	2	24	294	Mortrée	1051	11	1062
25	Basse-Normandie	61	1	08	295	La Motte-Fouquet	169	3	172
25	Basse-Normandie	61	3	19	296	Moulicent	290	2	292
25	Basse-Normandie	61	3	25	297	Moulins-la-Marche	775	9	784
25	Basse-Normandie	61	2	39	298	Moulins-sur-Orne	313	14	327
25	Basse-Normandie	61	3	34	299	Moussonvilliers	225	2	227
25	Basse-Normandie	61	3	30	300	Moutiers-au-Perche	436	14	450
25	Basse-Normandie	61	1	31	301	Neauphe-sous-Essai	204	4	208
25	Basse-Normandie	61	2	35	302	Neauphe-sur-Dive	143	0	143
25	Basse-Normandie	61	2	35	303	Nécy	507	6	513
25	Basse-Normandie	61	1	20	304	Neuilly-le-Bisson	280	4	284
25	Basse-Normandie	61	3	19	305	Neuilly-sur-Eure	592	12	604
25	Basse-Normandie	61	1	31	306	Neuville-près-Sées	134	1	135
25	Basse-Normandie	61	2	16	307	Neuville-sur-Touques	252	4	256
25	Basse-Normandie	61	2	29	308	Neuvy-au-Houlme	235	6	241
25	Basse-Normandie	61	3	26	309	Nocé	825	18	843
25	Basse-Normandie	61	2	21	310	Nonant-le-Pin	531	27	558
25	Basse-Normandie	61	3	34	311	Normandel	94	1	95
25	Basse-Normandie	61	2	04	313	Notre-Dame-du-Rocher	63	1	64
25	Basse-Normandie	61	2	39	314	Occagnes	606	20	626
25	Basse-Normandie	61	2	12	315	Omméel	125	1	126
25	Basse-Normandie	61	2	35	316	Ommoy	113	1	114
25	Basse-Normandie	61	2	16	317	Orgères	175	5	180
25	Basse-Normandie	61	3	06	318	Origny-le-Butin	120	2	122
25	Basse-Normandie	61	3	06	319	Origny-le-Roux	283	13	296
25	Basse-Normandie	61	2	36	320	Orville	102	0	102
25	Basse-Normandie	61	1	02	321	Pacé	383	8	391
25	Basse-Normandie	61	3	28	322	Parfondeval	108	1	109
25	Basse-Normandie	61	3	19	323	Le Pas-Saint-l;Homer	127	2	129
25	Basse-Normandie	61	1	27	324	Passais	802	27	829
25	Basse-Normandie	61	3	28	325	La Perrière	270	6	276
25	Basse-Normandie	61	1	17	326	Perrou	397	16	413
25	Basse-Normandie	61	3	28	327	Pervenchères	376	12	388
25	Basse-Normandie	61	2	12	328	Le Pin-au-Haras	347	5	352
25	Basse-Normandie	61	3	28	329	Le Pin-la-Garenne	694	8	702
25	Basse-Normandie	61	2	21	330	Planches	190	5	195
25	Basse-Normandie	61	1	09	331	Le Plantis	156	0	156
25	Basse-Normandie	61	2	07	332	Pointel	305	43	348
25	Basse-Normandie	61	2	36	333	Pontchardon	234	2	236
25	Basse-Normandie	61	3	34	335	La Poterie-au-Perche	159	3	162
25	Basse-Normandie	61	3	06	336	Pouvrai	112	4	116
25	Basse-Normandie	61	3	26	337	Préaux-du-Perche	543	22	565
25	Basse-Normandie	61	3	34	338	Prépotin	125	2	127
25	Basse-Normandie	61	2	29	339	Putanges-Pont-Écrepin	1026	19	1045
25	Basse-Normandie	61	2	29	340	Rabodanges	138	4	142
25	Basse-Normandie	61	1	38	341	Radon	1054	25	1079
25	Basse-Normandie	61	3	37	342	Rai	1552	38	1590
25	Basse-Normandie	61	3	34	343	Randonnai	826	7	833
25	Basse-Normandie	61	2	11	344	Rânes	1081	24	1105
25	Basse-Normandie	61	3	30	345	Rémalard	1291	26	1317
25	Basse-Normandie	61	2	36	346	Le Renouard	189	10	199
25	Basse-Normandie	61	2	16	347	Résenlieu	205	6	211
25	Basse-Normandie	61	3	23	348	Réveillon	359	13	372
25	Basse-Normandie	61	2	29	349	Ri	166	3	169
25	Basse-Normandie	61	1	02	350	La Roche-Mabile	161	1	162
25	Basse-Normandie	61	2	36	351	Roiville	135	0	135
25	Basse-Normandie	61	2	29	352	Rônai	159	6	165
25	Basse-Normandie	61	2	04	353	Ronfeugerai	334	5	339
25	Basse-Normandie	61	2	29	354	Les Rotours	100	3	103
25	Basse-Normandie	61	1	10	355	Rouellé	202	4	206
25	Basse-Normandie	61	3	32	356	La Rouge	660	13	673
25	Basse-Normandie	61	1	08	357	Rouperroux	162	6	168
25	Basse-Normandie	61	2	03	358	Sai	219	12	231
25	Basse-Normandie	61	3	32	359	Saint-Agnan-sur-Erre	167	4	171
25	Basse-Normandie	61	1	09	360	Saint-Agnan-sur-Sarthe	118	4	122
25	Basse-Normandie	61	2	07	361	Saint-André-de-Briouze	188	4	192
25	Basse-Normandie	61	2	22	362	Saint-André-de-Messei	541	29	570
25	Basse-Normandie	61	3	25	363	Saint-Aquilin-de-Corbion	66	1	67
25	Basse-Normandie	61	2	29	364	Saint-Aubert-sur-Orne	114	2	116
25	Basse-Normandie	61	1	20	365	Saint-Aubin-d;Appenai	386	13	399
25	Basse-Normandie	61	2	36	366	Saint-Aubin-de-Bonneval	154	2	156
25	Basse-Normandie	61	3	05	367	Saint-Aubin-de-Courteraie	140	5	145
25	Basse-Normandie	61	3	26	368	Saint-Aubin-des-Grois	64	0	64
25	Basse-Normandie	61	1	10	369	Saint-Bômer-les-Forges	1040	29	1069
25	Basse-Normandie	61	1	10	370	Saint-Brice	168	2	170
25	Basse-Normandie	61	2	11	371	Saint-Brice-sous-Rânes	169	1	170
25	Basse-Normandie	61	1	02	372	Saint-Céneri-le-Gérei	126	3	129
25	Basse-Normandie	61	2	33	374	Saint-Christophe-de-Chaulieu	112	2	114
25	Basse-Normandie	61	2	24	375	Saint-Christophe-le-Jajolet	240	8	248
25	Basse-Normandie	61	1	10	376	Saint-Clair-de-Halouze	866	27	893
25	Basse-Normandie	61	2	33	377	Saint-Cornier-des-Landes	673	17	690
25	Basse-Normandie	61	3	26	379	Saint-Cyr-la-Rosière	260	3	263
25	Basse-Normandie	61	1	17	380	Saint-Denis-de-Villenette	147	2	149
25	Basse-Normandie	61	3	23	381	Saint-Denis-sur-Huisne	61	2	63
25	Basse-Normandie	61	1	02	382	Saint-Denis-sur-Sarthon	1145	18	1163
25	Basse-Normandie	61	1	08	383	Saint-Didier-sous-Écouves	160	3	163
25	Basse-Normandie	61	1	08	384	Saint-Ellier-les-Bois	258	5	263
25	Basse-Normandie	61	2	16	385	Saint-Evroult-de-Montfort	329	5	334
25	Basse-Normandie	61	2	13	386	Saint-Evroult-Notre-Dame-du-Bois	455	28	483
25	Basse-Normandie	61	1	27	387	Saint-Fraimbault	601	25	626
25	Basse-Normandie	61	3	06	388	Saint-Fulgent-des-Ormes	171	5	176
25	Basse-Normandie	61	2	07	390	Saint-Georges-d;Annebecq	141	8	149
25	Basse-Normandie	61	2	15	391	Saint-Georges-des-Groseillers	3270	155	3425
25	Basse-Normandie	61	2	36	392	Saint-Germain-d;Aunay	173	3	176
25	Basse-Normandie	61	2	21	393	Saint-Germain-de-Clairefeuille	160	4	164
25	Basse-Normandie	61	3	32	394	Saint-Germain-de-la-Coudre	839	22	861
25	Basse-Normandie	61	3	05	396	Saint-Germain-de-Martigny	102	1	103
25	Basse-Normandie	61	3	30	395	Saint-Germain-des-Grois	228	3	231
25	Basse-Normandie	61	1	02	397	Saint-Germain-du-Corbéis	3816	154	3970
25	Basse-Normandie	61	1	09	398	Saint-Germain-le-Vieux	55	2	57
25	Basse-Normandie	61	2	35	399	Saint-Gervais-des-Sablons	65	0	65
25	Basse-Normandie	61	1	31	400	Saint-Gervais-du-Perron	355	7	362
25	Basse-Normandie	61	1	10	401	Saint-Gilles-des-Marais	102	2	104
25	Basse-Normandie	61	2	07	402	Saint-Hilaire-de-Briouze	294	4	298
25	Basse-Normandie	61	1	31	403	Saint-Hilaire-la-Gérard	105	3	108
25	Basse-Normandie	61	3	23	404	Saint-Hilaire-le-Châtel	698	37	735
25	Basse-Normandie	61	3	32	405	Saint-Hilaire-sur-Erre	567	20	587
25	Basse-Normandie	61	3	25	406	Saint-Hilaire-sur-Risle	321	7	328
25	Basse-Normandie	61	3	26	409	Saint-Jean-de-la-Forêt	144	4	148
25	Basse-Normandie	61	2	33	410	Saint-Jean-des-Bois	180	9	189
25	Basse-Normandie	61	3	28	411	Saint-Jouin-de-Blavou	297	12	309
25	Basse-Normandie	61	3	28	412	Saint-Julien-sur-Sarthe	666	12	678
25	Basse-Normandie	61	2	35	413	Saint-Lambert-sur-Dive	144	1	145
25	Basse-Normandie	61	3	23	414	Saint-Langis-lès-Mortagne	906	25	931
25	Basse-Normandie	61	1	20	415	Saint-Léger-sur-Sarthe	341	5	346
25	Basse-Normandie	61	1	09	416	Saint-Léonard-des-Parcs	71	4	75
25	Basse-Normandie	61	2	24	417	Saint-Loyer-des-Champs	405	4	409
25	Basse-Normandie	61	3	23	418	Saint-Mard-de-Réno	426	11	437
25	Basse-Normandie	61	1	27	421	Saint-Mars-d;Égrenne	682	18	700
25	Basse-Normandie	61	3	18	423	Saint-Martin-d;Écublei	610	9	619
25	Basse-Normandie	61	1	08	424	Saint-Martin-des-Landes	203	9	212
25	Basse-Normandie	61	3	25	425	Saint-Martin-des-Pézerits	115	2	117
25	Basse-Normandie	61	3	06	426	Saint-Martin-du-Vieux-Bellême	629	16	645
25	Basse-Normandie	61	1	08	427	Saint-Martin-l;Aiguillon	195	1	196
25	Basse-Normandie	61	1	14	428	Saint-Maurice-du-Désert	692	30	722
25	Basse-Normandie	61	3	34	429	Saint-Maurice-lès-Charencey	582	23	605
25	Basse-Normandie	61	3	26	430	Saint-Maurice-sur-Huisne	70	1	71
25	Basse-Normandie	61	1	14	431	Saint-Michel-des-Andaines	348	13	361
25	Basse-Normandie	61	3	18	432	Saint-Michel-Tuboeuf	551	11	562
25	Basse-Normandie	61	2	13	435	Saint-Nicolas-de-Sommaire	274	5	279
25	Basse-Normandie	61	1	02	433	Saint-Nicolas-des-Bois	252	7	259
25	Basse-Normandie	61	2	13	434	Saint-Nicolas-des-Laitiers	96	2	98
25	Basse-Normandie	61	3	06	437	Saint-Ouen-de-la-Cour	62	3	65
25	Basse-Normandie	61	3	05	438	Saint-Ouen-de-Sécherouvre	189	0	189
25	Basse-Normandie	61	1	08	439	Saint-Ouen-le-Brisoult	138	7	145
25	Basse-Normandie	61	3	18	440	Saint-Ouen-sur-Iton	920	19	939
25	Basse-Normandie	61	2	11	441	Saint-Ouen-sur-Maire	104	3	107
25	Basse-Normandie	61	1	08	442	Saint-Patrice-du-Désert	198	4	202
25	Basse-Normandie	61	2	40	443	Saint-Paul	658	24	682
25	Basse-Normandie	61	2	29	444	Saint-Philbert-sur-Orne	118	1	119
25	Basse-Normandie	61	2	33	445	Saint-Pierre-d;Entremont	707	20	727
25	Basse-Normandie	61	3	25	446	Saint-Pierre-des-Loges	165	3	168
25	Basse-Normandie	61	2	04	447	Saint-Pierre-du-Regard	1311	23	1334
25	Basse-Normandie	61	3	26	448	Saint-Pierre-la-Bruyère	418	11	429
25	Basse-Normandie	61	2	12	449	Saint-Pierre-la-Rivière	170	0	170
25	Basse-Normandie	61	3	28	450	Saint-Quentin-de-Blavou	73	3	76
25	Basse-Normandie	61	2	33	451	Saint-Quentin-les-Chardonnets	286	8	294
25	Basse-Normandie	61	1	27	452	Saint-Roch-sur-Égrenne	200	1	201
25	Basse-Normandie	61	1	08	453	Saint-Sauveur-de-Carrouges	266	12	278
25	Basse-Normandie	61	1	27	455	Saint-Siméon	275	7	282
25	Basse-Normandie	61	3	18	456	Saint-Sulpice-sur-Risle	1666	71	1737
25	Basse-Normandie	61	3	37	457	Saint-Symphorien-des-Bruyères	489	22	511
25	Basse-Normandie	61	3	19	458	Saint-Victor-de-Réno	202	4	206
25	Basse-Normandie	61	3	05	373	Sainte-Céronne-lès-Mortagne	290	15	305
25	Basse-Normandie	61	2	29	378	Sainte-Croix-sur-Orne	81	4	85
25	Basse-Normandie	61	2	21	389	Sainte-Gauburge-Sainte-Colombe	1135	17	1152
25	Basse-Normandie	61	2	04	407	Sainte-Honorine-la-Chardonne	718	22	740
25	Basse-Normandie	61	2	29	408	Sainte-Honorine-la-Guillaume	362	5	367
25	Basse-Normandie	61	1	08	419	Sainte-Marguerite-de-Carrouges	217	4	221
25	Basse-Normandie	61	1	08	420	Sainte-Marie-la-Robert	78	3	81
25	Basse-Normandie	61	2	07	436	Sainte-Opportune	239	4	243
25	Basse-Normandie	61	1	09	454	Sainte-Scolasse-sur-Sarthe	550	12	562
25	Basse-Normandie	61	2	22	459	Saires-la-Verrerie	279	4	283
25	Basse-Normandie	61	2	36	460	Le Sap	947	21	968
25	Basse-Normandie	61	2	16	461	Le Sap-André	132	3	135
25	Basse-Normandie	61	2	39	462	Sarceaux	901	32	933
25	Basse-Normandie	61	1	14	463	La Sauvagère	952	10	962
25	Basse-Normandie	61	1	31	464	Sées	4446	419	4865
25	Basse-Normandie	61	2	04	465	Ségrie-Fontaine	410	16	426
25	Basse-Normandie	61	2	40	466	La Selle-la-Forge	1348	41	1389
25	Basse-Normandie	61	1	38	467	Semallé	400	16	416
25	Basse-Normandie	61	2	11	468	Sentilly	139	3	142
25	Basse-Normandie	61	1	17	469	Sept-Forges	294	5	299
25	Basse-Normandie	61	2	11	470	Serans	204	9	213
25	Basse-Normandie	61	3	06	471	Sérigny	387	8	395
25	Basse-Normandie	61	2	03	472	Sévigny	323	12	335
25	Basse-Normandie	61	2	11	473	Sevrai	239	7	246
25	Basse-Normandie	61	2	12	474	Silly-en-Gouffern	421	11	432
25	Basse-Normandie	61	3	05	475	Soligny-la-Trappe	714	18	732
25	Basse-Normandie	61	3	28	476	Suré	269	11	280
25	Basse-Normandie	61	2	12	477	Survie	148	6	154
25	Basse-Normandie	61	2	04	478	Taillebois	139	3	142
25	Basse-Normandie	61	2	11	479	Tanques	165	5	170
25	Basse-Normandie	61	1	31	480	Tanville	259	5	264
25	Basse-Normandie	61	1	09	481	Tellières-le-Plessis	78	0	78
25	Basse-Normandie	61	1	17	482	Tessé-Froulay	377	22	399
25	Basse-Normandie	61	3	32	484	Le Theil	1858	34	1892
25	Basse-Normandie	61	2	36	485	Ticheville	224	10	234
25	Basse-Normandie	61	2	33	486	Tinchebray	2571	108	2679
25	Basse-Normandie	61	1	27	487	Torchamp	293	1	294
25	Basse-Normandie	61	2	13	488	Touquettes	83	2	85
25	Basse-Normandie	61	2	04	489	Les Tourailles	71	3	74
25	Basse-Normandie	61	2	35	490	Tournai-sur-Dive	318	5	323
25	Basse-Normandie	61	3	34	491	Tourouvre	1624	13	1637
25	Basse-Normandie	61	1	09	492	Trémont	111	0	111
25	Basse-Normandie	61	2	16	493	La Trinité-des-Laitiers	91	2	93
25	Basse-Normandie	61	2	35	494	Trun	1313	69	1382
25	Basse-Normandie	61	2	03	496	Urou-et-Crennes	792	22	814
25	Basse-Normandie	61	1	38	497	Valframbert	1551	42	1593
25	Basse-Normandie	61	3	06	498	Vaunoise	110	1	111
25	Basse-Normandie	61	1	20	499	Les Ventes-de-Bourse	146	3	149
25	Basse-Normandie	61	3	34	500	La Ventrouze	127	3	130
25	Basse-Normandie	61	3	26	501	Verrières	400	16	416
25	Basse-Normandie	61	3	28	502	Vidai	78	1	79
25	Basse-Normandie	61	2	11	503	Vieux-Pont	209	4	213
25	Basse-Normandie	61	2	12	504	Villebadin	138	3	141
25	Basse-Normandie	61	2	35	505	Villedieu-lès-Bailleul	231	8	239
25	Basse-Normandie	61	2	13	506	Villers-en-Ouche	351	2	353
25	Basse-Normandie	61	3	23	507	Villiers-sous-Mortagne	326	2	328
25	Basse-Normandie	61	2	36	508	Vimoutiers	3807	131	3938
25	Basse-Normandie	61	1	38	509	Vingt-Hanaps	460	12	472
25	Basse-Normandie	61	3	18	510	Vitrai-sous-Laigle	221	6	227
25	Basse-Normandie	61	2	24	511	Vrigny	343	10	353
25	Basse-Normandie	61	2	07	512	Les Yveteaux	111	5	116
25	Basse-Normandie	61	2	33	513	Yvrandes	163	2	165
31	Nord-Pas-de-Calais	62	1	45	001	Ablain-Saint-Nazaire	1791	46	1837
31	Nord-Pas-de-Calais	62	1	20	002	Ablainzevelle	200	3	203
31	Nord-Pas-de-Calais	62	1	45	003	Acheville	608	9	617
31	Nord-Pas-de-Calais	62	1	04	004	Achicourt	7705	138	7843
31	Nord-Pas-de-Calais	62	1	09	005	Achiet-le-Grand	1068	12	1080
31	Nord-Pas-de-Calais	62	1	09	006	Achiet-le-Petit	339	2	341
31	Nord-Pas-de-Calais	62	1	71	007	Acq	552	8	560
31	Nord-Pas-de-Calais	62	5	34	008	Acquin-Westbécourt	684	19	703
31	Nord-Pas-de-Calais	62	1	10	009	Adinfer	237	6	243
31	Nord-Pas-de-Calais	62	5	34	010	Affringues	217	8	225
31	Nord-Pas-de-Calais	62	1	10	011	Agnez-lès-Duisans	675	21	696
31	Nord-Pas-de-Calais	62	1	05	012	Agnières	236	6	242
31	Nord-Pas-de-Calais	62	1	04	013	Agny	1958	42	2000
31	Nord-Pas-de-Calais	62	5	01	014	Aire-sur-la-Lys	9861	303	10164
31	Nord-Pas-de-Calais	62	4	69	015	Airon-Notre-Dame	197	10	207
31	Nord-Pas-de-Calais	62	4	69	016	Airon-Saint-Vaast	200	8	208
31	Nord-Pas-de-Calais	62	4	29	017	Aix-en-Ergny	176	0	176
31	Nord-Pas-de-Calais	62	4	18	018	Aix-en-Issart	274	8	282
31	Nord-Pas-de-Calais	62	7	77	019	Aix-Noulette	3843	58	3901
31	Nord-Pas-de-Calais	62	6	25	020	Alembon	604	5	609
31	Nord-Pas-de-Calais	62	4	29	021	Alette	356	1	357
31	Nord-Pas-de-Calais	62	3	21	022	Alincthun	339	9	348
31	Nord-Pas-de-Calais	62	2	53	023	Allouagne	3066	53	3119
31	Nord-Pas-de-Calais	62	5	34	024	Alquines	865	12	877
31	Nord-Pas-de-Calais	62	3	36	025	Ambleteuse	1912	32	1944
31	Nord-Pas-de-Calais	62	4	24	026	Ambricourt	131	0	131
31	Nord-Pas-de-Calais	62	1	05	027	Ambrines	226	1	227
31	Nord-Pas-de-Calais	62	2	63	028	Ames	621	9	630
31	Nord-Pas-de-Calais	62	2	63	029	Amettes	502	0	502
31	Nord-Pas-de-Calais	62	1	40	030	Amplier	318	3	321
31	Nord-Pas-de-Calais	62	6	25	031	Andres	1515	16	1531
31	Nord-Pas-de-Calais	62	7	60	032	Angres	3999	73	4072
31	Nord-Pas-de-Calais	62	7	49	033	Annay	4267	31	4298
31	Nord-Pas-de-Calais	62	2	17	034	Annequin	2366	18	2384
31	Nord-Pas-de-Calais	62	2	12	035	Annezin	5683	56	5739
31	Nord-Pas-de-Calais	62	1	27	036	Anvin	789	23	812
31	Nord-Pas-de-Calais	62	1	71	037	Anzin-Saint-Aubin	2697	100	2797
31	Nord-Pas-de-Calais	62	5	02	038	Ardres	4223	69	4292
31	Nord-Pas-de-Calais	62	1	45	039	Arleux-en-Gohelle	825	21	846
31	Nord-Pas-de-Calais	62	5	62	040	Arques	9991	172	10163
31	Nord-Pas-de-Calais	62	1	96	041	Arras	41611	1678	43289
31	Nord-Pas-de-Calais	62	1	03	042	Athies	1015	17	1032
31	Nord-Pas-de-Calais	62	6	16	043	Les Attaques	1979	24	2003
31	Nord-Pas-de-Calais	62	4	22	044	Attin	695	18	713
31	Nord-Pas-de-Calais	62	1	05	045	Aubigny-en-Artois	1384	34	1418
31	Nord-Pas-de-Calais	62	4	26	046	Aubin-Saint-Vaast	748	12	760
31	Nord-Pas-de-Calais	62	1	07	047	Aubrometz	142	2	144
31	Nord-Pas-de-Calais	62	2	63	048	Auchel	11031	85	11116
31	Nord-Pas-de-Calais	62	2	38	049	Auchy-au-Bois	464	3	467
31	Nord-Pas-de-Calais	62	4	39	050	Auchy-lès-Hesdin	1698	21	1719
31	Nord-Pas-de-Calais	62	2	17	051	Auchy-les-Mines	4467	23	4490
31	Nord-Pas-de-Calais	62	3	36	052	Audembert	415	25	440
31	Nord-Pas-de-Calais	62	5	23	053	Audincthun	658	13	671
31	Nord-Pas-de-Calais	62	3	36	054	Audinghen	589	10	599
31	Nord-Pas-de-Calais	62	5	02	055	Audrehem	484	2	486
31	Nord-Pas-de-Calais	62	3	36	056	Audresselles	710	4	714
31	Nord-Pas-de-Calais	62	5	06	057	Audruicq	4892	57	4949
31	Nord-Pas-de-Calais	62	1	27	058	Aumerval	198	0	198
31	Nord-Pas-de-Calais	62	5	02	059	Autingues	298	11	309
31	Nord-Pas-de-Calais	62	1	07	060	Auxi-le-Château	2898	54	2952
31	Nord-Pas-de-Calais	62	1	05	061	Averdoingt	268	4	272
31	Nord-Pas-de-Calais	62	4	29	062	Avesnes	36	0	36
31	Nord-Pas-de-Calais	62	1	08	063	Avesnes-le-Comte	2089	35	2124
31	Nord-Pas-de-Calais	62	1	09	064	Avesnes-lès-Bapaume	133	5	138
31	Nord-Pas-de-Calais	62	7	52	065	Avion	17271	158	17429
31	Nord-Pas-de-Calais	62	4	24	066	Avondance	44	0	44
31	Nord-Pas-de-Calais	62	5	23	067	Avroult	546	9	555
31	Nord-Pas-de-Calais	62	1	20	068	Ayette	320	4	324
31	Nord-Pas-de-Calais	62	4	39	069	Azincourt	307	6	313
31	Nord-Pas-de-Calais	62	1	05	070	Bailleul-aux-Cornailles	265	5	270
31	Nord-Pas-de-Calais	62	1	27	071	Bailleul-lès-Pernes	383	7	390
31	Nord-Pas-de-Calais	62	1	45	073	Bailleul-Sir-Berthoult	1257	27	1284
31	Nord-Pas-de-Calais	62	1	10	072	Bailleulmont	257	3	260
31	Nord-Pas-de-Calais	62	1	10	074	Bailleulval	273	6	279
31	Nord-Pas-de-Calais	62	3	14	075	Baincthun	1347	42	1389
31	Nord-Pas-de-Calais	62	3	21	076	Bainghen	169	2	171
31	Nord-Pas-de-Calais	62	1	05	077	Bajus	321	4	325
31	Nord-Pas-de-Calais	62	5	02	078	Balinghem	1126	7	1133
31	Nord-Pas-de-Calais	62	1	09	079	Bancourt	78	0	78
31	Nord-Pas-de-Calais	62	1	09	080	Bapaume	4115	238	4353
31	Nord-Pas-de-Calais	62	1	35	081	Baralle	482	6	488
31	Nord-Pas-de-Calais	62	1	11	082	Barastre	251	7	258
31	Nord-Pas-de-Calais	62	2	64	083	Barlin	7551	42	7593
31	Nord-Pas-de-Calais	62	1	08	084	Barly	227	6	233
31	Nord-Pas-de-Calais	62	1	10	085	Basseux	139	7	146
31	Nord-Pas-de-Calais	62	1	08	086	Bavincourt	368	13	381
31	Nord-Pas-de-Calais	62	5	02	087	Bayenghem-lès-Éperlecques	922	14	936
31	Nord-Pas-de-Calais	62	5	34	088	Bayenghem-lès-Seninghem	331	3	334
31	Nord-Pas-de-Calais	62	3	36	089	Bazinghen	423	5	428
31	Nord-Pas-de-Calais	62	4	39	090	Béalencourt	114	4	118
31	Nord-Pas-de-Calais	62	1	08	091	Beaudricourt	99	2	101
31	Nord-Pas-de-Calais	62	1	08	092	Beaufort-Blavincourt	430	5	435
31	Nord-Pas-de-Calais	62	1	09	093	Beaulencourt	223	2	225
31	Nord-Pas-de-Calais	62	4	37	094	Beaumerie-Saint-Martin	376	10	386
31	Nord-Pas-de-Calais	62	5	23	095	Beaumetz-lès-Aire	224	1	225
31	Nord-Pas-de-Calais	62	1	11	096	Beaumetz-lès-Cambrai	584	9	593
31	Nord-Pas-de-Calais	62	1	10	097	Beaumetz-lès-Loges	965	14	979
31	Nord-Pas-de-Calais	62	1	04	099	Beaurains	5083	100	5183
31	Nord-Pas-de-Calais	62	4	18	100	Beaurainville	1950	34	1984
31	Nord-Pas-de-Calais	62	1	07	881	Beauvoir-Wavans	389	8	397
31	Nord-Pas-de-Calais	62	1	43	101	Beauvois	139	1	140
31	Nord-Pas-de-Calais	62	4	29	102	Bécourt	276	3	279
31	Nord-Pas-de-Calais	62	1	09	103	Béhagnies	126	1	127
31	Nord-Pas-de-Calais	62	3	21	105	Belle-et-Houllefort	539	23	562
31	Nord-Pas-de-Calais	62	3	21	104	Bellebrune	339	11	350
31	Nord-Pas-de-Calais	62	1	46	106	Bellonne	239	7	246
31	Nord-Pas-de-Calais	62	7	68	107	Bénifontaine	340	3	343
31	Nord-Pas-de-Calais	62	4	69	108	Berck	15367	416	15783
31	Nord-Pas-de-Calais	62	1	27	109	Bergueneuse	211	5	216
31	Nord-Pas-de-Calais	62	1	08	111	Berlencourt-le-Cauroy	300	81	381
31	Nord-Pas-de-Calais	62	1	10	112	Berles-au-Bois	512	6	518
31	Nord-Pas-de-Calais	62	1	05	113	Berles-Monchel	476	13	489
31	Nord-Pas-de-Calais	62	1	43	114	Bermicourt	155	2	157
31	Nord-Pas-de-Calais	62	1	10	115	Berneville	441	12	453
31	Nord-Pas-de-Calais	62	4	22	116	Bernieulles	192	7	199
31	Nord-Pas-de-Calais	62	1	11	117	Bertincourt	936	25	961
31	Nord-Pas-de-Calais	62	1	05	118	Béthonsart	170	2	172
31	Nord-Pas-de-Calais	62	2	92	119	Béthune	25655	875	26530
31	Nord-Pas-de-Calais	62	2	28	120	Beugin	446	8	454
31	Nord-Pas-de-Calais	62	1	09	121	Beugnâtre	138	0	138
31	Nord-Pas-de-Calais	62	1	11	122	Beugny	367	7	374
31	Nord-Pas-de-Calais	62	4	29	123	Beussent	511	10	521
31	Nord-Pas-de-Calais	62	4	22	124	Beutin	493	9	502
31	Nord-Pas-de-Calais	62	3	36	125	Beuvrequen	398	12	410
31	Nord-Pas-de-Calais	62	2	57	126	Beuvry	8817	165	8982
31	Nord-Pas-de-Calais	62	4	29	127	Bezinghem	357	6	363
31	Nord-Pas-de-Calais	62	1	46	128	Biache-Saint-Vaast	3907	33	3940
31	Nord-Pas-de-Calais	62	1	09	129	Biefvillers-lès-Bapaume	110	1	111
31	Nord-Pas-de-Calais	62	1	40	130	Bienvillers-au-Bois	613	8	621
31	Nord-Pas-de-Calais	62	1	09	131	Bihucourt	370	9	379
31	Nord-Pas-de-Calais	62	2	73	132	Billy-Berclau	4387	41	4428
31	Nord-Pas-de-Calais	62	7	75	133	Billy-Montigny	8163	59	8222
31	Nord-Pas-de-Calais	62	4	29	134	Bimont	128	9	137
31	Nord-Pas-de-Calais	62	1	10	135	Blairville	298	5	303
31	Nord-Pas-de-Calais	62	1	43	137	Blangerval-Blangermont	96	2	98
31	Nord-Pas-de-Calais	62	4	39	138	Blangy-sur-Ternoise	773	14	787
31	Nord-Pas-de-Calais	62	5	62	139	Blendecques	5184	133	5317
31	Nord-Pas-de-Calais	62	5	34	140	Bléquin	435	4	439
31	Nord-Pas-de-Calais	62	2	38	141	Blessy	854	9	863
31	Nord-Pas-de-Calais	62	4	39	142	Blingel	117	1	118
31	Nord-Pas-de-Calais	62	1	07	143	Boffles	47	0	47
31	Nord-Pas-de-Calais	62	1	20	144	Boiry-Becquerelle	408	10	418
31	Nord-Pas-de-Calais	62	1	46	145	Boiry-Notre-Dame	457	6	463
31	Nord-Pas-de-Calais	62	1	10	146	Boiry-Saint-Martin	289	0	289
31	Nord-Pas-de-Calais	62	1	10	147	Boiry-Sainte-Rictrude	385	9	394
31	Nord-Pas-de-Calais	62	1	45	148	Bois-Bernard	818	12	830
31	Nord-Pas-de-Calais	62	5	34	149	Boisdinghem	231	6	237
31	Nord-Pas-de-Calais	62	4	18	150	Boisjean	489	7	496
31	Nord-Pas-de-Calais	62	1	20	151	Boisleux-au-Mont	502	11	513
31	Nord-Pas-de-Calais	62	1	20	152	Boisleux-Saint-Marc	225	1	226
31	Nord-Pas-de-Calais	62	5	23	153	Bomy	600	8	608
31	Nord-Pas-de-Calais	62	1	07	154	Bonnières	648	30	678
31	Nord-Pas-de-Calais	62	5	02	155	Bonningues-lès-Ardres	683	10	693
31	Nord-Pas-de-Calais	62	6	15	156	Bonningues-lès-Calais	634	18	652
31	Nord-Pas-de-Calais	62	4	18	157	Boubers-lès-Hesmond	72	0	72
31	Nord-Pas-de-Calais	62	1	07	158	Boubers-sur-Canche	605	12	617
31	Nord-Pas-de-Calais	62	4	26	661	Bouin-Plumoison	456	7	463
31	Nord-Pas-de-Calais	62	3	97	160	Boulogne-sur-Mer	43070	735	43805
31	Nord-Pas-de-Calais	62	6	25	161	Bouquehault	702	6	708
31	Nord-Pas-de-Calais	62	2	38	162	Bourecq	571	1	572
31	Nord-Pas-de-Calais	62	1	07	163	Bouret-sur-Canche	240	11	251
31	Nord-Pas-de-Calais	62	1	35	164	Bourlon	1213	27	1240
31	Nord-Pas-de-Calais	62	3	21	165	Bournonville	221	3	224
31	Nord-Pas-de-Calais	62	1	27	166	Bours	582	7	589
31	Nord-Pas-de-Calais	62	6	25	167	Boursin	268	4	272
31	Nord-Pas-de-Calais	62	4	29	168	Bourthes	728	8	736
31	Nord-Pas-de-Calais	62	5	34	169	Bouvelinghem	245	7	252
31	Nord-Pas-de-Calais	62	7	77	170	Bouvigny-Boyeffles	2470	89	2559
31	Nord-Pas-de-Calais	62	1	27	171	Boyaval	139	0	139
31	Nord-Pas-de-Calais	62	1	20	172	Boyelles	275	6	281
31	Nord-Pas-de-Calais	62	1	46	173	Brebières	4902	51	4953
31	Nord-Pas-de-Calais	62	5	02	174	Brêmes	1296	21	1317
31	Nord-Pas-de-Calais	62	4	26	175	Brévillers	150	3	153
31	Nord-Pas-de-Calais	62	4	22	176	Bréxent-Énocq	673	18	691
31	Nord-Pas-de-Calais	62	1	43	180	Brias	308	2	310
31	Nord-Pas-de-Calais	62	4	18	177	Brimeux	787	33	820
31	Nord-Pas-de-Calais	62	2	88	178	Bruay-la-Buissière	23408	461	23869
31	Nord-Pas-de-Calais	62	3	21	179	Brunembert	377	6	383
31	Nord-Pas-de-Calais	62	1	20	181	Bucquoy	1490	86	1576
31	Nord-Pas-de-Calais	62	1	07	182	Buire-au-Bois	214	5	219
31	Nord-Pas-de-Calais	62	4	18	183	Buire-le-Sec	793	7	800
31	Nord-Pas-de-Calais	62	1	35	184	Buissy	245	3	248
31	Nord-Pas-de-Calais	62	1	20	185	Bullecourt	247	4	251
31	Nord-Pas-de-Calais	62	7	51	186	Bully-les-Mines	12337	132	12469
31	Nord-Pas-de-Calais	62	1	43	187	Buneville	173	2	175
31	Nord-Pas-de-Calais	62	2	63	188	Burbure	2983	22	3005
31	Nord-Pas-de-Calais	62	1	11	189	Bus	127	1	128
31	Nord-Pas-de-Calais	62	2	33	190	Busnes	1261	29	1290
31	Nord-Pas-de-Calais	62	6	25	191	Caffiers	719	11	730
31	Nord-Pas-de-Calais	62	1	46	192	Cagnicourt	425	1	426
31	Nord-Pas-de-Calais	62	6	98	193	Calais	73636	937	74573
31	Nord-Pas-de-Calais	62	2	72	194	Calonne-Ricouart	5759	37	5796
31	Nord-Pas-de-Calais	62	2	33	195	Calonne-sur-la-Lys	1609	28	1637
31	Nord-Pas-de-Calais	62	4	37	196	La Calotterie	645	14	659
31	Nord-Pas-de-Calais	62	2	28	197	Camblain-Châtelain	1690	17	1707
31	Nord-Pas-de-Calais	62	1	05	199	Camblain-l;Abbé	646	143	789
31	Nord-Pas-de-Calais	62	1	05	198	Cambligneul	324	11	335
31	Nord-Pas-de-Calais	62	2	17	200	Cambrin	973	17	990
31	Nord-Pas-de-Calais	62	4	22	201	Camiers	2780	40	2820
31	Nord-Pas-de-Calais	62	4	29	202	Campagne-lès-Boulonnais	615	91	706
31	Nord-Pas-de-Calais	62	6	25	203	Campagne-lès-Guines	450	18	468
31	Nord-Pas-de-Calais	62	4	18	204	Campagne-lès-Hesdin	1765	39	1804
31	Nord-Pas-de-Calais	62	5	62	205	Campagne-lès-Wardrecques	1139	30	1169
31	Nord-Pas-de-Calais	62	4	37	206	Campigneulles-les-Grandes	315	9	324
31	Nord-Pas-de-Calais	62	4	37	207	Campigneulles-les-Petites	584	29	613
31	Nord-Pas-de-Calais	62	1	08	208	Canettemont	63	1	64
31	Nord-Pas-de-Calais	62	4	24	209	Canlers	187	2	189
31	Nord-Pas-de-Calais	62	1	07	210	Canteleux	17	0	17
31	Nord-Pas-de-Calais	62	1	05	211	Capelle-Fermont	194	3	197
31	Nord-Pas-de-Calais	62	3	14	908	La Capelle-lès-Boulogne	1506	50	1556
31	Nord-Pas-de-Calais	62	4	26	212	Capelle-lès-Hesdin	463	15	478
31	Nord-Pas-de-Calais	62	1	45	213	Carency	710	10	720
31	Nord-Pas-de-Calais	62	3	44	214	Carly	568	8	576
31	Nord-Pas-de-Calais	62	7	19	215	Carvin	17152	123	17275
31	Nord-Pas-de-Calais	62	1	10	216	La Cauchie	208	0	208
31	Nord-Pas-de-Calais	62	2	63	217	Cauchy-à-la-Tour	2973	34	3007
31	Nord-Pas-de-Calais	62	2	28	218	Caucourt	325	4	329
31	Nord-Pas-de-Calais	62	4	26	219	Caumont	184	6	190
31	Nord-Pas-de-Calais	62	4	26	220	Cavron-Saint-Martin	485	16	501
31	Nord-Pas-de-Calais	62	1	05	221	Chelers	291	5	296
31	Nord-Pas-de-Calais	62	4	26	222	Chériennes	154	4	158
31	Nord-Pas-de-Calais	62	1	20	223	Chérisy	290	5	295
31	Nord-Pas-de-Calais	62	2	12	224	Chocques	2996	32	3028
31	Nord-Pas-de-Calais	62	5	41	225	Clairmarais	626	16	642
31	Nord-Pas-de-Calais	62	5	01	226	Clarques	290	6	296
31	Nord-Pas-de-Calais	62	4	29	227	Clenleu	183	11	194
31	Nord-Pas-de-Calais	62	5	02	228	Clerques	266	4	270
31	Nord-Pas-de-Calais	62	5	34	229	Cléty	672	19	691
31	Nord-Pas-de-Calais	62	3	21	230	Colembert	767	19	786
31	Nord-Pas-de-Calais	62	4	69	231	Colline-Beaumont	133	4	137
31	Nord-Pas-de-Calais	62	1	05	232	La Comté	827	12	839
31	Nord-Pas-de-Calais	62	4	69	233	Conchil-le-Temple	1045	16	1061
31	Nord-Pas-de-Calais	62	1	07	234	Conchy-sur-Canche	188	6	194
31	Nord-Pas-de-Calais	62	3	44	235	Condette	2575	98	2673
31	Nord-Pas-de-Calais	62	4	26	236	Contes	316	7	323
31	Nord-Pas-de-Calais	62	1	27	238	Conteville-en-Ternois	87	3	90
31	Nord-Pas-de-Calais	62	3	13	237	Conteville-lès-Boulogne	468	12	480
31	Nord-Pas-de-Calais	62	6	15	239	Coquelles	2291	38	2329
31	Nord-Pas-de-Calais	62	1	46	240	Corbehem	2221	22	2243
31	Nord-Pas-de-Calais	62	4	22	241	Cormont	299	7	306
31	Nord-Pas-de-Calais	62	1	40	242	Couin	103	3	106
31	Nord-Pas-de-Calais	62	1	08	243	Coullemont	106	3	109
31	Nord-Pas-de-Calais	62	6	16	244	Coulogne	5686	232	5918
31	Nord-Pas-de-Calais	62	5	34	245	Coulomby	666	4	670
31	Nord-Pas-de-Calais	62	4	24	246	Coupelle-Neuve	215	3	218
31	Nord-Pas-de-Calais	62	4	24	247	Coupelle-Vieille	553	2	555
31	Nord-Pas-de-Calais	62	1	20	248	Courcelles-le-Comte	443	12	455
31	Nord-Pas-de-Calais	62	7	56	249	Courcelles-lès-Lens	6122	51	6173
31	Nord-Pas-de-Calais	62	7	59	250	Courrières	10602	71	10673
31	Nord-Pas-de-Calais	62	3	21	251	Courset	479	198	677
31	Nord-Pas-de-Calais	62	2	70	252	La Couture	2645	47	2692
31	Nord-Pas-de-Calais	62	1	08	253	Couturelle	100	2	102
31	Nord-Pas-de-Calais	62	5	23	254	Coyecques	580	17	597
31	Nord-Pas-de-Calais	62	3	21	255	Crémarest	775	10	785
31	Nord-Pas-de-Calais	62	4	24	256	Crépy	149	5	154
31	Nord-Pas-de-Calais	62	4	24	257	Créquy	489	15	504
31	Nord-Pas-de-Calais	62	1	43	258	Croisette	315	0	315
31	Nord-Pas-de-Calais	62	1	20	259	Croisilles	1419	15	1434
31	Nord-Pas-de-Calais	62	1	43	260	Croix-en-Ternois	308	7	315
31	Nord-Pas-de-Calais	62	4	37	261	Cucq	5167	132	5299
31	Nord-Pas-de-Calais	62	2	17	262	Cuinchy	1758	25	1783
31	Nord-Pas-de-Calais	62	1	71	263	Dainville	5569	112	5681
31	Nord-Pas-de-Calais	62	3	44	264	Dannes	1291	19	1310
31	Nord-Pas-de-Calais	62	5	34	265	Delettes	1136	30	1166
31	Nord-Pas-de-Calais	62	1	08	266	Denier	65	1	66
31	Nord-Pas-de-Calais	62	5	23	267	Dennebroeucq	374	3	377
31	Nord-Pas-de-Calais	62	3	21	268	Desvres	5179	42	5221
31	Nord-Pas-de-Calais	62	1	43	269	Diéval	774	15	789
31	Nord-Pas-de-Calais	62	2	72	270	Divion	7129	55	7184
31	Nord-Pas-de-Calais	62	5	34	271	Dohem	777	20	797
31	Nord-Pas-de-Calais	62	1	20	272	Douchy-lès-Ayette	314	7	321
31	Nord-Pas-de-Calais	62	3	44	273	Doudeauville	506	7	513
31	Nord-Pas-de-Calais	62	7	56	274	Dourges	5619	43	5662
31	Nord-Pas-de-Calais	62	4	18	275	Douriez	307	7	314
31	Nord-Pas-de-Calais	62	2	73	276	Douvrin	4978	62	5040
31	Nord-Pas-de-Calais	62	7	67	277	Drocourt	2983	26	3009
31	Nord-Pas-de-Calais	62	2	64	278	Drouvin-le-Marais	540	13	553
31	Nord-Pas-de-Calais	62	1	71	279	Duisans	1177	282	1459
31	Nord-Pas-de-Calais	62	1	46	280	Dury	336	10	346
31	Nord-Pas-de-Calais	62	3	14	281	Echinghen	376	9	385
31	Nord-Pas-de-Calais	62	4	39	282	Éclimeux	162	7	169
31	Nord-Pas-de-Calais	62	1	43	283	Écoivres	112	1	113
31	Nord-Pas-de-Calais	62	1	35	284	Écourt-Saint-Quentin	1753	23	1776
31	Nord-Pas-de-Calais	62	1	20	285	Écoust-Saint-Mein	501	8	509
31	Nord-Pas-de-Calais	62	2	63	286	Ecquedecques	486	4	490
31	Nord-Pas-de-Calais	62	5	01	288	Ecques	2004	56	2060
31	Nord-Pas-de-Calais	62	4	37	289	Écuires	782	27	809
31	Nord-Pas-de-Calais	62	1	71	290	Écurie	418	8	426
31	Nord-Pas-de-Calais	62	7	60	291	Éleu-dit-Leauwette	2887	33	2920
31	Nord-Pas-de-Calais	62	5	34	292	Elnes	915	23	938
31	Nord-Pas-de-Calais	62	4	24	293	Embry	243	5	248
31	Nord-Pas-de-Calais	62	5	23	294	Enguinegatte	456	5	461
31	Nord-Pas-de-Calais	62	5	23	295	Enquin-les-Mines	1078	12	1090
31	Nord-Pas-de-Calais	62	4	29	296	Enquin-sur-Baillons	236	1	237
31	Nord-Pas-de-Calais	62	5	02	297	Éperlecques	3225	56	3281
31	Nord-Pas-de-Calais	62	1	35	298	Épinoy	531	11	542
31	Nord-Pas-de-Calais	62	1	27	299	Eps	257	2	259
31	Nord-Pas-de-Calais	62	3	61	300	Équihen-Plage	2904	31	2935
31	Nord-Pas-de-Calais	62	1	27	301	Équirre	53	3	56
31	Nord-Pas-de-Calais	62	4	29	302	Ergny	223	5	228
31	Nord-Pas-de-Calais	62	1	27	303	Érin	197	1	198
31	Nord-Pas-de-Calais	62	5	23	304	Erny-Saint-Julien	328	2	330
31	Nord-Pas-de-Calais	62	1	20	306	Ervillers	393	8	401
31	Nord-Pas-de-Calais	62	6	15	307	Escalles	301	5	306
31	Nord-Pas-de-Calais	62	5	34	308	Escoeuilles	449	10	459
31	Nord-Pas-de-Calais	62	5	34	309	Esquerdes	1571	32	1603
31	Nord-Pas-de-Calais	62	2	70	310	Essars	1628	26	1654
31	Nord-Pas-de-Calais	62	7	55	311	Estevelles	1809	21	1830
31	Nord-Pas-de-Calais	62	4	22	312	Estrée	303	8	311
31	Nord-Pas-de-Calais	62	2	38	313	Estrée-Blanche	943	16	959
31	Nord-Pas-de-Calais	62	2	28	314	Estrée-Cauchy	370	5	375
31	Nord-Pas-de-Calais	62	1	08	316	Estrée-Wamin	172	3	175
31	Nord-Pas-de-Calais	62	4	22	315	Estréelles	350	11	361
31	Nord-Pas-de-Calais	62	1	46	317	Étaing	448	6	454
31	Nord-Pas-de-Calais	62	4	22	318	Étaples	11279	163	11442
31	Nord-Pas-de-Calais	62	1	46	319	Éterpigny	232	5	237
31	Nord-Pas-de-Calais	62	1	71	320	Étrun	334	7	341
31	Nord-Pas-de-Calais	62	7	56	321	Évin-Malmaison	4544	30	4574
31	Nord-Pas-de-Calais	62	1	40	322	Famechon	119	3	122
31	Nord-Pas-de-Calais	62	1	04	323	Fampoux	1119	33	1152
31	Nord-Pas-de-Calais	62	1	45	324	Farbus	538	14	552
31	Nord-Pas-de-Calais	62	5	23	325	Fauquembergues	978	25	1003
31	Nord-Pas-de-Calais	62	1	09	326	Favreuil	251	2	253
31	Nord-Pas-de-Calais	62	5	23	327	Febvin-Palfart	533	5	538
31	Nord-Pas-de-Calais	62	2	63	328	Ferfay	942	15	957
31	Nord-Pas-de-Calais	62	3	36	329	Ferques	1851	14	1865
31	Nord-Pas-de-Calais	62	2	17	330	Festubert	1306	30	1336
31	Nord-Pas-de-Calais	62	1	04	331	Feuchy	1040	25	1065
31	Nord-Pas-de-Calais	62	1	10	332	Ficheux	493	14	507
31	Nord-Pas-de-Calais	62	1	27	333	Fiefs	399	4	403
31	Nord-Pas-de-Calais	62	6	25	334	Fiennes	886	2	888
31	Nord-Pas-de-Calais	62	4	39	335	Fillièvres	527	11	538
31	Nord-Pas-de-Calais	62	5	23	336	Fléchin	509	14	523
31	Nord-Pas-de-Calais	62	1	43	337	Flers	192	2	194
31	Nord-Pas-de-Calais	62	2	30	338	Fleurbaix	2651	98	2749
31	Nord-Pas-de-Calais	62	1	27	339	Fleury	132	1	133
31	Nord-Pas-de-Calais	62	1	27	340	Floringhem	858	20	878
31	Nord-Pas-de-Calais	62	1	40	341	Foncquevillers	471	5	476
31	Nord-Pas-de-Calais	62	1	07	345	Fontaine-l;Étalon	122	4	126
31	Nord-Pas-de-Calais	62	1	27	342	Fontaine-lès-Boulans	87	0	87
31	Nord-Pas-de-Calais	62	1	20	343	Fontaine-lès-Croisilles	280	6	286
31	Nord-Pas-de-Calais	62	1	27	344	Fontaine-lès-Hermans	108	2	110
31	Nord-Pas-de-Calais	62	1	07	346	Fortel-en-Artois	219	2	221
31	Nord-Pas-de-Calais	62	1	10	347	Fosseux	140	0	140
31	Nord-Pas-de-Calais	62	1	43	348	Foufflin-Ricametz	122	5	127
31	Nord-Pas-de-Calais	62	2	53	349	Fouquereuil	1234	18	1252
31	Nord-Pas-de-Calais	62	2	53	350	Fouquières-lès-Béthune	1095	23	1118
31	Nord-Pas-de-Calais	62	7	75	351	Fouquières-lès-Lens	6538	49	6587
31	Nord-Pas-de-Calais	62	1	43	352	Framecourt	108	3	111
31	Nord-Pas-de-Calais	62	1	09	353	Frémicourt	286	4	290
31	Nord-Pas-de-Calais	62	4	22	354	Frencq	777	19	796
31	Nord-Pas-de-Calais	62	1	46	355	Fresnes-lès-Montauban	489	13	502
31	Nord-Pas-de-Calais	62	2	28	356	Fresnicourt-le-Dolmen	835	4	839
31	Nord-Pas-de-Calais	62	4	39	357	Fresnoy	74	1	75
31	Nord-Pas-de-Calais	62	1	45	358	Fresnoy-en-Gohelle	253	9	262
31	Nord-Pas-de-Calais	62	4	24	359	Fressin	541	13	554
31	Nord-Pas-de-Calais	62	6	15	360	Fréthun	1135	19	1154
31	Nord-Pas-de-Calais	62	1	07	361	Frévent	3784	91	3875
31	Nord-Pas-de-Calais	62	1	05	362	Frévillers	244	5	249
31	Nord-Pas-de-Calais	62	1	05	363	Frévin-Capelle	392	15	407
31	Nord-Pas-de-Calais	62	4	24	364	Fruges	2586	285	2871
31	Nord-Pas-de-Calais	62	4	39	365	Galametz	180	2	182
31	Nord-Pas-de-Calais	62	2	28	366	Gauchin-Légal	341	10	351
31	Nord-Pas-de-Calais	62	1	43	367	Gauchin-Verloingt	883	28	911
31	Nord-Pas-de-Calais	62	1	40	368	Gaudiempré	181	2	183
31	Nord-Pas-de-Calais	62	1	45	369	Gavrelle	566	13	579
31	Nord-Pas-de-Calais	62	1	07	370	Gennes-Ivergny	124	9	133
31	Nord-Pas-de-Calais	62	1	45	371	Givenchy-en-Gohelle	2057	41	2098
31	Nord-Pas-de-Calais	62	1	08	372	Givenchy-le-Noble	138	4	142
31	Nord-Pas-de-Calais	62	2	73	373	Givenchy-lès-la-Bassée	919	9	928
31	Nord-Pas-de-Calais	62	1	20	374	Gomiécourt	155	3	158
31	Nord-Pas-de-Calais	62	1	40	375	Gommecourt	114	1	115
31	Nord-Pas-de-Calais	62	2	33	376	Gonnehem	2372	36	2408
31	Nord-Pas-de-Calais	62	2	64	377	Gosnay	1044	10	1054
31	Nord-Pas-de-Calais	62	1	10	378	Gouves	189	1	190
31	Nord-Pas-de-Calais	62	1	10	379	Gouy-en-Artois	344	7	351
31	Nord-Pas-de-Calais	62	1	05	381	Gouy-en-Ternois	172	1	173
31	Nord-Pas-de-Calais	62	4	18	382	Gouy-Saint-André	638	6	644
31	Nord-Pas-de-Calais	62	7	77	380	Gouy-Servins	322	10	332
31	Nord-Pas-de-Calais	62	1	46	383	Gouy-sous-Bellonne	1224	24	1248
31	Nord-Pas-de-Calais	62	1	35	384	Graincourt-lès-Havrincourt	637	15	652
31	Nord-Pas-de-Calais	62	1	08	385	Grand-Rullecourt	397	3	400
31	Nord-Pas-de-Calais	62	7	32	386	Grenay	6715	51	6766
31	Nord-Pas-de-Calais	62	1	09	387	Grévillers	378	4	382
31	Nord-Pas-de-Calais	62	4	39	388	Grigny	299	6	305
31	Nord-Pas-de-Calais	62	1	40	389	Grincourt-lès-Pas	42	0	42
31	Nord-Pas-de-Calais	62	4	69	390	Groffliers	1468	45	1513
31	Nord-Pas-de-Calais	62	2	33	391	Guarbecque	1402	25	1427
31	Nord-Pas-de-Calais	62	1	20	392	Guémappe	361	7	368
31	Nord-Pas-de-Calais	62	5	06	393	Guemps	967	7	974
31	Nord-Pas-de-Calais	62	4	26	395	Guigny	165	5	170
31	Nord-Pas-de-Calais	62	1	43	396	Guinecourt	19	0	19
31	Nord-Pas-de-Calais	62	6	25	397	Guînes	5644	65	5709
31	Nord-Pas-de-Calais	62	4	26	398	Guisy	291	8	299
31	Nord-Pas-de-Calais	62	1	10	399	Habarcq	677	11	688
31	Nord-Pas-de-Calais	62	2	64	400	Haillicourt	4919	34	4953
31	Nord-Pas-de-Calais	62	2	73	401	Haisnes	4482	29	4511
31	Nord-Pas-de-Calais	62	3	44	402	Halinghen	310	3	313
31	Nord-Pas-de-Calais	62	5	34	403	Hallines	1291	37	1328
31	Nord-Pas-de-Calais	62	1	40	404	Halloy	236	4	240
31	Nord-Pas-de-Calais	62	2	38	407	Ham-en-Artois	1001	13	1014
31	Nord-Pas-de-Calais	62	1	46	405	Hamblain-les-Prés	490	11	501
31	Nord-Pas-de-Calais	62	1	20	406	Hamelincourt	261	4	265
31	Nord-Pas-de-Calais	62	6	25	408	Hames-Boucres	1431	20	1451
31	Nord-Pas-de-Calais	62	1	40	409	Hannescamps	189	4	193
31	Nord-Pas-de-Calais	62	1	11	410	Haplincourt	188	7	195
31	Nord-Pas-de-Calais	62	1	07	411	Haravesnes	47	2	49
31	Nord-Pas-de-Calais	62	6	25	412	Hardinghen	1122	17	1139
31	Nord-Pas-de-Calais	62	7	55	413	Harnes	12373	78	12451
31	Nord-Pas-de-Calais	62	1	46	414	Haucourt	257	5	262
31	Nord-Pas-de-Calais	62	5	34	419	Haut-Loquin	160	0	160
31	Nord-Pas-de-Calais	62	1	10	415	Haute-Avesnes	411	7	418
31	Nord-Pas-de-Calais	62	1	43	416	Hautecloque	220	4	224
31	Nord-Pas-de-Calais	62	1	08	418	Hauteville	317	4	321
31	Nord-Pas-de-Calais	62	1	11	421	Havrincourt	388	6	394
31	Nord-Pas-de-Calais	62	1	40	422	Hébuterne	534	9	543
31	Nord-Pas-de-Calais	62	5	62	423	Helfaut	1688	39	1727
31	Nord-Pas-de-Calais	62	1	46	424	Hendecourt-lès-Cagnicourt	326	1	327
31	Nord-Pas-de-Calais	62	1	10	425	Hendecourt-lès-Ransart	119	1	120
31	Nord-Pas-de-Calais	62	7	89	427	Hénin-Beaumont	26278	450	26728
31	Nord-Pas-de-Calais	62	1	20	428	Hénin-sur-Cojeul	493	9	502
31	Nord-Pas-de-Calais	62	1	20	426	Héninel	204	6	210
31	Nord-Pas-de-Calais	62	3	21	429	Henneveux	306	7	313
31	Nord-Pas-de-Calais	62	1	40	430	Hénu	163	2	165
31	Nord-Pas-de-Calais	62	5	01	431	Herbelles	491	18	509
31	Nord-Pas-de-Calais	62	6	25	432	Herbinghen	380	7	387
31	Nord-Pas-de-Calais	62	1	43	433	Héricourt	106	1	107
31	Nord-Pas-de-Calais	62	1	10	434	La Herlière	159	0	159
31	Nord-Pas-de-Calais	62	1	43	436	Herlin-le-Sec	176	8	184
31	Nord-Pas-de-Calais	62	1	43	435	Herlincourt	109	8	117
31	Nord-Pas-de-Calais	62	4	29	437	Herly	324	2	326
31	Nord-Pas-de-Calais	62	1	05	438	Hermaville	538	20	558
31	Nord-Pas-de-Calais	62	6	25	439	Hermelinghen	347	1	348
31	Nord-Pas-de-Calais	62	1	11	440	Hermies	1178	14	1192
31	Nord-Pas-de-Calais	62	2	28	441	Hermin	207	5	212
31	Nord-Pas-de-Calais	62	1	43	442	Hernicourt	499	5	504
31	Nord-Pas-de-Calais	62	7	77	443	Hersin-Coupigny	6225	54	6279
31	Nord-Pas-de-Calais	62	3	36	444	Hervelinghen	233	4	237
31	Nord-Pas-de-Calais	62	2	64	445	Hesdigneul-lès-Béthune	810	14	824
31	Nord-Pas-de-Calais	62	3	44	446	Hesdigneul-lès-Boulogne	692	55	747
31	Nord-Pas-de-Calais	62	4	26	447	Hesdin	2272	62	2334
31	Nord-Pas-de-Calais	62	3	44	448	Hesdin-l;Abbé	1887	38	1925
31	Nord-Pas-de-Calais	62	4	18	449	Hesmond	179	5	184
31	Nord-Pas-de-Calais	62	1	27	450	Hestrus	245	2	247
31	Nord-Pas-de-Calais	62	1	27	451	Heuchin	566	11	577
31	Nord-Pas-de-Calais	62	5	01	452	Heuringhem	1311	42	1353
31	Nord-Pas-de-Calais	62	4	24	453	Hézecques	115	1	116
31	Nord-Pas-de-Calais	62	2	70	454	Hinges	2217	66	2283
31	Nord-Pas-de-Calais	62	6	25	455	Hocquinghen	109	1	110
31	Nord-Pas-de-Calais	62	2	64	456	Houchin	708	13	721
31	Nord-Pas-de-Calais	62	2	28	457	Houdain	7633	75	7708
31	Nord-Pas-de-Calais	62	5	41	458	Houlle	983	15	998
31	Nord-Pas-de-Calais	62	1	08	459	Houvin-Houvigneul	238	2	240
31	Nord-Pas-de-Calais	62	4	22	460	Hubersent	251	5	256
31	Nord-Pas-de-Calais	62	4	26	461	Huby-Saint-Leu	937	15	952
31	Nord-Pas-de-Calais	62	1	27	462	Huclier	117	0	117
31	Nord-Pas-de-Calais	62	4	29	463	Hucqueliers	519	60	579
31	Nord-Pas-de-Calais	62	7	68	464	Hulluch	3088	33	3121
31	Nord-Pas-de-Calais	62	1	40	465	Humbercamps	232	3	235
31	Nord-Pas-de-Calais	62	4	29	466	Humbert	240	3	243
31	Nord-Pas-de-Calais	62	1	43	467	Humeroeuille	145	3	148
31	Nord-Pas-de-Calais	62	1	43	468	Humières	210	10	220
31	Nord-Pas-de-Calais	62	1	35	469	Inchy-en-Artois	605	14	619
31	Nord-Pas-de-Calais	62	4	39	470	Incourt	67	2	69
31	Nord-Pas-de-Calais	62	5	01	471	Inghem	356	4	360
31	Nord-Pas-de-Calais	62	4	22	472	Inxent	165	9	174
31	Nord-Pas-de-Calais	62	2	38	473	Isbergues	9289	108	9397
31	Nord-Pas-de-Calais	62	3	44	474	Isques	1168	20	1188
31	Nord-Pas-de-Calais	62	1	08	475	Ivergny	263	5	268
31	Nord-Pas-de-Calais	62	1	45	476	Izel-lès-Équerchin	929	4	933
31	Nord-Pas-de-Calais	62	1	05	477	Izel-lès-Hameau	695	19	714
31	Nord-Pas-de-Calais	62	5	02	478	Journy	273	6	279
31	Nord-Pas-de-Calais	62	2	53	479	Labeuvrière	1697	20	1717
31	Nord-Pas-de-Calais	62	2	57	480	Labourse	2306	23	2329
31	Nord-Pas-de-Calais	62	4	26	481	Labroye	179	3	182
31	Nord-Pas-de-Calais	62	3	44	483	Lacres	242	3	245
31	Nord-Pas-de-Calais	62	1	35	484	Lagnicourt-Marcel	347	2	349
31	Nord-Pas-de-Calais	62	5	23	485	Laires	346	5	351
31	Nord-Pas-de-Calais	62	2	38	486	Lambres	1064	15	1079
31	Nord-Pas-de-Calais	62	3	36	487	Landrethun-le-Nord	1199	18	1217
31	Nord-Pas-de-Calais	62	5	02	488	Landrethun-lès-Ardres	697	12	709
31	Nord-Pas-de-Calais	62	2	53	489	Lapugnoy	3288	31	3319
31	Nord-Pas-de-Calais	62	1	08	490	Lattre-Saint-Quentin	240	11	251
31	Nord-Pas-de-Calais	62	2	30	491	Laventie	4838	98	4936
31	Nord-Pas-de-Calais	62	4	24	492	Lebiez	256	3	259
31	Nord-Pas-de-Calais	62	1	11	493	Lebucquière	252	2	254
31	Nord-Pas-de-Calais	62	1	11	494	Léchelle	61	2	63
31	Nord-Pas-de-Calais	62	5	34	495	Ledinghem	313	3	316
31	Nord-Pas-de-Calais	62	4	22	496	Lefaux	264	8	272
31	Nord-Pas-de-Calais	62	7	56	497	Leforest	7139	59	7198
31	Nord-Pas-de-Calais	62	7	95	498	Lens	35032	716	35748
31	Nord-Pas-de-Calais	62	4	37	499	Lépine	280	14	294
31	Nord-Pas-de-Calais	62	2	63	500	Lespesses	417	7	424
31	Nord-Pas-de-Calais	62	4	18	501	Lespinoy	218	3	221
31	Nord-Pas-de-Calais	62	2	30	502	Lestrem	4241	90	4331
31	Nord-Pas-de-Calais	62	3	36	503	Leubringhen	329	4	333
31	Nord-Pas-de-Calais	62	5	34	504	Leulinghem	230	11	241
31	Nord-Pas-de-Calais	62	3	36	505	Leulinghen-Bernes	413	5	418
31	Nord-Pas-de-Calais	62	7	19	907	Libercourt	8580	51	8631
31	Nord-Pas-de-Calais	62	6	25	506	Licques	1562	34	1596
31	Nord-Pas-de-Calais	62	1	08	507	Liencourt	276	2	278
31	Nord-Pas-de-Calais	62	2	63	508	Lières	374	3	377
31	Nord-Pas-de-Calais	62	2	38	509	Liettres	293	4	297
31	Nord-Pas-de-Calais	62	7	91	510	Liévin	31873	455	32328
31	Nord-Pas-de-Calais	62	1	08	511	Lignereuil	151	2	153
31	Nord-Pas-de-Calais	62	2	38	512	Ligny-lès-Aire	622	7	629
31	Nord-Pas-de-Calais	62	1	43	514	Ligny-Saint-Flochel	244	6	250
31	Nord-Pas-de-Calais	62	1	07	513	Ligny-sur-Canche	196	4	200
31	Nord-Pas-de-Calais	62	1	09	515	Ligny-Thilloy	577	13	590
31	Nord-Pas-de-Calais	62	2	33	516	Lillers	10055	134	10189
31	Nord-Pas-de-Calais	62	2	38	517	Linghem	213	2	215
31	Nord-Pas-de-Calais	62	1	43	518	Linzeux	165	5	170
31	Nord-Pas-de-Calais	62	1	27	519	Lisbourg	569	9	578
31	Nord-Pas-de-Calais	62	2	70	520	Locon	2317	49	2366
31	Nord-Pas-de-Calais	62	4	26	521	La Loge	192	5	197
31	Nord-Pas-de-Calais	62	7	49	523	Loison-sous-Lens	5299	47	5346
31	Nord-Pas-de-Calais	62	4	18	522	Loison-sur-Créquoise	242	4	246
31	Nord-Pas-de-Calais	62	3	21	524	Longfossé	1407	20	1427
31	Nord-Pas-de-Calais	62	5	42	525	Longuenesse	10925	651	11576
31	Nord-Pas-de-Calais	62	3	21	526	Longueville	129	3	132
31	Nord-Pas-de-Calais	62	4	22	527	Longvilliers	250	6	256
31	Nord-Pas-de-Calais	62	7	50	528	Loos-en-Gohelle	6778	114	6892
31	Nord-Pas-de-Calais	62	2	30	529	Lorgies	1601	37	1638
31	Nord-Pas-de-Calais	62	3	21	530	Lottinghen	529	8	537
31	Nord-Pas-de-Calais	62	5	02	531	Louches	930	12	942
31	Nord-Pas-de-Calais	62	2	63	532	Lozinghem	1225	13	1238
31	Nord-Pas-de-Calais	62	4	24	533	Lugy	146	0	146
31	Nord-Pas-de-Calais	62	5	34	534	Lumbres	3763	117	3880
31	Nord-Pas-de-Calais	62	4	37	535	La Madelaine-sous-Montreuil	176	8	184
31	Nord-Pas-de-Calais	62	1	05	536	Magnicourt-en-Comte	625	9	634
31	Nord-Pas-de-Calais	62	1	08	537	Magnicourt-sur-Canche	109	3	112
31	Nord-Pas-de-Calais	62	4	18	538	Maintenay	389	4	393
31	Nord-Pas-de-Calais	62	1	43	539	Maisnil	255	2	257
31	Nord-Pas-de-Calais	62	2	28	540	Maisnil-lès-Ruitz	1494	13	1507
31	Nord-Pas-de-Calais	62	4	39	541	Maisoncelle	121	2	123
31	Nord-Pas-de-Calais	62	1	05	542	Maizières	168	2	170
31	Nord-Pas-de-Calais	62	5	01	543	Mametz	2022	56	2078
31	Nord-Pas-de-Calais	62	1	08	544	Manin	185	5	190
31	Nord-Pas-de-Calais	62	4	29	545	Maninghem	147	2	149
31	Nord-Pas-de-Calais	62	3	36	546	Maninghen-Henne	328	14	342
31	Nord-Pas-de-Calais	62	4	18	547	Marant	72	0	72
31	Nord-Pas-de-Calais	62	6	54	548	Marck	9589	138	9727
31	Nord-Pas-de-Calais	62	4	26	549	Marconne	1116	74	1190
31	Nord-Pas-de-Calais	62	4	26	550	Marconnelle	1208	20	1228
31	Nord-Pas-de-Calais	62	4	18	551	Marenla	216	7	223
31	Nord-Pas-de-Calais	62	4	18	552	Maresquel-Ecquemicourt	887	21	908
31	Nord-Pas-de-Calais	62	1	27	553	Marest	262	12	274
31	Nord-Pas-de-Calais	62	4	22	554	Maresville	83	3	86
31	Nord-Pas-de-Calais	62	2	72	555	Marles-les-Mines	5744	47	5791
31	Nord-Pas-de-Calais	62	4	18	556	Marles-sur-Canche	286	17	303
31	Nord-Pas-de-Calais	62	1	71	557	Maroeuil	2506	114	2620
31	Nord-Pas-de-Calais	62	1	43	558	Marquay	168	2	170
31	Nord-Pas-de-Calais	62	1	35	559	Marquion	956	26	982
31	Nord-Pas-de-Calais	62	3	36	560	Marquise	5174	59	5233
31	Nord-Pas-de-Calais	62	1	09	561	Martinpuich	197	5	202
31	Nord-Pas-de-Calais	62	4	24	562	Matringhem	187	5	192
31	Nord-Pas-de-Calais	62	7	51	563	Mazingarbe	7496	52	7548
31	Nord-Pas-de-Calais	62	2	38	564	Mazinghem	444	8	452
31	Nord-Pas-de-Calais	62	4	24	565	Mencas	74	1	75
31	Nord-Pas-de-Calais	62	3	21	566	Menneville	711	16	727
31	Nord-Pas-de-Calais	62	5	02	567	Mentque-Nortbécourt	599	10	609
31	Nord-Pas-de-Calais	62	1	10	568	Mercatel	615	6	621
31	Nord-Pas-de-Calais	62	5	23	569	Merck-Saint-Liévin	591	11	602
31	Nord-Pas-de-Calais	62	7	90	570	Méricourt	11956	101	12057
31	Nord-Pas-de-Calais	62	4	37	571	Merlimont	3089	85	3174
31	Nord-Pas-de-Calais	62	1	11	572	Metz-en-Couture	642	10	652
31	Nord-Pas-de-Calais	62	7	68	573	Meurchin	3758	31	3789
31	Nord-Pas-de-Calais	62	1	05	574	Mingoval	206	3	209
31	Nord-Pas-de-Calais	62	1	43	576	Moncheaux-lès-Frévent	136	3	139
31	Nord-Pas-de-Calais	62	1	07	577	Monchel-sur-Canche	85	2	87
31	Nord-Pas-de-Calais	62	1	10	578	Monchiet	96	5	101
31	Nord-Pas-de-Calais	62	1	10	579	Monchy-au-Bois	504	16	520
31	Nord-Pas-de-Calais	62	1	05	580	Monchy-Breton	421	3	424
31	Nord-Pas-de-Calais	62	1	27	581	Monchy-Cayeux	291	7	298
31	Nord-Pas-de-Calais	62	1	46	582	Monchy-le-Preux	624	29	653
31	Nord-Pas-de-Calais	62	1	40	583	Mondicourt	636	10	646
31	Nord-Pas-de-Calais	62	2	33	584	Mont-Bernanchon	1394	22	1416
31	Nord-Pas-de-Calais	62	1	71	589	Mont-Saint-Éloi	1005	38	1043
31	Nord-Pas-de-Calais	62	4	22	585	Montcavrel	376	8	384
31	Nord-Pas-de-Calais	62	1	10	586	Montenescourt	438	14	452
31	Nord-Pas-de-Calais	62	7	74	587	Montigny-en-Gohelle	10047	66	10113
31	Nord-Pas-de-Calais	62	4	37	588	Montreuil	2282	210	2492
31	Nord-Pas-de-Calais	62	1	43	590	Monts-en-Ternois	53	1	54
31	Nord-Pas-de-Calais	62	1	11	591	Morchies	177	3	180
31	Nord-Pas-de-Calais	62	5	41	592	Moringhem	495	17	512
31	Nord-Pas-de-Calais	62	1	09	593	Morval	94	3	97
31	Nord-Pas-de-Calais	62	1	20	594	Mory	338	1	339
31	Nord-Pas-de-Calais	62	5	41	595	Moulle	1004	21	1025
31	Nord-Pas-de-Calais	62	4	26	596	Mouriez	253	5	258
31	Nord-Pas-de-Calais	62	1	20	597	Moyenneville	291	5	296
31	Nord-Pas-de-Calais	62	5	02	598	Muncq-Nieurlet	679	14	693
31	Nord-Pas-de-Calais	62	3	21	599	Nabringhen	170	2	172
31	Nord-Pas-de-Calais	62	1	27	600	Nédon	163	4	167
31	Nord-Pas-de-Calais	62	1	27	601	Nédonchel	241	2	243
31	Nord-Pas-de-Calais	62	4	37	602	Nempont-Saint-Firmin	181	5	186
31	Nord-Pas-de-Calais	62	3	44	603	Nesles	962	11	973
31	Nord-Pas-de-Calais	62	3	44	604	Neufchâtel-Hardelot	3774	115	3889
31	Nord-Pas-de-Calais	62	4	39	605	Neulette	20	1	21
31	Nord-Pas-de-Calais	62	2	30	606	Neuve-Chapelle	1345	31	1376
31	Nord-Pas-de-Calais	62	1	43	607	Neuville-au-Cornet	83	1	84
31	Nord-Pas-de-Calais	62	1	11	608	Neuville-Bourjonval	170	0	170
31	Nord-Pas-de-Calais	62	1	45	609	Neuville-Saint-Vaast	1449	50	1499
31	Nord-Pas-de-Calais	62	4	37	610	Neuville-sous-Montreuil	663	25	688
31	Nord-Pas-de-Calais	62	1	04	611	Neuville-Vitasse	495	7	502
31	Nord-Pas-de-Calais	62	1	45	612	Neuvireuil	479	11	490
31	Nord-Pas-de-Calais	62	5	02	614	Nielles-lès-Ardres	519	11	530
31	Nord-Pas-de-Calais	62	5	34	613	Nielles-lès-Bléquin	875	25	900
31	Nord-Pas-de-Calais	62	6	15	615	Nielles-lès-Calais	237	7	244
31	Nord-Pas-de-Calais	62	1	07	616	Noeux-lès-Auxi	173	3	176
31	Nord-Pas-de-Calais	62	2	57	617	Noeux-les-Mines	12206	111	12317
31	Nord-Pas-de-Calais	62	5	02	618	Nordausques	957	10	967
31	Nord-Pas-de-Calais	62	1	20	619	Noreuil	137	2	139
31	Nord-Pas-de-Calais	62	2	38	620	Norrent-Fontes	1436	33	1469
31	Nord-Pas-de-Calais	62	5	02	622	Nort-Leulinghem	203	4	207
31	Nord-Pas-de-Calais	62	5	06	621	Nortkerque	1632	20	1652
31	Nord-Pas-de-Calais	62	5	06	623	Nouvelle-Église	510	5	515
31	Nord-Pas-de-Calais	62	1	08	630	Noyelle-Vion	253	5	258
31	Nord-Pas-de-Calais	62	7	48	624	Noyelles-Godault	5141	28	5169
31	Nord-Pas-de-Calais	62	4	39	625	Noyelles-lès-Humières	61	0	61
31	Nord-Pas-de-Calais	62	2	17	626	Noyelles-lès-Vermelles	2243	17	2260
31	Nord-Pas-de-Calais	62	1	46	627	Noyelles-sous-Bellonne	810	18	828
31	Nord-Pas-de-Calais	62	7	75	628	Noyelles-sous-Lens	6896	44	6940
31	Nord-Pas-de-Calais	62	1	08	629	Noyellette	184	4	188
31	Nord-Pas-de-Calais	62	1	43	631	Nuncq-Hautecôte	402	7	409
31	Nord-Pas-de-Calais	62	2	12	632	Oblinghem	219	10	229
31	Nord-Pas-de-Calais	62	1	43	633	OEuf-en-Ternois	255	6	261
31	Nord-Pas-de-Calais	62	5	06	634	Offekerque	1107	21	1128
31	Nord-Pas-de-Calais	62	4	18	635	Offin	209	5	214
31	Nord-Pas-de-Calais	62	3	36	636	Offrethun	265	8	273
31	Nord-Pas-de-Calais	62	7	59	637	Oignies	9877	57	9934
31	Nord-Pas-de-Calais	62	1	35	638	Oisy-le-Verger	1267	15	1282
31	Nord-Pas-de-Calais	62	1	45	639	Oppy	363	11	374
31	Nord-Pas-de-Calais	62	1	40	640	Orville	394	5	399
31	Nord-Pas-de-Calais	62	1	43	641	Ostreville	259	19	278
31	Nord-Pas-de-Calais	62	2	28	642	Ourton	774	6	780
31	Nord-Pas-de-Calais	62	3	61	643	Outreau	14527	190	14717
31	Nord-Pas-de-Calais	62	5	34	644	Ouve-Wirquin	534	7	541
31	Nord-Pas-de-Calais	62	5	06	645	Oye-Plage	5427	110	5537
31	Nord-Pas-de-Calais	62	1	35	646	Palluel	566	7	573
31	Nord-Pas-de-Calais	62	4	39	647	Le Parcq	794	16	810
31	Nord-Pas-de-Calais	62	4	29	648	Parenty	485	6	491
31	Nord-Pas-de-Calais	62	1	40	649	Pas-en-Artois	810	13	823
31	Nord-Pas-de-Calais	62	1	46	650	Pelves	709	8	717
31	Nord-Pas-de-Calais	62	1	05	651	Penin	429	4	433
31	Nord-Pas-de-Calais	62	1	27	652	Pernes	1629	13	1642
31	Nord-Pas-de-Calais	62	3	13	653	Pernes-lès-Boulogne	473	13	486
31	Nord-Pas-de-Calais	62	6	15	654	Peuplingues	697	14	711
31	Nord-Pas-de-Calais	62	1	43	655	Pierremont	266	9	275
31	Nord-Pas-de-Calais	62	5	34	656	Pihem	990	17	1007
31	Nord-Pas-de-Calais	62	6	25	657	Pihen-lès-Guînes	483	2	485
31	Nord-Pas-de-Calais	62	3	13	658	Pittefaux	118	5	123
31	Nord-Pas-de-Calais	62	4	24	659	Planques	109	5	114
31	Nord-Pas-de-Calais	62	1	46	660	Plouvain	460	6	466
31	Nord-Pas-de-Calais	62	5	06	662	Polincove	787	12	799
31	Nord-Pas-de-Calais	62	1	40	663	Pommera	313	3	316
31	Nord-Pas-de-Calais	62	1	40	664	Pommier	240	1	241
31	Nord-Pas-de-Calais	62	1	07	665	Le Ponchel	223	5	228
31	Nord-Pas-de-Calais	62	7	55	666	Pont-à-Vendin	3109	32	3141
31	Nord-Pas-de-Calais	62	3	76	667	Le Portel	9569	128	9697
31	Nord-Pas-de-Calais	62	1	27	668	Prédefin	197	0	197
31	Nord-Pas-de-Calais	62	1	27	669	Pressy	291	3	294
31	Nord-Pas-de-Calais	62	4	29	670	Preures	562	8	570
31	Nord-Pas-de-Calais	62	1	35	671	Pronville	323	5	328
31	Nord-Pas-de-Calais	62	1	40	672	Puisieux	660	11	671
31	Nord-Pas-de-Calais	62	1	35	673	Quéant	625	6	631
31	Nord-Pas-de-Calais	62	5	34	674	Quelmes	561	9	570
31	Nord-Pas-de-Calais	62	5	34	675	Quercamps	278	9	287
31	Nord-Pas-de-Calais	62	2	38	676	Quernes	456	10	466
31	Nord-Pas-de-Calais	62	4	39	677	Le Quesnoy-en-Artois	361	5	366
31	Nord-Pas-de-Calais	62	3	21	678	Quesques	600	8	608
31	Nord-Pas-de-Calais	62	3	44	679	Questrecques	338	4	342
31	Nord-Pas-de-Calais	62	1	45	680	Quiéry-la-Motte	740	15	755
31	Nord-Pas-de-Calais	62	5	01	681	Quiestède	661	27	688
31	Nord-Pas-de-Calais	62	4	29	682	Quilen	58	2	60
31	Nord-Pas-de-Calais	62	1	07	683	Quoeux-Haut-Maînil	251	6	257
31	Nord-Pas-de-Calais	62	5	01	684	Racquinghem	2312	31	2343
31	Nord-Pas-de-Calais	62	4	24	685	Radinghem	288	141	429
31	Nord-Pas-de-Calais	62	1	43	686	Ramecourt	311	15	326
31	Nord-Pas-de-Calais	62	4	69	688	Rang-du-Fliers	4057	123	4180
31	Nord-Pas-de-Calais	62	1	10	689	Ransart	384	12	396
31	Nord-Pas-de-Calais	62	4	26	690	Raye-sur-Authie	219	1	220
31	Nord-Pas-de-Calais	62	5	01	691	Rebecques	446	14	460
31	Nord-Pas-de-Calais	62	5	02	692	Rebergues	243	3	246
31	Nord-Pas-de-Calais	62	2	28	693	Rebreuve-Ranchicourt	1095	34	1129
31	Nord-Pas-de-Calais	62	1	08	694	Rebreuve-sur-Canche	219	3	222
31	Nord-Pas-de-Calais	62	1	08	695	Rebreuviette	271	2	273
31	Nord-Pas-de-Calais	62	5	23	696	Reclinghem	188	0	188
31	Nord-Pas-de-Calais	62	1	46	697	Récourt	229	10	239
31	Nord-Pas-de-Calais	62	4	22	698	Recques-sur-Course	267	8	275
31	Nord-Pas-de-Calais	62	5	02	699	Recques-sur-Hem	565	12	577
31	Nord-Pas-de-Calais	62	4	26	700	Regnauville	219	3	222
31	Nord-Pas-de-Calais	62	2	38	701	Rely	457	1	458
31	Nord-Pas-de-Calais	62	5	34	702	Remilly-Wirquin	337	5	342
31	Nord-Pas-de-Calais	62	1	46	703	Rémy	284	4	288
31	Nord-Pas-de-Calais	62	5	23	704	Renty	575	12	587
31	Nord-Pas-de-Calais	62	3	36	705	Rety	2073	17	2090
31	Nord-Pas-de-Calais	62	2	17	706	Richebourg	2418	62	2480
31	Nord-Pas-de-Calais	62	1	09	708	Riencourt-lès-Bapaume	36	0	36
31	Nord-Pas-de-Calais	62	1	46	709	Riencourt-lès-Cagnicourt	283	4	287
31	Nord-Pas-de-Calais	62	4	24	710	Rimboval	145	2	147
31	Nord-Pas-de-Calais	62	3	36	711	Rinxent	2748	34	2782
31	Nord-Pas-de-Calais	62	1	10	712	Rivière	1125	29	1154
31	Nord-Pas-de-Calais	62	2	33	713	Robecq	1282	25	1307
31	Nord-Pas-de-Calais	62	1	71	714	Roclincourt	790	17	807
31	Nord-Pas-de-Calais	62	1	11	715	Rocquigny	287	5	292
31	Nord-Pas-de-Calais	62	5	02	716	Rodelinghem	543	3	546
31	Nord-Pas-de-Calais	62	1	43	717	Roëllecourt	608	14	622
31	Nord-Pas-de-Calais	62	1	46	718	Roeux	1392	14	1406
31	Nord-Pas-de-Calais	62	4	39	719	Rollancourt	349	37	386
31	Nord-Pas-de-Calais	62	2	38	720	Rombly	40	0	40
31	Nord-Pas-de-Calais	62	5	01	721	Roquetoire	1872	38	1910
31	Nord-Pas-de-Calais	62	1	07	722	Rougefay	92	0	92
31	Nord-Pas-de-Calais	62	4	18	723	Roussent	203	8	211
31	Nord-Pas-de-Calais	62	7	67	724	Rouvroy	8778	73	8851
31	Nord-Pas-de-Calais	62	4	24	725	Royon	121	3	124
31	Nord-Pas-de-Calais	62	4	24	726	Ruisseauville	167	2	169
31	Nord-Pas-de-Calais	62	2	64	727	Ruitz	1532	30	1562
31	Nord-Pas-de-Calais	62	1	35	728	Rumaucourt	702	11	713
31	Nord-Pas-de-Calais	62	4	29	729	Rumilly	257	3	260
31	Nord-Pas-de-Calais	62	5	06	730	Ruminghem	1577	22	1599
31	Nord-Pas-de-Calais	62	1	11	731	Ruyaulcourt	279	3	282
31	Nord-Pas-de-Calais	62	1	27	732	Sachin	303	7	310
31	Nord-Pas-de-Calais	62	1	40	733	Sailly-au-Bois	284	6	290
31	Nord-Pas-de-Calais	62	1	46	734	Sailly-en-Ostrevent	718	3	721
31	Nord-Pas-de-Calais	62	2	57	735	Sailly-Labourse	2128	14	2142
31	Nord-Pas-de-Calais	62	2	30	736	Sailly-sur-la-Lys	4090	74	4164
31	Nord-Pas-de-Calais	62	7	77	737	Sains-en-Gohelle	6450	55	6505
31	Nord-Pas-de-Calais	62	4	24	738	Sains-lès-Fressin	175	3	178
31	Nord-Pas-de-Calais	62	1	35	739	Sains-lès-Marquion	338	3	341
31	Nord-Pas-de-Calais	62	1	27	740	Sains-lès-Pernes	272	4	276
31	Nord-Pas-de-Calais	62	1	40	741	Saint-Amand	144	6	150
31	Nord-Pas-de-Calais	62	4	37	742	Saint-Aubin	260	14	274
31	Nord-Pas-de-Calais	62	4	18	745	Saint-Denoeux	137	0	137
31	Nord-Pas-de-Calais	62	3	44	746	Saint-Étienne-au-Mont	5070	77	5147
31	Nord-Pas-de-Calais	62	2	33	747	Saint-Floris	523	9	532
31	Nord-Pas-de-Calais	62	5	06	748	Saint-Folquin	2214	33	2247
31	Nord-Pas-de-Calais	62	4	39	749	Saint-Georges	308	7	315
31	Nord-Pas-de-Calais	62	2	38	750	Saint-Hilaire-Cottes	841	7	848
31	Nord-Pas-de-Calais	62	3	36	751	Saint-Inglevert	726	18	744
31	Nord-Pas-de-Calais	62	4	37	752	Saint-Josse	1188	36	1224
31	Nord-Pas-de-Calais	62	1	03	753	Saint-Laurent-Blangy	6059	78	6137
31	Nord-Pas-de-Calais	62	1	20	754	Saint-Léger	406	9	415
31	Nord-Pas-de-Calais	62	3	44	755	Saint-Léonard	3581	58	3639
31	Nord-Pas-de-Calais	62	5	41	757	Saint-Martin-au-Laërt	3729	81	3810
31	Nord-Pas-de-Calais	62	3	14	758	Saint-Martin-Boulogne	11230	239	11469
31	Nord-Pas-de-Calais	62	3	21	759	Saint-Martin-Choquel	468	13	481
31	Nord-Pas-de-Calais	62	5	23	760	Saint-Martin-d;Hardinghem	303	13	316
31	Nord-Pas-de-Calais	62	1	20	761	Saint-Martin-sur-Cojeul	210	4	214
31	Nord-Pas-de-Calais	62	4	29	762	Saint-Michel-sous-Bois	123	4	127
31	Nord-Pas-de-Calais	62	1	43	763	Saint-Michel-sur-Ternoise	935	21	956
31	Nord-Pas-de-Calais	62	1	03	764	Saint-Nicolas	4843	84	4927
31	Nord-Pas-de-Calais	62	5	99	765	Saint-Omer	14506	725	15231
31	Nord-Pas-de-Calais	62	5	06	766	Saint-Omer-Capelle	1125	10	1135
31	Nord-Pas-de-Calais	62	1	43	767	Saint-Pol-sur-Ternoise	5185	210	5395
31	Nord-Pas-de-Calais	62	4	18	768	Saint-Rémy-au-Bois	110	2	112
31	Nord-Pas-de-Calais	62	6	15	769	Saint-Tricat	668	28	696
31	Nord-Pas-de-Calais	62	2	33	770	Saint-Venant	3120	99	3219
31	Nord-Pas-de-Calais	62	4	26	743	Sainte-Austreberthe	410	13	423
31	Nord-Pas-de-Calais	62	1	71	744	Sainte-Catherine	3411	80	3491
31	Nord-Pas-de-Calais	62	5	06	756	Sainte-Marie-Kerque	1520	33	1553
31	Nord-Pas-de-Calais	62	7	31	771	Sallaumines	9956	107	10063
31	Nord-Pas-de-Calais	62	5	41	772	Salperwick	504	12	516
31	Nord-Pas-de-Calais	62	3	44	773	Samer	3633	123	3756
31	Nord-Pas-de-Calais	62	6	15	774	Sangatte	4673	106	4779
31	Nord-Pas-de-Calais	62	6	25	775	Sanghen	274	2	276
31	Nord-Pas-de-Calais	62	1	09	776	Sapignies	178	4	182
31	Nord-Pas-de-Calais	62	1	09	777	Le Sars	162	2	164
31	Nord-Pas-de-Calais	62	1	08	778	Sars-le-Bois	66	0	66
31	Nord-Pas-de-Calais	62	1	40	779	Sarton	176	0	176
31	Nord-Pas-de-Calais	62	1	35	780	Sauchy-Cauchy	391	5	396
31	Nord-Pas-de-Calais	62	1	35	781	Sauchy-Lestrée	457	8	465
31	Nord-Pas-de-Calais	62	1	46	782	Saudemont	439	7	446
31	Nord-Pas-de-Calais	62	4	18	783	Saulchoy	304	5	309
31	Nord-Pas-de-Calais	62	1	08	784	Saulty	719	4	723
31	Nord-Pas-de-Calais	62	1	05	785	Savy-Berlette	965	106	1071
31	Nord-Pas-de-Calais	62	3	21	786	Selles	323	5	328
31	Nord-Pas-de-Calais	62	4	18	787	Sempy	297	4	301
31	Nord-Pas-de-Calais	62	5	34	788	Seninghem	667	16	683
31	Nord-Pas-de-Calais	62	3	21	789	Senlecques	252	4	256
31	Nord-Pas-de-Calais	62	4	24	790	Senlis	178	8	186
31	Nord-Pas-de-Calais	62	1	43	791	Séricourt	54	2	56
31	Nord-Pas-de-Calais	62	5	41	792	Serques	1149	40	1189
31	Nord-Pas-de-Calais	62	7	77	793	Servins	1050	24	1074
31	Nord-Pas-de-Calais	62	5	34	794	Setques	644	13	657
31	Nord-Pas-de-Calais	62	1	43	795	Sibiville	96	1	97
31	Nord-Pas-de-Calais	62	1	10	796	Simencourt	530	12	542
31	Nord-Pas-de-Calais	62	1	43	797	Siracourt	248	12	260
31	Nord-Pas-de-Calais	62	1	08	798	Sombrin	239	1	240
31	Nord-Pas-de-Calais	62	4	37	799	Sorrus	645	19	664
31	Nord-Pas-de-Calais	62	1	40	800	Souastre	359	5	364
31	Nord-Pas-de-Calais	62	1	45	801	Souchez	2523	32	2555
31	Nord-Pas-de-Calais	62	1	08	802	Le Souich	179	3	182
31	Nord-Pas-de-Calais	62	5	34	803	Surques	501	3	504
31	Nord-Pas-de-Calais	62	1	08	804	Sus-Saint-Léger	350	3	353
31	Nord-Pas-de-Calais	62	1	27	805	Tangry	233	2	235
31	Nord-Pas-de-Calais	62	3	36	806	Tardinghen	154	11	165
31	Nord-Pas-de-Calais	62	5	42	807	Tatinghem	1775	37	1812
31	Nord-Pas-de-Calais	62	1	27	808	Teneur	285	3	288
31	Nord-Pas-de-Calais	62	1	43	809	Ternas	134	2	136
31	Nord-Pas-de-Calais	62	1	45	810	Thélus	1218	16	1234
31	Nord-Pas-de-Calais	62	5	01	811	Thérouanne	1072	29	1101
31	Nord-Pas-de-Calais	62	5	23	812	Thiembronne	747	19	766
31	Nord-Pas-de-Calais	62	1	05	813	La Thieuloye	460	2	462
31	Nord-Pas-de-Calais	62	1	40	814	Thièvres	121	1	122
31	Nord-Pas-de-Calais	62	4	69	815	Tigny-Noyelle	154	4	158
31	Nord-Pas-de-Calais	62	1	05	816	Tilloy-lès-Hermaville	236	3	239
31	Nord-Pas-de-Calais	62	1	04	817	Tilloy-lès-Mofflaines	1394	120	1514
31	Nord-Pas-de-Calais	62	1	27	818	Tilly-Capelle	158	4	162
31	Nord-Pas-de-Calais	62	5	41	819	Tilques	1107	35	1142
31	Nord-Pas-de-Calais	62	1	05	820	Tincques	875	10	885
31	Nord-Pas-de-Calais	62	3	44	821	Tingry	326	6	332
31	Nord-Pas-de-Calais	62	1	07	822	Tollent	91	3	94
31	Nord-Pas-de-Calais	62	4	24	823	Torcy	159	5	164
31	Nord-Pas-de-Calais	62	4	26	824	Tortefontaine	250	5	255
31	Nord-Pas-de-Calais	62	1	46	825	Tortequesne	709	11	720
31	Nord-Pas-de-Calais	62	4	37	826	Le Touquet-Paris-Plage	4495	360	4855
31	Nord-Pas-de-Calais	62	5	02	827	Tournehem-sur-la-Hem	1413	19	1432
31	Nord-Pas-de-Calais	62	4	39	828	Tramecourt	56	1	57
31	Nord-Pas-de-Calais	62	1	09	829	Le Transloy	438	8	446
31	Nord-Pas-de-Calais	62	1	11	830	Trescault	194	5	199
31	Nord-Pas-de-Calais	62	1	43	831	Troisvaux	295	6	301
31	Nord-Pas-de-Calais	62	4	22	832	Tubersent	503	8	511
31	Nord-Pas-de-Calais	62	1	07	833	Vacquerie-le-Boucq	78	2	80
31	Nord-Pas-de-Calais	62	4	39	834	Vacqueriette-Erquières	245	6	251
31	Nord-Pas-de-Calais	62	1	27	835	Valhuon	576	9	585
31	Nord-Pas-de-Calais	62	2	64	836	Vaudricourt	891	36	927
31	Nord-Pas-de-Calais	62	5	34	837	Vaudringhem	485	3	488
31	Nord-Pas-de-Calais	62	1	07	838	Vaulx	84	0	84
31	Nord-Pas-de-Calais	62	1	20	839	Vaulx-Vraucourt	1069	11	1080
31	Nord-Pas-de-Calais	62	1	11	840	Vélu	123	3	126
31	Nord-Pas-de-Calais	62	7	68	842	Vendin-le-Vieil	7664	61	7725
31	Nord-Pas-de-Calais	62	2	12	841	Vendin-lès-Béthune	2371	43	2414
31	Nord-Pas-de-Calais	62	4	24	843	Verchin	228	5	233
31	Nord-Pas-de-Calais	62	4	29	844	Verchocq	614	10	624
31	Nord-Pas-de-Calais	62	3	44	845	Verlincthun	381	4	385
31	Nord-Pas-de-Calais	62	2	17	846	Vermelles	4445	39	4484
31	Nord-Pas-de-Calais	62	2	70	847	Verquigneul	2028	35	2063
31	Nord-Pas-de-Calais	62	2	53	848	Verquin	3318	45	3363
31	Nord-Pas-de-Calais	62	4	69	849	Verton	2269	83	2352
31	Nord-Pas-de-Calais	62	4	39	850	Vieil-Hesdin	373	16	389
31	Nord-Pas-de-Calais	62	3	21	853	Vieil-Moutier	391	2	393
31	Nord-Pas-de-Calais	62	2	70	851	Vieille-Chapelle	766	7	773
31	Nord-Pas-de-Calais	62	5	06	852	Vieille-Église	1359	21	1380
31	Nord-Pas-de-Calais	62	1	45	854	Villers-au-Bois	533	11	544
31	Nord-Pas-de-Calais	62	1	09	855	Villers-au-Flos	219	7	226
31	Nord-Pas-de-Calais	62	1	05	856	Villers-Brûlin	307	11	318
31	Nord-Pas-de-Calais	62	1	05	857	Villers-Châtel	119	3	122
31	Nord-Pas-de-Calais	62	1	07	859	Villers-l;Hôpital	270	4	274
31	Nord-Pas-de-Calais	62	1	46	858	Villers-lès-Cagnicourt	255	9	264
31	Nord-Pas-de-Calais	62	1	05	860	Villers-Sir-Simon	127	3	130
31	Nord-Pas-de-Calais	62	1	45	861	Vimy	4345	107	4452
31	Nord-Pas-de-Calais	62	4	24	862	Vincly	164	0	164
31	Nord-Pas-de-Calais	62	2	73	863	Violaines	3713	62	3775
31	Nord-Pas-de-Calais	62	1	46	864	Vis-en-Artois	652	17	669
31	Nord-Pas-de-Calais	62	1	46	865	Vitry-en-Artois	4446	61	4507
31	Nord-Pas-de-Calais	62	4	69	866	Waben	432	4	436
31	Nord-Pas-de-Calais	62	3	36	867	Wacquinghen	232	6	238
31	Nord-Pas-de-Calais	62	4	39	868	Wail	276	2	278
31	Nord-Pas-de-Calais	62	1	04	869	Wailly	1037	23	1060
31	Nord-Pas-de-Calais	62	4	37	870	Wailly-Beaucamp	992	25	1017
31	Nord-Pas-de-Calais	62	4	26	871	Wambercourt	251	4	255
31	Nord-Pas-de-Calais	62	4	39	872	Wamin	251	8	259
31	Nord-Pas-de-Calais	62	1	20	873	Wancourt	658	11	669
31	Nord-Pas-de-Calais	62	1	10	874	Wanquetin	699	5	704
31	Nord-Pas-de-Calais	62	5	01	875	Wardrecques	1174	24	1198
31	Nord-Pas-de-Calais	62	1	09	876	Warlencourt-Eaucourt	162	1	163
31	Nord-Pas-de-Calais	62	1	40	877	Warlincourt-lès-Pas	153	3	156
31	Nord-Pas-de-Calais	62	1	10	878	Warlus	366	5	371
31	Nord-Pas-de-Calais	62	1	08	879	Warluzel	249	3	252
31	Nord-Pas-de-Calais	62	3	21	880	Le Wast	202	7	209
31	Nord-Pas-de-Calais	62	5	34	882	Wavrans-sur-l;Aa	1328	30	1358
31	Nord-Pas-de-Calais	62	1	43	883	Wavrans-sur-Ternoise	219	3	222
31	Nord-Pas-de-Calais	62	2	38	885	Westrehem	216	13	229
31	Nord-Pas-de-Calais	62	4	29	886	Wicquinghem	203	5	208
31	Nord-Pas-de-Calais	62	4	22	887	Widehem	267	2	269
31	Nord-Pas-de-Calais	62	3	44	888	Wierre-au-Bois	218	1	219
31	Nord-Pas-de-Calais	62	3	36	889	Wierre-Effroy	788	11	799
31	Nord-Pas-de-Calais	62	4	39	890	Willeman	177	1	178
31	Nord-Pas-de-Calais	62	1	07	891	Willencourt	145	1	146
31	Nord-Pas-de-Calais	62	1	45	892	Willerval	651	10	661
31	Nord-Pas-de-Calais	62	3	65	893	Wimereux	7442	176	7618
31	Nord-Pas-de-Calais	62	3	13	894	Wimille	4231	94	4325
31	Nord-Pas-de-Calais	62	7	68	895	Wingles	8255	69	8324
31	Nord-Pas-de-Calais	62	3	21	896	Wirwignes	741	23	764
31	Nord-Pas-de-Calais	62	5	34	897	Wismes	522	18	540
31	Nord-Pas-de-Calais	62	5	34	898	Wisques	242	3	245
31	Nord-Pas-de-Calais	62	3	36	899	Wissant	1056	21	1077
31	Nord-Pas-de-Calais	62	2	38	900	Witternesse	577	5	582
31	Nord-Pas-de-Calais	62	5	01	901	Wittes	874	11	885
31	Nord-Pas-de-Calais	62	5	42	902	Wizernes	3310	51	3361
31	Nord-Pas-de-Calais	62	1	11	909	Ytres	436	4	440
31	Nord-Pas-de-Calais	62	4	29	903	Zoteux	520	9	529
31	Nord-Pas-de-Calais	62	5	02	904	Zouafques	571	6	577
31	Nord-Pas-de-Calais	62	5	34	905	Zudausques	838	32	870
31	Nord-Pas-de-Calais	62	5	06	906	Zutkerque	1713	24	1737
83	Auvergne	63	4	01	001	Aigueperse	2561	35	2596
83	Auvergne	63	1	41	002	Aix-la-Fayette	73	1	74
83	Auvergne	63	1	02	003	Ambert	6920	307	7227
83	Auvergne	63	4	23	004	Les Ancizes-Comps	1761	21	1782
83	Auvergne	63	3	40	005	Antoingt	373	16	389
83	Auvergne	63	3	03	006	Anzat-le-Luguet	187	2	189
83	Auvergne	63	3	03	007	Apchat	187	7	194
83	Auvergne	63	5	43	008	Arconsat	634	11	645
83	Auvergne	63	3	03	009	Ardes	607	22	629
83	Auvergne	63	1	04	010	Arlanc	1941	56	1997
83	Auvergne	63	4	26	011	Ars-les-Favets	235	3	238
83	Auvergne	63	4	01	012	Artonne	770	14	784
83	Auvergne	63	4	01	013	Aubiat	883	11	894
83	Auvergne	63	2	55	014	Aubière	9621	203	9824
83	Auvergne	63	5	15	015	Aubusson-d;Auvergne	241	4	245
83	Auvergne	63	5	15	016	Augerolles	878	15	893
83	Auvergne	63	3	03	017	Augnat	130	3	133
83	Auvergne	63	3	19	018	Aulhat-Saint-Privat	381	13	394
83	Auvergne	63	2	59	019	Aulnat	4171	51	4222
83	Auvergne	63	2	35	020	Aurières	331	3	334
83	Auvergne	63	2	48	021	Authezat	650	9	659
83	Auvergne	63	3	20	022	Auzat-la-Combelle	2060	49	2109
83	Auvergne	63	1	16	023	Auzelles	337	12	349
83	Auvergne	63	3	45	024	Avèze	197	5	202
83	Auvergne	63	4	42	025	Ayat-sur-Sioule	145	4	149
83	Auvergne	63	2	37	026	Aydat	2192	43	2235
83	Auvergne	63	1	50	027	Baffie	118	2	120
83	Auvergne	63	3	21	028	Bagnols	493	11	504
83	Auvergne	63	3	44	029	Bansat	247	4	251
83	Auvergne	63	4	32	030	Bas-et-Lezat	259	8	267
83	Auvergne	63	3	40	031	Beaulieu	405	8	413
83	Auvergne	63	2	56	032	Beaumont	10933	296	11229
83	Auvergne	63	4	32	033	Beaumont-lès-Randan	276	3	279
83	Auvergne	63	2	47	034	Beauregard-l;Évêque	1312	24	1336
83	Auvergne	63	4	14	035	Beauregard-Vendon	1055	13	1068
83	Auvergne	63	3	19	036	Bergonne	340	10	350
83	Auvergne	63	1	36	037	Bertignat	482	20	502
83	Auvergne	63	3	05	038	Besse-et-Saint-Anastaise	1561	59	1620
83	Auvergne	63	1	04	039	Beurières	304	12	316
83	Auvergne	63	2	06	040	Billom	4635	103	4738
83	Auvergne	63	4	42	041	Biollet	318	2	320
83	Auvergne	63	2	59	042	Blanzat	3824	53	3877
83	Auvergne	63	4	25	043	Blot-l;Église	404	13	417
83	Auvergne	63	2	06	044	Bongheat	368	4	372
83	Auvergne	63	2	06	045	Bort-l;Étang	593	6	599
83	Auvergne	63	3	40	046	Boudes	267	8	275
83	Auvergne	63	2	35	047	La Bourboule	1925	59	1984
83	Auvergne	63	2	07	048	Bourg-Lastic	914	22	936
83	Auvergne	63	2	47	049	Bouzel	703	16	719
83	Auvergne	63	3	20	050	Brassac-les-Mines	3290	164	3454
83	Auvergne	63	3	44	051	Brenat	583	24	607
83	Auvergne	63	3	40	052	Le Breuil-sur-Couze	962	77	1039
83	Auvergne	63	2	07	053	Briffons	302	7	309
83	Auvergne	63	3	19	054	Le Broc	619	16	635
83	Auvergne	63	4	31	055	Bromont-Lamothe	954	14	968
83	Auvergne	63	1	16	056	Brousse	363	10	373
83	Auvergne	63	1	27	057	Le Brugeron	251	11	262
83	Auvergne	63	5	22	058	Bulhon	501	9	510
83	Auvergne	63	2	49	059	Busséol	187	1	188
83	Auvergne	63	4	28	060	Bussières	106	1	107
83	Auvergne	63	4	01	061	Bussières-et-Pruns	418	3	421
83	Auvergne	63	4	26	062	Buxières-sous-Montaigut	239	5	244
83	Auvergne	63	2	59	063	Cébazat	7611	113	7724
83	Auvergne	63	2	39	065	Ceilloux	158	8	166
83	Auvergne	63	4	29	064	La Celle	84	4	88
83	Auvergne	63	5	43	066	Celles-sur-Durolle	1774	29	1803
83	Auvergne	63	4	28	067	La Cellette	161	3	164
83	Auvergne	63	4	33	068	Cellule	1068	10	1078
83	Auvergne	63	2	48	069	Le Cendre	4696	76	4772
83	Auvergne	63	2	56	070	Ceyrat	5341	203	5544
83	Auvergne	63	2	35	071	Ceyssat	649	11	660
83	Auvergne	63	5	43	072	Chabreloche	1310	25	1335
83	Auvergne	63	3	08	073	Chadeleuf	387	11	398
83	Auvergne	63	3	40	074	Chalus	185	1	186
83	Auvergne	63	2	57	075	Chamalières	17081	602	17683
83	Auvergne	63	1	41	076	Chambon-sur-Dolore	171	5	176
83	Auvergne	63	3	05	077	Chambon-sur-Lac	352	4	356
83	Auvergne	63	3	44	078	Chaméane	146	5	151
83	Auvergne	63	3	20	079	Champagnat-le-Jeune	123	2	125
83	Auvergne	63	3	08	080	Champeix	1348	18	1366
83	Auvergne	63	1	02	081	Champétières	253	7	260
83	Auvergne	63	4	14	082	Champs	323	5	328
83	Auvergne	63	2	61	083	Chanat-la-Mouteyre	944	29	973
83	Auvergne	63	2	37	084	Chanonat	1615	38	1653
83	Auvergne	63	4	31	085	Chapdes-Beaufort	1015	14	1029
83	Auvergne	63	1	16	086	La Chapelle-Agnon	382	9	391
83	Auvergne	63	3	03	087	La Chapelle-Marcousse	75	2	77
83	Auvergne	63	3	20	088	La Chapelle-sur-Usson	78	0	78
83	Auvergne	63	4	17	089	Chappes	1507	9	1516
83	Auvergne	63	4	01	090	Chaptuzat	437	11	448
83	Auvergne	63	3	40	091	Charbonnier-les-Mines	901	36	937
83	Auvergne	63	4	23	092	Charbonnières-les-Varennes	1532	47	1579
83	Auvergne	63	4	23	093	Charbonnières-les-Vieilles	988	10	998
83	Auvergne	63	4	42	094	Charensat	522	12	534
83	Auvergne	63	5	22	095	Charnat	200	9	209
83	Auvergne	63	2	47	096	Chas	379	8	387
83	Auvergne	63	3	03	097	Chassagne	87	1	88
83	Auvergne	63	3	21	098	Chastreix	243	11	254
83	Auvergne	63	4	28	101	Château-sur-Cher	92	1	93
83	Auvergne	63	4	34	099	Châteaugay	3152	89	3241
83	Auvergne	63	4	23	100	Châteauneuf-les-Bains	292	7	299
83	Auvergne	63	4	33	103	Châtel-Guyon	6222	184	6406
83	Auvergne	63	5	09	102	Châteldon	763	17	780
83	Auvergne	63	1	38	104	La Chaulme	136	3	139
83	Auvergne	63	1	04	105	Chaumont-le-Bourg	217	6	223
83	Auvergne	63	2	47	106	Chauriat	1565	33	1598
83	Auvergne	63	4	17	107	Chavaroux	452	5	457
83	Auvergne	63	4	33	108	Le Cheix	615	12	627
83	Auvergne	63	3	08	109	Chidrac	505	5	510
83	Auvergne	63	4	31	110	Cisternes-la-Forêt	486	9	495
83	Auvergne	63	3	08	111	Clémensat	108	0	108
83	Auvergne	63	4	17	112	Clerlande	418	4	422
83	Auvergne	63	2	98	113	Clermont-Ferrand	139860	3809	143669
83	Auvergne	63	3	40	114	Collanges	154	1	155
83	Auvergne	63	4	29	115	Combrailles	218	4	222
83	Auvergne	63	4	14	116	Combronde	2030	48	2078
83	Auvergne	63	3	05	117	Compains	158	0	158
83	Auvergne	63	4	29	118	Condat-en-Combraille	486	9	495
83	Auvergne	63	1	41	119	Condat-lès-Montboissier	227	4	231
83	Auvergne	63	2	48	120	Corent	679	8	687
83	Auvergne	63	3	19	121	Coudes	1144	20	1164
83	Auvergne	63	3	08	122	Courgoul	65	4	69
83	Auvergne	63	2	37	123	Cournols	233	11	244
83	Auvergne	63	2	58	124	Cournon-d;Auvergne	19244	465	19709
83	Auvergne	63	5	15	125	Courpière	4461	190	4651
83	Auvergne	63	2	48	126	Le Crest	1278	25	1303
83	Auvergne	63	3	08	127	Creste	52	3	55
83	Auvergne	63	5	22	128	Crevant-Laveine	954	24	978
83	Auvergne	63	3	21	129	Cros	172	6	178
83	Auvergne	63	4	26	130	La Crouzille	280	5	285
83	Auvergne	63	5	22	131	Culhat	1022	24	1046
83	Auvergne	63	1	16	132	Cunlhat	1292	39	1331
83	Auvergne	63	2	30	133	Dallet	1398	25	1423
83	Auvergne	63	3	03	134	Dauzat-sur-Vodable	90	2	92
83	Auvergne	63	4	14	135	Davayat	572	5	577
83	Auvergne	63	2	39	136	Domaize	382	7	389
83	Auvergne	63	1	04	137	Doranges	149	7	156
83	Auvergne	63	5	46	138	Dorat	678	21	699
83	Auvergne	63	1	04	139	Dore-l;Église	630	19	649
83	Auvergne	63	4	26	140	Durmignat	203	8	211
83	Auvergne	63	2	61	141	Durtol	1960	60	2020
83	Auvergne	63	1	41	142	Échandelys	232	5	237
83	Auvergne	63	4	01	143	Effiat	1043	16	1059
83	Auvergne	63	3	05	144	Égliseneuve-d;Entraigues	458	12	470
83	Auvergne	63	3	44	145	Égliseneuve-des-Liards	145	3	148
83	Auvergne	63	2	06	146	Égliseneuve-près-Billom	826	83	909
83	Auvergne	63	1	50	147	Églisolles	257	6	263
83	Auvergne	63	4	17	148	Ennezat	2395	53	2448
83	Auvergne	63	4	17	149	Entraigues	634	13	647
83	Auvergne	63	4	34	150	Enval	1390	38	1428
83	Auvergne	63	5	46	151	Escoutoux	1320	53	1373
83	Auvergne	63	4	42	152	Espinasse	308	9	317
83	Auvergne	63	3	05	153	Espinchal	100	4	104
83	Auvergne	63	2	47	154	Espirat	325	20	345
83	Auvergne	63	2	39	155	Estandeuil	383	8	391
83	Auvergne	63	3	20	156	Esteil	69	1	70
83	Auvergne	63	2	39	157	Fayet-le-Château	314	5	319
83	Auvergne	63	1	41	158	Fayet-Ronaye	99	5	104
83	Auvergne	63	4	29	159	Fernoël	135	2	137
83	Auvergne	63	3	19	160	Flat	498	12	510
83	Auvergne	63	1	02	161	La Forie	333	8	341
83	Auvergne	63	1	41	162	Fournols	347	9	356
83	Auvergne	63	2	35	163	Gelles	909	46	955
83	Auvergne	63	2	59	164	Gerzat	10393	131	10524
83	Auvergne	63	4	29	165	Giat	887	45	932
83	Auvergne	63	3	40	166	Gignat	244	7	251
83	Auvergne	63	4	14	167	Gimeaux	412	9	421
83	Auvergne	63	2	06	168	Glaine-Montaigut	524	11	535
83	Auvergne	63	3	03	169	La Godivelle	23	0	23
83	Auvergne	63	4	31	170	La Goutelle	619	11	630
83	Auvergne	63	4	42	171	Gouttières	348	13	361
83	Auvergne	63	3	08	172	Grandeyrolles	61	0	61
83	Auvergne	63	1	38	173	Grandrif	167	4	171
83	Auvergne	63	1	36	174	Grandval	114	10	124
83	Auvergne	63	2	18	175	Herment	283	7	290
83	Auvergne	63	2	35	176	Heume-l;Église	112	0	112
83	Auvergne	63	2	49	177	Isserteaux	410	3	413
83	Auvergne	63	3	19	178	Issoire	14012	463	14475
83	Auvergne	63	1	02	179	Job	1081	24	1105
83	Auvergne	63	5	24	180	Joze	1050	26	1076
83	Auvergne	63	4	14	181	Jozerand	453	12	465
83	Auvergne	63	3	20	182	Jumeaux	707	14	721
83	Auvergne	63	3	45	183	Labessette	71	1	72
83	Auvergne	63	5	09	184	Lachaux	315	3	318
83	Auvergne	63	3	20	185	Lamontgie	587	9	596
83	Auvergne	63	4	29	186	Landogne	232	7	239
83	Auvergne	63	4	26	187	Lapeyrouse	567	15	582
83	Auvergne	63	2	49	188	Laps	558	7	565
83	Auvergne	63	2	35	189	Laqueuille	374	6	380
83	Auvergne	63	3	45	190	Larodde	268	10	278
83	Auvergne	63	2	07	191	Lastic	110	5	115
83	Auvergne	63	2	30	193	Lempdes	8354	308	8662
83	Auvergne	63	5	22	194	Lempty	357	7	364
83	Auvergne	63	5	22	195	Lezoux	5599	106	5705
83	Auvergne	63	5	24	196	Limons	704	9	713
83	Auvergne	63	4	25	197	Lisseuil	91	3	94
83	Auvergne	63	4	23	198	Loubeyrat	1171	18	1189
83	Auvergne	63	3	08	199	Ludesse	458	6	464
83	Auvergne	63	2	30	200	Lussat	899	17	916
83	Auvergne	63	5	24	201	Luzillat	974	30	1004
83	Auvergne	63	3	03	202	Madriat	117	0	117
83	Auvergne	63	4	34	203	Malauzat	1063	28	1091
83	Auvergne	63	2	59	204	Malintrat	941	17	958
83	Auvergne	63	2	49	205	Manglieu	454	8	462
83	Auvergne	63	4	23	206	Manzat	1230	50	1280
83	Auvergne	63	1	27	207	Marat	832	20	852
83	Auvergne	63	4	25	208	Marcillat	242	5	247
83	Auvergne	63	3	40	209	Mareugheol	175	3	178
83	Auvergne	63	5	24	210	Maringues	2748	57	2805
83	Auvergne	63	1	02	211	Marsac-en-Livradois	1447	47	1494
83	Auvergne	63	4	34	212	Marsat	1197	42	1239
83	Auvergne	63	2	30	213	Les Martres-d;Artière	1982	55	2037
83	Auvergne	63	2	48	214	Les Martres-de-Veyre	3928	118	4046
83	Auvergne	63	4	17	215	Martres-sur-Morge	556	13	569
83	Auvergne	63	2	06	216	Mauzun	95	2	97
83	Auvergne	63	1	04	218	Mayres	181	10	191
83	Auvergne	63	2	35	219	Mazaye	697	13	710
83	Auvergne	63	3	03	220	Mazoires	101	7	108
83	Auvergne	63	1	50	221	Medeyrolles	113	2	115
83	Auvergne	63	3	19	222	Meilhaud	547	7	554
83	Auvergne	63	4	25	223	Menat	581	10	591
83	Auvergne	63	4	33	224	Ménétrol	1576	21	1597
83	Auvergne	63	2	07	225	Messeix	1120	30	1150
83	Auvergne	63	2	47	226	Mezel	1902	45	1947
83	Auvergne	63	2	49	227	Mirefleurs	2295	56	2351
83	Auvergne	63	4	29	228	Miremont	329	10	339
83	Auvergne	63	2	47	229	Moissat	1082	14	1096
83	Auvergne	63	1	36	230	Le Monestier	194	7	201
83	Auvergne	63	5	43	231	La Monnerie-le-Montel	1995	28	2023
83	Auvergne	63	4	32	232	Mons	432	13	445
83	Auvergne	63	2	35	236	Mont-Dore	1356	36	1392
83	Auvergne	63	4	26	233	Montaigut	1037	27	1064
83	Auvergne	63	3	08	234	Montaigut-le-Blanc	776	13	789
83	Auvergne	63	4	14	235	Montcel	420	10	430
83	Auvergne	63	4	29	237	Montel-de-Gelat	510	5	515
83	Auvergne	63	4	31	238	Montfermy	208	6	214
83	Auvergne	63	2	06	239	Montmorin	610	9	619
83	Auvergne	63	4	01	240	Montpensier	410	13	423
83	Auvergne	63	3	19	241	Montpeyroux	366	13	379
83	Auvergne	63	3	40	242	Moriat	377	4	381
83	Auvergne	63	4	26	243	Moureuille	306	4	310
83	Auvergne	63	4	33	244	La Moutade	484	9	493
83	Auvergne	63	4	34	245	Mozac	3755	106	3861
83	Auvergne	63	2	35	246	Murat-le-Quaire	475	21	496
83	Auvergne	63	3	05	247	Murol	547	9	556
83	Auvergne	63	2	35	248	Nébouzat	787	14	801
83	Auvergne	63	5	22	249	Néronde-sur-Dore	445	16	461
83	Auvergne	63	3	08	250	Neschers	870	18	888
83	Auvergne	63	4	25	251	Neuf-Église	294	11	305
83	Auvergne	63	2	06	252	Neuville	342	9	351
83	Auvergne	63	5	09	253	Noalhat	232	5	237
83	Auvergne	63	2	61	254	Nohanent	1878	37	1915
83	Auvergne	63	3	40	255	Nonette	322	5	327
83	Auvergne	63	1	04	256	Novacelles	152	5	157
83	Auvergne	63	2	35	257	Olby	696	8	704
83	Auvergne	63	1	27	258	Olliergues	776	35	811
83	Auvergne	63	2	37	259	Olloix	311	4	315
83	Auvergne	63	5	15	260	Olmet	143	4	147
83	Auvergne	63	3	19	261	Orbeil	815	18	833
83	Auvergne	63	2	48	262	Orcet	2718	53	2771
83	Auvergne	63	2	61	263	Orcines	3296	91	3387
83	Auvergne	63	2	35	264	Orcival	249	2	251
83	Auvergne	63	5	22	265	Orléat	2040	53	2093
83	Auvergne	63	3	40	266	Orsonnette	204	6	210
83	Auvergne	63	5	43	267	Palladuc	542	22	564
83	Auvergne	63	3	19	268	Pardines	208	2	210
83	Auvergne	63	2	49	269	Parent	790	17	807
83	Auvergne	63	3	44	270	Parentignat	476	28	504
83	Auvergne	63	5	09	271	Paslières	1561	23	1584
83	Auvergne	63	2	55	272	Pérignat-lès-Sarliève	2696	55	2751
83	Auvergne	63	2	06	273	Pérignat-sur-Allier	1445	35	1480
83	Auvergne	63	2	35	274	Perpezat	424	12	436
83	Auvergne	63	3	19	275	Perrier	829	24	853
83	Auvergne	63	5	22	276	Peschadoires	2111	52	2163
83	Auvergne	63	3	20	277	Peslières	69	0	69
83	Auvergne	63	4	33	278	Pessat-Villeneuve	507	9	516
83	Auvergne	63	3	21	279	Picherande	354	17	371
83	Auvergne	63	2	49	280	Pignols	295	6	301
83	Auvergne	63	4	28	281	Pionsat	1089	28	1117
83	Auvergne	63	2	48	282	Plauzat	1484	20	1504
83	Auvergne	63	2	30	284	Pont-du-Château	10612	279	10891
83	Auvergne	63	4	29	283	Pontaumur	743	125	868
83	Auvergne	63	4	31	285	Pontgibaud	731	17	748
83	Auvergne	63	4	25	286	Pouzol	282	2	284
83	Auvergne	63	3	44	287	Les Pradeaux	302	14	316
83	Auvergne	63	4	14	288	Prompsat	435	7	442
83	Auvergne	63	2	18	289	Prondines	260	6	266
83	Auvergne	63	4	31	290	Pulvérières	374	7	381
83	Auvergne	63	5	09	291	Puy-Guillaume	2622	55	2677
83	Auvergne	63	4	29	292	Puy-Saint-Gulmier	142	0	142
83	Auvergne	63	4	28	293	Le Quartier	207	8	215
83	Auvergne	63	4	23	294	Queuille	268	7	275
83	Auvergne	63	4	32	295	Randan	1549	59	1608
83	Auvergne	63	2	47	296	Ravel	700	14	714
83	Auvergne	63	2	47	297	Reignat	345	5	350
83	Auvergne	63	5	15	298	La Renaudie	113	6	119
83	Auvergne	63	3	03	299	Rentières	103	3	106
83	Auvergne	63	4	99	300	Riom	17941	743	18684
83	Auvergne	63	5	09	301	Ris	746	14	760
83	Auvergne	63	2	48	302	La Roche-Blanche	3188	90	3278
83	Auvergne	63	3	03	303	Roche-Charles-la-Mayrand	49	0	49
83	Auvergne	63	4	28	304	Roche-d;Agoux	90	2	92
83	Auvergne	63	2	49	306	La Roche-Noire	619	11	630
83	Auvergne	63	2	35	305	Rochefort-Montagne	897	100	997
83	Auvergne	63	2	55	307	Romagnat	8089	266	8355
83	Auvergne	63	2	61	308	Royat	4473	94	4567
83	Auvergne	63	1	50	309	Saillant	282	13	295
83	Auvergne	63	4	01	311	Saint-Agoulin	310	3	313
83	Auvergne	63	1	04	312	Saint-Alyre-d;Arlanc	172	4	176
83	Auvergne	63	3	03	313	Saint-Alyre-ès-Montagne	162	5	167
83	Auvergne	63	1	36	314	Saint-Amant-Roche-Savine	533	30	563
83	Auvergne	63	2	37	315	Saint-Amant-Tallende	1835	36	1871
83	Auvergne	63	4	32	317	Saint-André-le-Coq	487	18	505
83	Auvergne	63	4	23	318	Saint-Angel	393	12	405
83	Auvergne	63	1	38	319	Saint-Anthème	736	25	761
83	Auvergne	63	4	29	320	Saint-Avit	257	6	263
83	Auvergne	63	3	19	321	Saint-Babel	907	25	932
83	Auvergne	63	4	17	322	Saint-Beauzire	2106	38	2144
83	Auvergne	63	1	41	323	Saint-Bonnet-le-Bourg	146	2	148
83	Auvergne	63	1	41	324	Saint-Bonnet-le-Chastel	237	10	247
83	Auvergne	63	2	47	325	Saint-Bonnet-lès-Allier	425	5	430
83	Auvergne	63	2	35	326	Saint-Bonnet-près-Orcival	446	6	452
83	Auvergne	63	4	33	327	Saint-Bonnet-près-Riom	1988	38	2026
83	Auvergne	63	3	08	330	Saint-Cirgues-sur-Couze	308	3	311
83	Auvergne	63	4	32	332	Saint-Clément-de-Régnat	506	25	531
83	Auvergne	63	1	38	331	Saint-Clément-de-Valorgue	221	3	224
83	Auvergne	63	4	32	333	Saint-Denis-Combarnazat	217	1	218
83	Auvergne	63	2	39	334	Saint-Dier-d;Auvergne	573	48	621
83	Auvergne	63	3	05	335	Saint-Diéry	374	2	376
83	Auvergne	63	3	21	336	Saint-Donat	244	6	250
83	Auvergne	63	1	36	337	Saint-Éloy-la-Glacière	62	2	64
83	Auvergne	63	4	26	338	Saint-Éloy-les-Mines	3657	171	3828
83	Auvergne	63	4	29	339	Saint-Étienne-des-Champs	145	1	146
83	Auvergne	63	3	44	340	Saint-Étienne-sur-Usson	260	3	263
83	Auvergne	63	1	02	341	Saint-Ferréol-des-Côtes	548	27	575
83	Auvergne	63	3	08	342	Saint-Floret	268	8	276
83	Auvergne	63	2	39	343	Saint-Flour	259	13	272
83	Auvergne	63	4	25	344	Saint-Gal-sur-Sioule	127	1	128
83	Auvergne	63	2	56	345	Saint-Genès-Champanelle	3155	161	3316
83	Auvergne	63	3	21	346	Saint-Genès-Champespe	234	11	245
83	Auvergne	63	4	01	347	Saint-Genès-du-Retz	495	17	512
83	Auvergne	63	3	44	348	Saint-Genès-la-Tourette	183	2	185
83	Auvergne	63	4	23	349	Saint-Georges-de-Mons	2151	44	2195
83	Auvergne	63	2	49	350	Saint-Georges-sur-Allier	1159	31	1190
83	Auvergne	63	1	41	353	Saint-Germain-l;Herm	497	38	535
83	Auvergne	63	3	40	352	Saint-Germain-Lembron	1825	35	1860
83	Auvergne	63	2	18	351	Saint-Germain-près-Herment	77	5	82
83	Auvergne	63	4	42	354	Saint-Gervais-d;Auvergne	1300	144	1444
83	Auvergne	63	1	27	355	Saint-Gervais-sous-Meymont	257	5	262
83	Auvergne	63	3	40	356	Saint-Gervazy	308	6	314
83	Auvergne	63	3	03	357	Saint-Hérent	101	3	104
83	Auvergne	63	4	28	360	Saint-Hilaire	194	4	198
83	Auvergne	63	4	14	358	Saint-Hilaire-la-Croix	309	3	312
83	Auvergne	63	4	29	359	Saint-Hilaire-les-Monges	100	1	101
83	Auvergne	63	4	17	362	Saint-Ignat	780	12	792
83	Auvergne	63	4	31	363	Saint-Jacques-d;Ambur	290	6	296
83	Auvergne	63	5	22	364	Saint-Jean-d;Heurs	616	5	621
83	Auvergne	63	2	39	365	Saint-Jean-des-Ollières	462	5	467
83	Auvergne	63	3	44	366	Saint-Jean-en-Val	339	9	348
83	Auvergne	63	3	20	367	Saint-Jean-Saint-Gervais	105	4	109
83	Auvergne	63	2	06	368	Saint-Julien-de-Coppel	1128	26	1154
83	Auvergne	63	4	42	369	Saint-Julien-la-Geneste	133	6	139
83	Auvergne	63	2	07	370	Saint-Julien-Puy-Lavèze	370	7	377
83	Auvergne	63	1	50	371	Saint-Just	171	4	175
83	Auvergne	63	4	17	372	Saint-Laure	490	15	505
83	Auvergne	63	4	28	373	Saint-Maigner	198	2	200
83	Auvergne	63	3	20	376	Saint-Martin-d;Ollières	143	4	147
83	Auvergne	63	1	02	374	Saint-Martin-des-Olmes	269	8	277
83	Auvergne	63	3	44	375	Saint-Martin-des-Plains	146	2	148
83	Auvergne	63	2	49	378	Saint-Maurice	803	23	826
83	Auvergne	63	4	28	377	Saint-Maurice-près-Pionsat	370	7	377
83	Auvergne	63	4	14	379	Saint-Myon	440	2	442
83	Auvergne	63	3	08	380	Saint-Nectaire	725	15	740
83	Auvergne	63	4	31	381	Saint-Ours	1578	31	1609
83	Auvergne	63	4	25	382	Saint-Pardoux	425	9	434
83	Auvergne	63	3	05	383	Saint-Pierre-Colamine	235	7	242
83	Auvergne	63	1	27	384	Saint-Pierre-la-Bourlhonne	137	3	140
83	Auvergne	63	4	31	385	Saint-Pierre-le-Chastel	384	2	386
83	Auvergne	63	2	35	386	Saint-Pierre-Roche	420	8	428
83	Auvergne	63	4	32	387	Saint-Priest-Bramefant	884	28	912
83	Auvergne	63	4	42	388	Saint-Priest-des-Champs	691	33	724
83	Auvergne	63	3	44	389	Saint-Quentin-sur-Sauxillanges	99	3	102
83	Auvergne	63	4	25	390	Saint-Quintin-sur-Sioule	337	5	342
83	Auvergne	63	4	25	391	Saint-Rémy-de-Blot	224	7	231
83	Auvergne	63	3	44	392	Saint-Rémy-de-Chargnat	552	8	560
83	Auvergne	63	5	43	393	Saint-Rémy-sur-Durolle	1873	32	1905
83	Auvergne	63	1	38	394	Saint-Romain	237	5	242
83	Auvergne	63	2	37	395	Saint-Sandoux	886	11	897
83	Auvergne	63	2	37	396	Saint-Saturnin	1024	108	1132
83	Auvergne	63	3	45	397	Saint-Sauves-d;Auvergne	1143	20	1163
83	Auvergne	63	1	04	398	Saint-Sauveur-la-Sagne	113	4	117
83	Auvergne	63	2	07	399	Saint-Sulpice	100	1	101
83	Auvergne	63	4	32	400	Saint-Sylvestre-Pragoulin	1082	29	1111
83	Auvergne	63	3	05	401	Saint-Victor-la-Rivière	243	7	250
83	Auvergne	63	5	43	402	Saint-Victor-Montvianeix	258	13	271
83	Auvergne	63	3	08	403	Saint-Vincent	445	8	453
83	Auvergne	63	3	19	404	Saint-Yvoine	521	8	529
83	Auvergne	63	5	15	310	Sainte-Agathe	197	3	200
83	Auvergne	63	1	41	328	Sainte-Catherine	59	3	62
83	Auvergne	63	4	42	329	Sainte-Christine	157	5	162
83	Auvergne	63	2	49	405	Sallèdes	566	11	577
83	Auvergne	63	4	01	406	Sardon	313	6	319
83	Auvergne	63	2	37	407	Saulzet-le-Froid	261	3	264
83	Auvergne	63	4	42	408	Sauret-Besserve	181	3	184
83	Auvergne	63	3	08	409	Saurier	232	3	235
83	Auvergne	63	2	18	410	Sauvagnat	151	4	155
83	Auvergne	63	3	19	411	Sauvagnat-Sainte-Marthe	511	8	519
83	Auvergne	63	1	50	412	Sauvessanges	534	16	550
83	Auvergne	63	2	48	413	La Sauvetat	661	7	668
83	Auvergne	63	5	15	414	Sauviat	522	12	534
83	Auvergne	63	3	44	415	Sauxillanges	1171	29	1200
83	Auvergne	63	2	07	416	Savennes	92	8	100
83	Auvergne	63	2	59	417	Sayat	2184	38	2222
83	Auvergne	63	5	15	418	Sermentizon	522	12	534
83	Auvergne	63	4	25	419	Servant	524	16	540
83	Auvergne	63	5	22	420	Seychalles	628	25	653
83	Auvergne	63	3	45	421	Singles	169	9	178
83	Auvergne	63	3	19	422	Solignat	468	7	475
83	Auvergne	63	3	44	423	Sugères	572	12	584
83	Auvergne	63	4	17	424	Surat	533	8	541
83	Auvergne	63	2	48	425	Tallende	1583	56	1639
83	Auvergne	63	3	45	426	Tauves	753	14	767
83	Auvergne	63	4	14	427	Teilhède	410	15	425
83	Auvergne	63	4	25	428	Teilhet	299	4	303
83	Auvergne	63	3	03	429	Ternant-les-Eaux	44	0	44
83	Auvergne	63	5	46	430	Thiers	11250	395	11645
83	Auvergne	63	1	02	431	Thiolières	167	3	170
83	Auvergne	63	4	01	432	Thuret	802	41	843
83	Auvergne	63	2	18	433	Tortebesse	53	0	53
83	Auvergne	63	3	21	192	La Tour-d;Auvergne	658	40	698
83	Auvergne	63	2	39	434	Tours-sur-Meymont	522	15	537
83	Auvergne	63	3	08	435	Tourzel-Ronzières	254	3	257
83	Auvergne	63	4	29	436	Tralaigues	84	0	84
83	Auvergne	63	3	21	437	Trémouille-Saint-Loup	143	5	148
83	Auvergne	63	2	39	438	Trézioux	451	6	457
83	Auvergne	63	3	44	439	Usson	270	7	277
83	Auvergne	63	3	05	440	Valbeleix	142	3	145
83	Auvergne	63	1	02	441	Valcivières	214	9	223
83	Auvergne	63	3	20	442	Valz-sous-Châteauneuf	55	2	57
83	Auvergne	63	4	17	443	Varennes-sur-Morge	402	5	407
83	Auvergne	63	3	44	444	Varennes-sur-Usson	248	2	250
83	Auvergne	63	2	47	445	Vassel	237	3	240
83	Auvergne	63	4	01	446	Vensat	434	11	445
83	Auvergne	63	4	28	447	Vergheas	77	1	78
83	Auvergne	63	3	44	448	Vernet-la-Varenne	713	83	796
83	Auvergne	63	2	37	449	Le Vernet-Sainte-Marguerite	278	7	285
83	Auvergne	63	2	18	450	Verneugheol	254	5	259
83	Auvergne	63	2	35	451	Vernines	355	37	392
83	Auvergne	63	3	08	452	Verrières	74	2	76
83	Auvergne	63	2	47	453	Vertaizon	3115	78	3193
83	Auvergne	63	1	27	454	Vertolaye	590	14	604
83	Auvergne	63	2	48	455	Veyre-Monton	3405	82	3487
83	Auvergne	63	2	49	457	Vic-le-Comte	4796	101	4897
83	Auvergne	63	3	40	456	Vichel	296	7	303
83	Auvergne	63	3	40	458	Villeneuve	156	4	160
83	Auvergne	63	4	32	459	Villeneuve-les-Cerfs	506	12	518
83	Auvergne	63	4	29	460	Villosanges	375	7	382
83	Auvergne	63	5	22	461	Vinzelles	316	4	320
83	Auvergne	63	4	26	462	Virlet	273	3	276
83	Auvergne	63	5	43	463	Viscomtat	616	8	624
83	Auvergne	63	4	23	464	Vitrac	331	17	348
83	Auvergne	63	1	50	465	Viverols	404	5	409
83	Auvergne	63	3	19	466	Vodable	200	8	208
83	Auvergne	63	4	29	467	Voingt	54	6	60
83	Auvergne	63	5	15	468	Vollore-Montagne	319	9	328
83	Auvergne	63	5	15	469	Vollore-Ville	714	19	733
83	Auvergne	63	4	34	470	Volvic	4556	126	4682
83	Auvergne	63	4	26	471	Youx	1034	16	1050
83	Auvergne	63	2	49	472	Yronde-et-Buron	637	16	653
83	Auvergne	63	4	14	473	Yssac-la-Tourette	354	13	367
72	Aquitaine	64	3	22	001	Aast	192	2	194
72	Aquitaine	64	3	23	002	Abère	147	3	150
72	Aquitaine	64	3	15	003	Abidos	236	8	244
72	Aquitaine	64	2	38	004	Abitain	101	2	103
72	Aquitaine	64	2	21	005	Abos	487	9	496
72	Aquitaine	64	2	01	006	Accous	426	17	443
72	Aquitaine	64	2	28	007	Agnos	880	41	921
72	Aquitaine	64	1	35	008	Ahaxe-Alciette-Bascassan	291	12	303
72	Aquitaine	64	1	41	009	Ahetze	1809	35	1844
72	Aquitaine	64	1	36	010	Aïcirits-Camou-Suhast	655	14	669
72	Aquitaine	64	1	35	011	Aincille	135	1	136
72	Aquitaine	64	2	20	012	Ainharp	147	5	152
72	Aquitaine	64	1	35	013	Ainhice-Mongelos	161	3	164
72	Aquitaine	64	1	10	014	Ainhoa	683	13	696
72	Aquitaine	64	1	33	016	Aldudes	372	4	376
72	Aquitaine	64	2	39	017	Alos-Sibas-Abense	284	7	291
72	Aquitaine	64	2	39	015	Alçay-Alçabéhéty-Sunharette	232	10	242
72	Aquitaine	64	1	36	018	Amendeuix-Oneix	414	13	427
72	Aquitaine	64	1	36	019	Amorots-Succos	226	4	230
72	Aquitaine	64	2	02	020	Ance	242	12	254
72	Aquitaine	64	3	23	021	Andoins	628	13	641
72	Aquitaine	64	2	38	022	Andrein	133	4	137
72	Aquitaine	64	3	25	023	Angaïs	836	33	869
72	Aquitaine	64	1	90	024	Anglet	38032	1400	39432
72	Aquitaine	64	2	24	025	Angous	109	0	109
72	Aquitaine	64	1	33	026	Anhaux	293	2	295
72	Aquitaine	64	3	23	027	Anos	191	5	196
72	Aquitaine	64	3	18	028	Anoye	150	8	158
72	Aquitaine	64	2	02	029	Aramits	683	30	713
72	Aquitaine	64	1	09	031	Arancou	122	1	123
72	Aquitaine	64	2	24	032	Araujuzon	196	5	201
72	Aquitaine	64	2	24	033	Araux	131	0	131
72	Aquitaine	64	1	36	034	Arbérats-Sillègue	299	5	304
72	Aquitaine	64	1	41	035	Arbonne	2034	34	2068
72	Aquitaine	64	1	36	036	Arbouet-Sussaute	294	5	299
72	Aquitaine	64	3	19	037	Arbus	1099	24	1123
72	Aquitaine	64	1	41	038	Arcangues	3111	96	3207
72	Aquitaine	64	2	28	039	Aren	223	6	229
72	Aquitaine	64	3	47	041	Aressy	624	5	629
72	Aquitaine	64	2	02	040	Arette	1114	44	1158
72	Aquitaine	64	3	03	042	Argagnon	729	26	755
72	Aquitaine	64	3	40	043	Argelos	260	6	266
72	Aquitaine	64	3	05	044	Arget	93	2	95
72	Aquitaine	64	1	13	045	Arhansus	74	0	74
72	Aquitaine	64	1	13	046	Armendarits	380	13	393
72	Aquitaine	64	1	35	047	Arnéguy	252	10	262
72	Aquitaine	64	3	03	048	Arnos	71	0	71
72	Aquitaine	64	1	36	049	Aroue-Ithorots-Olhaïby	244	5	249
72	Aquitaine	64	2	20	050	Arrast-Larrebieu	100	0	100
72	Aquitaine	64	1	36	051	Arraute-Charritte	385	7	392
72	Aquitaine	64	3	18	052	Arricau-Bordes	103	2	105
72	Aquitaine	64	3	23	053	Arrien	154	3	157
72	Aquitaine	64	3	26	054	Arros-de-Nay	791	17	808
72	Aquitaine	64	3	18	056	Arrosès	148	4	152
72	Aquitaine	64	3	26	058	Arthez-d;Asson	501	10	511
72	Aquitaine	64	3	03	057	Arthez-de-Béarn	1796	51	1847
72	Aquitaine	64	3	31	059	Artigueloutan	914	16	930
72	Aquitaine	64	3	19	060	Artiguelouve	1544	47	1591
72	Aquitaine	64	3	03	061	Artix	3471	74	3545
72	Aquitaine	64	2	04	062	Arudy	2230	81	2311
72	Aquitaine	64	3	05	063	Arzacq-Arraziguet	1010	43	1053
72	Aquitaine	64	2	28	064	Asasp-Arros	505	10	515
72	Aquitaine	64	1	34	065	Ascain	4001	103	4104
72	Aquitaine	64	1	33	066	Ascarat	312	19	331
72	Aquitaine	64	3	47	067	Assat	1736	42	1778
72	Aquitaine	64	3	26	068	Asson	2000	45	2045
72	Aquitaine	64	2	16	069	Aste-Béon	283	12	295
72	Aquitaine	64	3	40	070	Astis	303	4	307
72	Aquitaine	64	2	38	071	Athos-Aspis	185	10	195
72	Aquitaine	64	2	17	072	Aubertin	656	16	672
72	Aquitaine	64	3	40	073	Aubin	261	9	270
72	Aquitaine	64	3	11	074	Aubous	51	0	51
72	Aquitaine	64	2	24	075	Audaux	187	118	305
72	Aquitaine	64	3	40	077	Auga	140	6	146
72	Aquitaine	64	3	40	078	Auriac	246	9	255
72	Aquitaine	64	3	18	079	Aurions-Idernes	110	2	112
72	Aquitaine	64	3	19	080	Aussevielle	797	14	811
72	Aquitaine	64	2	20	081	Aussurucq	251	7	258
72	Aquitaine	64	3	37	082	Auterrive	123	7	130
72	Aquitaine	64	2	38	083	Autevielle-Saint-Martin-Bideren	173	3	176
72	Aquitaine	64	3	11	084	Aydie	140	4	144
72	Aquitaine	64	2	01	085	Aydius	100	1	101
72	Aquitaine	64	1	14	086	Ayherre	987	26	1013
72	Aquitaine	64	3	29	087	Baigts-de-Béarn	811	18	829
72	Aquitaine	64	3	29	088	Balansun	244	5	249
72	Aquitaine	64	3	22	089	Baleix	137	0	137
72	Aquitaine	64	3	11	090	Baliracq-Maumusson	145	3	148
72	Aquitaine	64	3	26	091	Baliros	367	11	378
72	Aquitaine	64	1	33	092	Banca	335	3	338
72	Aquitaine	64	2	20	093	Barcus	734	17	751
72	Aquitaine	64	1	09	094	Bardos	1620	49	1669
72	Aquitaine	64	3	23	095	Barinque	587	20	607
72	Aquitaine	64	2	38	096	Barraute-Camu	158	8	166
72	Aquitaine	64	3	32	097	Barzun	595	7	602
72	Aquitaine	64	3	18	098	Bassillon-Vauzé	72	1	73
72	Aquitaine	64	1	41	100	Bassussarry	2405	95	2500
72	Aquitaine	64	2	24	099	Bastanès	102	32	134
72	Aquitaine	64	1	14	289	La Bastide-Clairence	997	19	1016
72	Aquitaine	64	3	25	101	Baudreix	528	116	644
72	Aquitaine	64	1	96	102	Bayonne	44820	1371	46191
72	Aquitaine	64	3	22	103	Bédeille	195	6	201
72	Aquitaine	64	2	01	104	Bedous	550	17	567
72	Aquitaine	64	1	36	105	Béguios	272	12	284
72	Aquitaine	64	1	36	106	Béhasque-Lapiste	434	15	449
72	Aquitaine	64	1	35	107	Béhorléguy	77	2	79
72	Aquitaine	64	3	37	108	Bellocq	895	32	927
72	Aquitaine	64	3	25	109	Bénéjacq	1899	44	1943
72	Aquitaine	64	3	22	111	Bentayou-Sérée	110	2	112
72	Aquitaine	64	2	16	110	Béost	213	4	217
72	Aquitaine	64	3	37	112	Bérenx	489	6	495
72	Aquitaine	64	1	09	113	Bergouey-Viellenave	127	2	129
72	Aquitaine	64	3	23	114	Bernadets	542	7	549
72	Aquitaine	64	2	20	115	Berrogain-Laruns	106	5	111
72	Aquitaine	64	2	04	116	Bescat	271	2	273
72	Aquitaine	64	3	15	117	Bésingrand	122	1	123
72	Aquitaine	64	3	18	118	Bétracq	49	3	52
72	Aquitaine	64	3	25	119	Beuste	515	17	532
72	Aquitaine	64	3	19	121	Beyrie-en-Béarn	179	6	185
72	Aquitaine	64	1	36	120	Beyrie-sur-Joyeuse	513	7	520
72	Aquitaine	64	1	91	122	Biarritz	25306	688	25994
72	Aquitaine	64	1	09	123	Bidache	1284	45	1329
72	Aquitaine	64	1	33	124	Bidarray	649	18	667
72	Aquitaine	64	1	34	125	Bidart	6206	152	6358
72	Aquitaine	64	2	27	126	Bidos	1166	37	1203
72	Aquitaine	64	2	16	127	Bielle	444	16	460
72	Aquitaine	64	2	16	128	Bilhères	163	3	166
72	Aquitaine	64	3	51	129	Billère	13142	297	13439
72	Aquitaine	64	1	45	130	Biriatou	1087	33	1120
72	Aquitaine	64	3	15	131	Biron	605	16	621
72	Aquitaine	64	3	47	132	Bizanos	4779	184	4963
72	Aquitaine	64	3	25	133	Boeil-Bezing	1234	31	1265
72	Aquitaine	64	1	12	134	Bonloc	371	10	381
72	Aquitaine	64	3	29	135	Bonnut	674	18	692
72	Aquitaine	64	2	01	136	Borce	159	1	160
72	Aquitaine	64	3	25	137	Bordères	655	28	683
72	Aquitaine	64	3	25	138	Bordes	2485	49	2534
72	Aquitaine	64	3	46	139	Bosdarros	1014	20	1034
72	Aquitaine	64	1	07	140	Boucau	7762	174	7936
72	Aquitaine	64	3	11	141	Boueilh-Boueilho-Lasque	357	15	372
72	Aquitaine	64	3	19	142	Bougarber	725	18	743
72	Aquitaine	64	3	05	143	Bouillon	147	2	149
72	Aquitaine	64	3	03	144	Boumourt	134	3	137
72	Aquitaine	64	3	26	145	Bourdettes	412	9	421
72	Aquitaine	64	3	40	146	Bournos	339	6	345
72	Aquitaine	64	1	14	147	Briscous	2633	67	2700
72	Aquitaine	64	3	26	148	Bruges-Capbis-Mifaget	945	19	964
72	Aquitaine	64	2	24	149	Bugnein	228	8	236
72	Aquitaine	64	1	13	150	Bunus	152	4	156
72	Aquitaine	64	2	38	151	Burgaronne	99	6	105
72	Aquitaine	64	3	23	152	Buros	1771	95	1866
72	Aquitaine	64	3	11	153	Burosse-Mendousse	58	0	58
72	Aquitaine	64	1	35	154	Bussunarits-Sarrasquette	169	4	173
72	Aquitaine	64	1	35	155	Bustince-Iriberry	93	6	99
72	Aquitaine	64	2	27	156	Buziet	460	8	468
72	Aquitaine	64	2	04	157	Buzy	934	12	946
72	Aquitaine	64	3	05	158	Cabidos	189	6	195
72	Aquitaine	64	3	18	159	Cadillon	101	10	111
72	Aquitaine	64	1	10	160	Cambo-les-Bains	6518	152	6670
72	Aquitaine	64	1	09	161	Came	847	17	864
72	Aquitaine	64	2	39	162	Camou-Cihigue	103	4	107
72	Aquitaine	64	2	27	165	Cardesse	260	2	262
72	Aquitaine	64	1	35	166	Caro	184	10	194
72	Aquitaine	64	3	40	167	Carrère	200	4	204
72	Aquitaine	64	3	37	168	Carresse-Cassaber	639	13	652
72	Aquitaine	64	3	37	170	Castagnède	195	8	203
72	Aquitaine	64	3	03	171	Casteide-Cami	239	8	247
72	Aquitaine	64	3	03	172	Casteide-Candau	221	1	222
72	Aquitaine	64	3	22	173	Casteide-Doat	133	6	139
72	Aquitaine	64	3	22	174	Castéra-Loubix	54	0	54
72	Aquitaine	64	2	04	175	Castet	160	6	166
72	Aquitaine	64	2	38	176	Castetbon	170	4	174
72	Aquitaine	64	3	29	177	Castétis	600	17	617
72	Aquitaine	64	2	24	178	Castetnau-Camblong	434	12	446
72	Aquitaine	64	3	15	179	Castetner	154	3	157
72	Aquitaine	64	3	11	180	Castetpugon	182	2	184
72	Aquitaine	64	3	03	181	Castillon (Canton d;Arthez-de-Béarn)	289	11	300
72	Aquitaine	64	3	18	182	Castillon (Canton de Lembeye)	56	1	57
72	Aquitaine	64	3	19	183	Caubios-Loos	491	14	505
72	Aquitaine	64	3	03	184	Cescau	517	11	528
72	Aquitaine	64	2	01	185	Cette-Eygun	79	4	83
72	Aquitaine	64	2	24	186	Charre	200	12	212
72	Aquitaine	64	2	20	187	Charritte-de-Bas	242	7	249
72	Aquitaine	64	2	20	188	Chéraute	1115	201	1316
72	Aquitaine	64	1	45	189	Ciboure	6824	229	7053
72	Aquitaine	64	3	40	190	Claracq	230	8	238
72	Aquitaine	64	3	25	191	Coarraze	2113	130	2243
72	Aquitaine	64	3	11	192	Conchez-de-Béarn	123	3	126
72	Aquitaine	64	3	18	193	Corbère-Abères	107	4	111
72	Aquitaine	64	3	18	194	Coslédaà-Lube-Boast	377	2	379
72	Aquitaine	64	3	05	195	Coublucq	105	1	106
72	Aquitaine	64	3	18	196	Crouseilles	144	1	145
72	Aquitaine	64	2	21	197	Cuqueron	180	6	186
72	Aquitaine	64	3	19	198	Denguin	1760	37	1797
72	Aquitaine	64	3	11	199	Diusse	153	3	156
72	Aquitaine	64	3	03	200	Doazon	189	3	192
72	Aquitaine	64	2	24	201	Dognen	210	4	214
72	Aquitaine	64	1	36	202	Domezain-Berraute	508	49	557
72	Aquitaine	64	3	40	203	Doumy	279	7	286
72	Aquitaine	64	2	16	204	Eaux-Bonnes	415	8	423
72	Aquitaine	64	3	37	205	Escos	254	6	260
72	Aquitaine	64	2	01	206	Escot	131	7	138
72	Aquitaine	64	2	27	207	Escou	377	9	386
72	Aquitaine	64	3	23	208	Escoubès	331	5	336
72	Aquitaine	64	2	27	209	Escout	417	18	435
72	Aquitaine	64	3	18	210	Escurès	157	7	164
72	Aquitaine	64	3	23	211	Eslourenties-Daban	243	7	250
72	Aquitaine	64	3	23	212	Espéchède	163	2	165
72	Aquitaine	64	1	10	213	Espelette	1974	53	2027
72	Aquitaine	64	2	20	214	Espès-Undurein	501	25	526
72	Aquitaine	64	2	38	215	Espiute	114	2	116
72	Aquitaine	64	3	32	216	Espoey	1025	17	1042
72	Aquitaine	64	2	28	217	Esquiule	537	15	552
72	Aquitaine	64	1	35	218	Estérençuby	354	2	356
72	Aquitaine	64	2	17	219	Estialescq	250	7	257
72	Aquitaine	64	2	27	220	Estos	527	22	549
72	Aquitaine	64	1	36	221	Etcharry	128	2	130
72	Aquitaine	64	2	39	222	Etchebar	66	0	66
72	Aquitaine	64	2	01	223	Etsaut	80	2	82
72	Aquitaine	64	2	27	224	Eysus	704	23	727
72	Aquitaine	64	2	02	225	Féas	441	24	465
72	Aquitaine	64	3	05	226	Fichous-Riumayou	164	3	167
72	Aquitaine	64	3	23	227	Gabaston	593	11	604
72	Aquitaine	64	1	36	228	Gabat	211	10	221
72	Aquitaine	64	1	35	229	Gamarthe	123	2	125
72	Aquitaine	64	3	46	230	Gan	5446	109	5555
72	Aquitaine	64	2	20	231	Garindein	523	14	537
72	Aquitaine	64	3	40	232	Garlède-Mondebat	202	5	207
72	Aquitaine	64	3	11	233	Garlin	1379	41	1420
72	Aquitaine	64	3	05	234	Garos	225	5	230
72	Aquitaine	64	1	36	235	Garris	291	13	304
72	Aquitaine	64	3	18	236	Gayon	57	7	64
72	Aquitaine	64	3	48	237	Gelos	3656	140	3796
72	Aquitaine	64	3	32	238	Ger	1916	51	1967
72	Aquitaine	64	3	18	239	Gerderest	126	1	127
72	Aquitaine	64	2	16	240	Gère-Bélesten	174	4	178
72	Aquitaine	64	2	28	241	Géronce	441	9	450
72	Aquitaine	64	1	36	242	Gestas	66	2	68
72	Aquitaine	64	3	05	243	Géus-d;Arzacq	182	4	186
72	Aquitaine	64	2	28	244	Geüs-d;Oloron	208	6	214
72	Aquitaine	64	2	27	245	Goès	562	16	578
72	Aquitaine	64	3	32	246	Gomer	237	4	241
72	Aquitaine	64	2	20	247	Gotein-Libarrenx	451	14	465
72	Aquitaine	64	1	34	249	Guéthary	1349	43	1392
72	Aquitaine	64	1	09	250	Guiche	907	27	934
72	Aquitaine	64	2	38	251	Guinarthe-Parenties	239	10	249
72	Aquitaine	64	2	28	252	Gurmençon	801	29	830
72	Aquitaine	64	2	24	253	Gurs	401	62	463
72	Aquitaine	64	3	03	254	Hagetaubin	542	14	556
72	Aquitaine	64	1	41	255	Halsou	502	16	518
72	Aquitaine	64	1	12	256	Hasparren	6140	274	6414
72	Aquitaine	64	3	26	257	Haut-de-Bosdarros	286	5	291
72	Aquitaine	64	2	39	258	Haux	93	2	95
72	Aquitaine	64	1	13	259	Hélette	703	5	708
72	Aquitaine	64	1	45	260	Hendaye	15370	432	15802
72	Aquitaine	64	2	27	261	Herrère	362	9	371
72	Aquitaine	64	3	23	262	Higuères-Souye	284	6	290
72	Aquitaine	64	2	38	263	L; Hôpital-d;Orion	161	6	167
72	Aquitaine	64	2	20	264	L; Hôpital-Saint-Blaise	83	0	83
72	Aquitaine	64	1	13	265	Hosta	74	3	77
72	Aquitaine	64	3	32	266	Hours	235	2	237
72	Aquitaine	64	1	13	267	Ibarrolle	100	0	100
72	Aquitaine	64	2	20	268	Idaux-Mendy	268	7	275
72	Aquitaine	64	3	31	269	Idron	3983	173	4156
72	Aquitaine	64	3	25	270	Igon	946	118	1064
72	Aquitaine	64	1	13	271	Iholdy	521	6	527
72	Aquitaine	64	1	36	272	Ilharre	139	4	143
72	Aquitaine	64	1	13	273	Irissarry	875	24	899
72	Aquitaine	64	1	33	274	Irouléguy	326	7	333
72	Aquitaine	64	1	35	275	Ispoure	595	16	611
72	Aquitaine	64	2	02	276	Issor	253	1	254
72	Aquitaine	64	1	14	277	Isturits	450	4	454
72	Aquitaine	64	1	10	279	Itxassou	2032	75	2107
72	Aquitaine	64	2	04	280	Izeste	458	12	470
72	Aquitaine	64	2	24	281	Jasses	161	2	163
72	Aquitaine	64	1	41	282	Jatxou	1099	28	1127
72	Aquitaine	64	1	35	283	Jaxu	163	6	169
72	Aquitaine	64	3	46	284	Jurançon	6963	287	7250
72	Aquitaine	64	1	13	285	Juxue	231	4	235
72	Aquitaine	64	3	15	286	Laà-Mondrans	402	18	420
72	Aquitaine	64	2	38	287	Laàs	112	3	115
72	Aquitaine	64	3	03	288	Labastide-Cézéracq	555	10	565
72	Aquitaine	64	3	03	290	Labastide-Monréjeau	536	9	545
72	Aquitaine	64	3	37	291	Labastide-Villefranche	342	5	347
72	Aquitaine	64	3	32	292	Labatmale	263	6	269
72	Aquitaine	64	3	22	293	Labatut	162	1	163
72	Aquitaine	64	1	36	294	Labets-Biscay	154	1	155
72	Aquitaine	64	3	03	295	Labeyrie	108	2	110
72	Aquitaine	64	3	03	296	Lacadée	137	3	140
72	Aquitaine	64	1	35	297	Lacarre	153	4	157
72	Aquitaine	64	2	39	298	Lacarry-Arhan-Charritte-de-Haut	129	2	131
72	Aquitaine	64	2	17	299	Lacommande	231	5	236
72	Aquitaine	64	3	95	300	Lacq	705	15	720
72	Aquitaine	64	3	15	301	Lagor	1217	24	1241
72	Aquitaine	64	3	25	302	Lagos	464	18	482
72	Aquitaine	64	2	39	303	Laguinge-Restoue	174	8	182
72	Aquitaine	64	1	52	304	Lahonce	2066	52	2118
72	Aquitaine	64	3	37	305	Lahontan	467	9	476
72	Aquitaine	64	2	21	306	Lahourcade	730	24	754
72	Aquitaine	64	3	18	307	Lalongue	199	6	205
72	Aquitaine	64	3	40	308	Lalonquette	279	11	290
72	Aquitaine	64	3	22	309	Lamayou	183	5	188
72	Aquitaine	64	2	02	310	Lanne-en-Barétous	492	17	509
72	Aquitaine	64	3	18	311	Lannecaube	165	0	165
72	Aquitaine	64	3	29	312	Lanneplaà	321	7	328
72	Aquitaine	64	1	13	313	Lantabat	292	5	297
72	Aquitaine	64	1	13	314	Larceveau-Arros-Cibits	405	5	410
72	Aquitaine	64	3	46	315	Laroin	946	27	973
72	Aquitaine	64	2	39	316	Larrau	199	1	200
72	Aquitaine	64	1	41	317	Larressore	1613	46	1659
72	Aquitaine	64	3	05	318	Larreule	160	8	168
72	Aquitaine	64	1	36	319	Larribar-Sorhapuru	190	4	194
72	Aquitaine	64	2	16	320	Laruns	1283	40	1323
72	Aquitaine	64	3	40	321	Lasclaveries	262	11	273
72	Aquitaine	64	1	33	322	Lasse	290	5	295
72	Aquitaine	64	3	18	323	Lasserre	95	4	99
72	Aquitaine	64	2	17	324	Lasseube	1679	37	1716
72	Aquitaine	64	2	17	325	Lasseubetat	180	6	186
72	Aquitaine	64	2	24	326	Lay-Lamidou	121	3	124
72	Aquitaine	64	1	35	327	Lecumberry	183	2	185
72	Aquitaine	64	2	27	328	Ledeuix	998	44	1042
72	Aquitaine	64	3	31	329	Lée	1198	52	1250
72	Aquitaine	64	2	01	330	Lées-Athas	291	11	302
72	Aquitaine	64	3	18	331	Lembeye	763	14	777
72	Aquitaine	64	3	40	332	Lème	163	2	165
72	Aquitaine	64	3	37	334	Léren	226	8	234
72	Aquitaine	64	3	19	335	Lescar	9981	536	10517
72	Aquitaine	64	2	01	336	Lescun	179	1	180
72	Aquitaine	64	3	18	337	Lespielle	125	2	127
72	Aquitaine	64	3	23	338	Lespourcy	171	0	171
72	Aquitaine	64	3	25	339	Lestelle-Bétharram	843	138	981
72	Aquitaine	64	2	39	340	Lichans-Sunhar	67	4	71
72	Aquitaine	64	2	24	341	Lichos	140	1	141
72	Aquitaine	64	2	39	342	Licq-Athérey	243	8	251
72	Aquitaine	64	3	32	343	Limendous	489	8	497
72	Aquitaine	64	3	32	344	Livron	419	4	423
72	Aquitaine	64	1	36	345	Lohitzun-Oyhercq	201	7	208
72	Aquitaine	64	3	23	346	Lombia	197	5	202
72	Aquitaine	64	3	19	348	Lons	12147	417	12564
72	Aquitaine	64	3	05	347	Lonçon	161	6	167
72	Aquitaine	64	3	15	349	Loubieng	453	10	463
72	Aquitaine	64	1	10	350	Louhossoa	887	13	900
72	Aquitaine	64	2	01	351	Lourdios-Ichère	151	5	156
72	Aquitaine	64	3	32	352	Lourenties	352	9	361
72	Aquitaine	64	2	04	353	Louvie-Juzon	1101	30	1131
72	Aquitaine	64	2	16	354	Louvie-Soubiron	113	7	120
72	Aquitaine	64	3	05	355	Louvigny	125	4	129
72	Aquitaine	64	3	18	356	Luc-Armau	112	1	113
72	Aquitaine	64	3	18	357	Lucarré	62	0	62
72	Aquitaine	64	3	32	358	Lucgarier	284	14	298
72	Aquitaine	64	2	21	359	Lucq-de-Béarn	972	42	1014
72	Aquitaine	64	2	27	360	Lurbe-Saint-Christau	224	3	227
72	Aquitaine	64	3	18	361	Lussagnet-Lusson	168	6	174
72	Aquitaine	64	1	36	362	Luxe-Sumberraute	320	32	352
72	Aquitaine	64	2	04	363	Lys	360	11	371
72	Aquitaine	64	1	12	364	Macaye	550	13	563
72	Aquitaine	64	3	05	365	Malaussanne	411	11	422
72	Aquitaine	64	3	11	366	Mascaraàs-Haron	125	1	126
72	Aquitaine	64	3	15	367	Maslacq	825	27	852
72	Aquitaine	64	1	36	368	Masparraute	254	4	258
72	Aquitaine	64	3	18	369	Maspie-Lalonquère-Juillacq	280	8	288
72	Aquitaine	64	3	23	370	Maucor	505	20	525
72	Aquitaine	64	2	20	371	Mauléon-Licharre	3218	216	3434
72	Aquitaine	64	3	22	372	Maure	118	3	121
72	Aquitaine	64	3	48	373	Mazères-Lezons	1940	70	2010
72	Aquitaine	64	3	05	374	Mazerolles	1014	36	1050
72	Aquitaine	64	1	12	375	Méharin	259	1	260
72	Aquitaine	64	3	47	376	Meillon	867	15	882
72	Aquitaine	64	1	12	377	Mendionde	816	16	832
72	Aquitaine	64	2	20	378	Menditte	199	135	334
72	Aquitaine	64	1	35	379	Mendive	193	2	195
72	Aquitaine	64	3	05	380	Méracq	211	8	219
72	Aquitaine	64	2	24	381	Méritein	298	1	299
72	Aquitaine	64	3	03	382	Mesplède	316	13	329
72	Aquitaine	64	3	05	383	Mialos	100	2	102
72	Aquitaine	64	3	40	385	Miossens-Lanusse	225	1	226
72	Aquitaine	64	3	25	386	Mirepeix	1196	24	1220
72	Aquitaine	64	3	19	387	Momas	545	10	555
72	Aquitaine	64	3	18	388	Momy	129	3	132
72	Aquitaine	64	3	18	389	Monassut-Audiracq	347	8	355
72	Aquitaine	64	3	18	390	Moncaup	158	3	161
72	Aquitaine	64	2	20	391	Moncayolle-Larrory-Mendibieu	334	15	349
72	Aquitaine	64	3	11	392	Moncla	102	4	106
72	Aquitaine	64	2	21	393	Monein	4501	125	4626
72	Aquitaine	64	3	18	394	Monpezat	90	5	95
72	Aquitaine	64	3	22	395	Monségur	136	1	137
72	Aquitaine	64	3	15	396	Mont	1025	100	1125
72	Aquitaine	64	3	11	401	Mont-Disse	78	2	80
72	Aquitaine	64	3	05	397	Montagut	125	5	130
72	Aquitaine	64	3	22	398	Montaner	464	11	475
72	Aquitaine	64	3	23	399	Montardon	2323	264	2587
72	Aquitaine	64	3	25	400	Montaut	1076	83	1159
72	Aquitaine	64	2	38	403	Montfort	171	5	176
72	Aquitaine	64	2	39	404	Montory	327	12	339
72	Aquitaine	64	3	23	405	Morlaàs	4165	269	4434
72	Aquitaine	64	3	05	406	Morlanne	589	12	601
72	Aquitaine	64	1	52	407	Mouguerre	4669	148	4817
72	Aquitaine	64	3	11	408	Mouhous	36	1	37
72	Aquitaine	64	2	28	409	Moumour	846	26	872
72	Aquitaine	64	3	15	410	Mourenx	7068	180	7248
72	Aquitaine	64	2	20	411	Musculdy	239	5	244
72	Aquitaine	64	2	24	412	Nabas	122	3	125
72	Aquitaine	64	3	48	413	Narcastet	606	15	621
72	Aquitaine	64	2	38	414	Narp	123	0	123
72	Aquitaine	64	3	40	415	Navailles-Angos	1329	41	1370
72	Aquitaine	64	2	24	416	Navarrenx	1075	107	1182
72	Aquitaine	64	3	97	417	Nay	3218	288	3506
72	Aquitaine	64	3	15	418	Noguères	154	4	158
72	Aquitaine	64	3	31	419	Nousty	1493	28	1521
72	Aquitaine	64	2	24	420	Ogenne-Camptort	243	6	249
72	Aquitaine	64	2	27	421	Ogeu-les-Bains	1226	38	1264
72	Aquitaine	64	2	98	422	Oloron-Sainte-Marie	10800	649	11449
72	Aquitaine	64	2	38	423	Oraàs	164	2	166
72	Aquitaine	64	2	20	424	Ordiarp	526	10	536
72	Aquitaine	64	1	36	425	Orègue	478	11	489
72	Aquitaine	64	2	28	426	Orin	214	10	224
72	Aquitaine	64	2	38	427	Orion	155	8	163
72	Aquitaine	64	2	38	428	Orriule	145	2	147
72	Aquitaine	64	1	36	429	Orsanco	98	3	101
72	Aquitaine	64	3	29	430	Orthez	10982	692	11674
72	Aquitaine	64	3	15	431	Os-Marsillon	453	14	467
72	Aquitaine	64	2	39	432	Ossas-Suhare	86	2	88
72	Aquitaine	64	2	01	433	Osse-en-Aspe	327	6	333
72	Aquitaine	64	2	38	434	Ossenx	42	3	45
72	Aquitaine	64	1	36	435	Osserain-Rivareyte	234	7	241
72	Aquitaine	64	1	33	436	Ossès	855	18	873
72	Aquitaine	64	1	13	437	Ostabat-Asme	198	5	203
72	Aquitaine	64	3	23	438	Ouillon	463	12	475
72	Aquitaine	64	3	31	439	Ousse	1519	41	1560
72	Aquitaine	64	3	15	440	Ozenx-Montestrucq	363	15	378
72	Aquitaine	64	1	36	441	Pagolle	261	9	270
72	Aquitaine	64	2	21	442	Parbayse	251	3	254
72	Aquitaine	64	2	21	443	Pardies	909	32	941
72	Aquitaine	64	3	26	444	Pardies-Piétat	448	9	457
72	Aquitaine	64	3	99	445	Pau	81166	1610	82776
72	Aquitaine	64	3	18	446	Peyrelongue-Abos	146	1	147
72	Aquitaine	64	3	05	447	Piets-Plasence-Moustrou	140	1	141
72	Aquitaine	64	2	27	449	Poey-d;Oloron	184	8	192
72	Aquitaine	64	3	19	448	Poey-de-Lescar	1533	54	1587
72	Aquitaine	64	3	05	450	Pomps	254	4	258
72	Aquitaine	64	3	22	451	Ponson-Debat-Pouts	88	0	88
72	Aquitaine	64	3	22	452	Ponson-Dessus	241	5	246
72	Aquitaine	64	3	32	453	Pontacq	2822	56	2878
72	Aquitaine	64	3	22	454	Pontiacq-Viellepinte	142	4	146
72	Aquitaine	64	3	11	455	Portet	176	9	185
72	Aquitaine	64	3	40	456	Pouliacq	48	0	48
72	Aquitaine	64	3	05	457	Poursiugues-Boucoue	205	9	214
72	Aquitaine	64	2	24	458	Préchacq-Josbaig	286	15	301
72	Aquitaine	64	2	24	459	Préchacq-Navarrenx	168	4	172
72	Aquitaine	64	2	27	460	Précilhon	350	18	368
72	Aquitaine	64	3	29	461	Puyoô	1183	27	1210
72	Aquitaine	64	3	29	462	Ramous	474	7	481
72	Aquitaine	64	2	04	463	Rébénacq	681	23	704
72	Aquitaine	64	3	11	464	Ribarrouy	80	3	83
72	Aquitaine	64	3	23	465	Riupeyrous	162	8	170
72	Aquitaine	64	2	24	466	Rivehaute	246	38	284
72	Aquitaine	64	3	48	467	Rontignon	737	22	759
72	Aquitaine	64	2	20	468	Roquiague	121	5	126
72	Aquitaine	64	3	26	469	Saint-Abit	357	17	374
72	Aquitaine	64	3	23	470	Saint-Armou	602	8	610
72	Aquitaine	64	3	29	471	Saint-Boès	365	26	391
72	Aquitaine	64	3	23	472	Saint-Castin	800	16	816
72	Aquitaine	64	3	37	474	Saint-Dos	135	4	139
72	Aquitaine	64	1	12	476	Saint-Esteben	434	3	437
72	Aquitaine	64	1	33	477	Saint-Étienne-de-Baïgorry	1601	25	1626
72	Aquitaine	64	3	46	478	Saint-Faust	762	32	794
72	Aquitaine	64	3	29	479	Saint-Girons-en-Béarn	159	10	169
72	Aquitaine	64	2	38	480	Saint-Gladie-Arrive-Munein	176	8	184
72	Aquitaine	64	2	28	481	Saint-Goin	227	5	232
72	Aquitaine	64	3	23	482	Saint-Jammes	637	15	652
72	Aquitaine	64	1	34	483	Saint-Jean-de-Luz	12969	479	13448
72	Aquitaine	64	1	35	484	Saint-Jean-le-Vieux	860	14	874
72	Aquitaine	64	1	35	485	Saint-Jean-Pied-de-Port	1471	225	1696
72	Aquitaine	64	3	11	486	Saint-Jean-Poudge	84	2	86
72	Aquitaine	64	1	13	487	Saint-Just-Ibarre	244	9	253
72	Aquitaine	64	3	23	488	Saint-Laurent-Bretagne	425	4	429
72	Aquitaine	64	1	12	489	Saint-Martin-d;Arberoue	324	6	330
72	Aquitaine	64	1	33	490	Saint-Martin-d;Arrossa	470	10	480
72	Aquitaine	64	3	03	491	Saint-Médard	211	6	217
72	Aquitaine	64	1	35	492	Saint-Michel	264	3	267
72	Aquitaine	64	1	36	493	Saint-Palais	1862	130	1992
72	Aquitaine	64	3	37	494	Saint-Pé-de-Léren	258	8	266
72	Aquitaine	64	1	41	495	Saint-Pée-sur-Nivelle	5707	155	5862
72	Aquitaine	64	1	52	496	Saint-Pierre-d;Irube	4390	104	4494
72	Aquitaine	64	3	25	498	Saint-Vincent	384	8	392
72	Aquitaine	64	2	04	473	Sainte-Colome	358	5	363
72	Aquitaine	64	2	39	475	Sainte-Engrâce	206	1	207
72	Aquitaine	64	3	37	499	Salies-de-Béarn	5020	193	5213
72	Aquitaine	64	3	29	500	Salles-Mongiscard	298	5	303
72	Aquitaine	64	3	29	501	Sallespisse	592	20	612
72	Aquitaine	64	1	09	502	Sames	628	12	640
72	Aquitaine	64	3	18	503	Samsons-Lion	76	2	78
72	Aquitaine	64	1	10	504	Sare	2508	56	2564
72	Aquitaine	64	3	15	505	Sarpourenx	274	8	282
72	Aquitaine	64	2	01	506	Sarrance	196	9	205
72	Aquitaine	64	3	23	507	Saubole	127	4	131
72	Aquitaine	64	2	27	508	Saucède	129	6	135
72	Aquitaine	64	2	39	509	Sauguis-Saint-Étienne	164	9	173
72	Aquitaine	64	3	29	510	Sault-de-Navailles	830	16	846
72	Aquitaine	64	3	19	511	Sauvagnon	2989	94	3083
72	Aquitaine	64	3	15	512	Sauvelade	268	5	273
72	Aquitaine	64	2	38	513	Sauveterre-de-Béarn	1384	103	1487
72	Aquitaine	64	3	05	514	Séby	192	3	195
72	Aquitaine	64	3	22	515	Sedze-Maubecq	198	4	202
72	Aquitaine	64	3	23	516	Sedzère	414	10	424
72	Aquitaine	64	3	18	517	Séméacq-Blachon	174	7	181
72	Aquitaine	64	3	23	518	Sendets	851	25	876
72	Aquitaine	64	3	23	519	Serres-Castet	3647	116	3763
72	Aquitaine	64	3	23	520	Serres-Morlaàs	707	36	743
72	Aquitaine	64	3	03	521	Serres-Sainte-Marie	472	12	484
72	Aquitaine	64	3	40	523	Sévignacq	695	9	704
72	Aquitaine	64	2	04	522	Sévignacq-Meyracq	529	3	532
72	Aquitaine	64	3	18	524	Simacourbe	347	6	353
72	Aquitaine	64	3	19	525	Siros	618	22	640
72	Aquitaine	64	3	32	526	Soumoulou	1436	42	1478
72	Aquitaine	64	1	10	527	Souraïde	1247	24	1271
72	Aquitaine	64	1	13	528	Suhescun	194	5	199
72	Aquitaine	64	2	24	529	Sus	383	8	391
72	Aquitaine	64	2	24	530	Susmiou	321	14	335
72	Aquitaine	64	2	38	531	Tabaille-Usquain	39	1	40
72	Aquitaine	64	3	11	532	Tadousse-Ussau	79	4	83
72	Aquitaine	64	2	39	533	Tardets-Sorholus	603	5	608
72	Aquitaine	64	3	11	534	Taron-Sadirac-Viellenave	189	2	191
72	Aquitaine	64	2	21	535	Tarsacq	511	9	520
72	Aquitaine	64	3	40	536	Thèze	832	37	869
72	Aquitaine	64	2	39	537	Trois-Villes	132	3	135
72	Aquitaine	64	1	35	538	Uhart-Cize	691	17	708
72	Aquitaine	64	1	36	539	Uhart-Mixe	223	7	230
72	Aquitaine	64	1	52	540	Urcuit	2172	50	2222
72	Aquitaine	64	3	03	541	Urdès	272	8	280
72	Aquitaine	64	2	01	542	Urdos	71	2	73
72	Aquitaine	64	1	33	543	Urepel	338	4	342
72	Aquitaine	64	3	23	544	Urost	64	1	65
72	Aquitaine	64	1	45	545	Urrugne	8673	237	8910
72	Aquitaine	64	1	14	546	Urt	2195	59	2254
72	Aquitaine	64	1	41	547	Ustaritz	6184	303	6487
72	Aquitaine	64	3	05	548	Uzan	151	3	154
72	Aquitaine	64	3	19	549	Uzein	1255	24	1279
72	Aquitaine	64	3	48	550	Uzos	730	22	752
72	Aquitaine	64	2	27	551	Verdets	281	8	289
72	Aquitaine	64	3	11	552	Vialer	192	3	195
72	Aquitaine	64	3	03	554	Viellenave-d;Arthez	172	6	178
72	Aquitaine	64	2	24	555	Viellenave-de-Navarrenx	168	2	170
72	Aquitaine	64	3	15	556	Vielleségure	394	15	409
72	Aquitaine	64	3	05	557	Vignes	438	12	450
72	Aquitaine	64	1	52	558	Villefranque	2225	44	2269
72	Aquitaine	64	2	20	559	Viodos-Abense-de-Bas	765	28	793
72	Aquitaine	64	3	40	560	Viven	174	7	181
73	Midi-Pyrénées	65	1	01	001	Adast	257	7	264
73	Midi-Pyrénées	65	1	27	002	Adé	741	15	756
73	Midi-Pyrénées	65	2	06	003	Adervielle-Pouchergues	106	5	111
73	Midi-Pyrénées	65	1	01	004	Agos-Vidalos	388	10	398
73	Midi-Pyrénées	65	3	22	005	Allier	379	9	388
73	Midi-Pyrénées	65	2	02	006	Ancizan	312	12	324
73	Midi-Pyrénées	65	3	25	007	Andrest	1414	34	1448
73	Midi-Pyrénées	65	2	19	009	Anères	187	5	192
73	Midi-Pyrénées	65	1	12	011	Les Angles	126	8	134
73	Midi-Pyrénées	65	3	22	010	Angos	225	12	237
73	Midi-Pyrénées	65	2	15	012	Anla	80	2	82
73	Midi-Pyrénées	65	3	18	013	Ansost	56	3	59
73	Midi-Pyrénées	65	2	15	014	Antichan	37	0	37
73	Midi-Pyrénées	65	3	24	015	Antin	121	2	123
73	Midi-Pyrénées	65	2	04	016	Antist	135	3	138
73	Midi-Pyrénées	65	2	26	017	Aragnouet	242	9	251
73	Midi-Pyrénées	65	1	03	018	Arbéost	90	4	94
73	Midi-Pyrénées	65	3	34	019	Arcizac-Adour	519	11	530
73	Midi-Pyrénées	65	1	12	020	Arcizac-ez-Angles	277	6	283
73	Midi-Pyrénées	65	1	01	021	Arcizans-Avant	364	14	378
73	Midi-Pyrénées	65	1	03	022	Arcizans-Dessus	101	4	105
73	Midi-Pyrénées	65	2	02	023	Ardengost	15	0	15
73	Midi-Pyrénées	65	2	04	024	Argelès-Bagnères	120	6	126
73	Midi-Pyrénées	65	1	01	025	Argelès-Gazost	3208	260	3468
73	Midi-Pyrénées	65	3	08	026	Aries-Espénan	64	1	65
73	Midi-Pyrénées	65	2	06	027	Armenteule	60	1	61
73	Midi-Pyrénées	65	3	08	028	Arné	203	3	206
73	Midi-Pyrénées	65	1	03	029	Arras-en-Lavedan	527	13	540
73	Midi-Pyrénées	65	1	12	247	Arrayou-Lahitte	103	5	108
73	Midi-Pyrénées	65	2	02	031	Arreau	797	31	828
73	Midi-Pyrénées	65	1	03	032	Arrens-Marsous	725	16	741
73	Midi-Pyrénées	65	2	05	034	Arrodets	25	0	25
73	Midi-Pyrénées	65	1	12	033	Arrodets-ez-Angles	104	4	108
73	Midi-Pyrénées	65	3	25	035	Artagnan	495	18	513
73	Midi-Pyrénées	65	1	01	036	Artalens-Souin	107	2	109
73	Midi-Pyrénées	65	2	11	037	Artiguemy	84	2	86
73	Midi-Pyrénées	65	1	12	038	Artigues	24	1	25
73	Midi-Pyrénées	65	2	02	039	Aspin-Aure	55	1	56
73	Midi-Pyrénées	65	1	27	040	Aspin-en-Lavedan	246	7	253
73	Midi-Pyrénées	65	2	05	041	Asque	120	5	125
73	Midi-Pyrénées	65	2	07	042	Asté	535	10	545
73	Midi-Pyrénées	65	2	04	043	Astugue	284	7	291
73	Midi-Pyrénées	65	3	17	044	Aubarède	257	4	261
73	Midi-Pyrénées	65	1	03	045	Aucun	260	6	266
73	Midi-Pyrénées	65	2	02	046	Aulon	81	3	84
73	Midi-Pyrénées	65	3	21	047	Aureilhan	7911	257	8168
73	Midi-Pyrénées	65	3	33	048	Aurensan	755	23	778
73	Midi-Pyrénées	65	3	14	049	Auriébat	290	11	301
73	Midi-Pyrénées	65	2	06	050	Avajan	73	3	76
73	Midi-Pyrénées	65	2	19	051	Aventignan	179	7	186
73	Midi-Pyrénées	65	3	16	052	Averan	72	4	76
73	Midi-Pyrénées	65	2	15	053	Aveux	51	2	53
73	Midi-Pyrénées	65	2	05	054	Avezac-Prat-Lahitte	569	6	575
73	Midi-Pyrénées	65	1	01	055	Ayros-Arbouix	291	6	297
73	Midi-Pyrénées	65	1	01	056	Ayzac-Ost	386	16	402
73	Midi-Pyrénées	65	3	16	057	Azereix	992	27	1019
73	Midi-Pyrénées	65	2	26	058	Azet	161	3	164
73	Midi-Pyrénées	65	2	04	059	Bagnères-de-Bigorre	8047	678	8725
73	Midi-Pyrénées	65	2	04	060	Banios	54	5	59
73	Midi-Pyrénées	65	3	18	061	Barbachen	51	1	52
73	Midi-Pyrénées	65	3	22	062	Barbazan-Debat	3470	101	3571
73	Midi-Pyrénées	65	3	23	063	Barbazan-Dessus	133	4	137
73	Midi-Pyrénées	65	1	13	481	Barèges	201	7	208
73	Midi-Pyrénées	65	2	06	064	Bareilles	60	0	60
73	Midi-Pyrénées	65	1	20	065	Barlest	267	24	291
73	Midi-Pyrénées	65	2	02	066	Barrancoueu	32	1	33
73	Midi-Pyrénées	65	3	16	067	Barry	133	3	136
73	Midi-Pyrénées	65	3	08	068	Barthe	16	0	16
73	Midi-Pyrénées	65	2	05	069	La Barthe-de-Neste	1163	34	1197
73	Midi-Pyrénées	65	1	27	070	Bartrès	477	14	491
73	Midi-Pyrénées	65	2	05	071	Batsère	47	2	49
73	Midi-Pyrénées	65	3	33	072	Bazet	1650	24	1674
73	Midi-Pyrénées	65	3	18	073	Bazillac	329	7	336
73	Midi-Pyrénées	65	3	08	074	Bazordan	124	1	125
73	Midi-Pyrénées	65	2	02	075	Bazus-Aure	134	5	139
73	Midi-Pyrénées	65	2	05	076	Bazus-Neste	47	1	48
73	Midi-Pyrénées	65	1	01	077	Beaucens	422	16	438
73	Midi-Pyrénées	65	2	07	078	Beaudéan	400	10	410
73	Midi-Pyrénées	65	3	23	079	Bégole	186	6	192
73	Midi-Pyrénées	65	3	16	080	Bénac	508	18	526
73	Midi-Pyrénées	65	2	11	081	Benqué	77	1	78
73	Midi-Pyrénées	65	1	12	082	Berbérust-Lias	56	1	57
73	Midi-Pyrénées	65	3	22	083	Bernac-Debat	659	13	672
73	Midi-Pyrénées	65	3	22	084	Bernac-Dessus	306	10	316
73	Midi-Pyrénées	65	3	24	085	Bernadets-Debat	104	1	105
73	Midi-Pyrénées	65	3	23	086	Bernadets-Dessus	148	3	151
73	Midi-Pyrénées	65	2	15	087	Bertren	217	4	221
73	Midi-Pyrénées	65	3	08	088	Betbèze	43	3	46
73	Midi-Pyrénées	65	1	13	089	Betpouey	111	0	111
73	Midi-Pyrénées	65	3	08	090	Betpouy	76	0	76
73	Midi-Pyrénées	65	2	04	091	Bettes	67	3	70
73	Midi-Pyrénées	65	2	02	092	Beyrède-Jumet	223	3	226
73	Midi-Pyrénées	65	2	19	093	Bize	217	5	222
73	Midi-Pyrénées	65	2	19	094	Bizous	101	4	105
73	Midi-Pyrénées	65	3	24	095	Bonnefont	351	6	357
73	Midi-Pyrénées	65	2	11	096	Bonnemazon	83	0	83
73	Midi-Pyrénées	65	3	10	097	Bonrepos	192	5	197
73	Midi-Pyrénées	65	1	01	098	Boô-Silhen	278	13	291
73	Midi-Pyrénées	65	2	06	099	Bordères-Louron	158	3	161
73	Midi-Pyrénées	65	3	33	100	Bordères-sur-l;Échez	4243	161	4404
73	Midi-Pyrénées	65	3	23	101	Bordes	726	26	752
73	Midi-Pyrénées	65	3	18	102	Bouilh-Devant	20	0	20
73	Midi-Pyrénées	65	3	17	103	Bouilh-Péreuilh	105	4	109
73	Midi-Pyrénées	65	3	17	104	Boulin	275	9	284
73	Midi-Pyrénées	65	2	11	105	Bourg-de-Bigorre	190	6	196
73	Midi-Pyrénées	65	2	26	106	Bourisp	152	6	158
73	Midi-Pyrénées	65	1	12	107	Bourréac	84	3	87
73	Midi-Pyrénées	65	3	21	108	Bours	785	22	807
73	Midi-Pyrénées	65	2	15	109	Bramevaque	34	1	35
73	Midi-Pyrénées	65	3	24	110	Bugard	86	2	88
73	Midi-Pyrénées	65	2	05	111	Bulan	63	1	64
73	Midi-Pyrénées	65	1	03	112	Bun	147	2	149
73	Midi-Pyrénées	65	3	23	113	Burg	269	6	275
73	Midi-Pyrénées	65	3	18	114	Buzon	84	3	87
73	Midi-Pyrénées	65	3	17	115	Cabanac	270	6	276
73	Midi-Pyrénées	65	2	02	116	Cadéac	248	9	257
73	Midi-Pyrénées	65	2	26	117	Cadeilhan-Trachère	45	5	50
73	Midi-Pyrénées	65	3	23	118	Caharet	26	0	26
73	Midi-Pyrénées	65	3	25	119	Caixon	404	28	432
73	Midi-Pyrénées	65	3	23	120	Calavanté	270	5	275
73	Midi-Pyrénées	65	3	25	121	Camalès	440	13	453
73	Midi-Pyrénées	65	2	02	122	Camous	26	1	27
73	Midi-Pyrénées	65	2	07	123	Campan	1457	59	1516
73	Midi-Pyrénées	65	2	26	124	Camparan	61	2	63
73	Midi-Pyrénées	65	2	11	125	Campistrous	298	19	317
73	Midi-Pyrénées	65	3	08	126	Campuzan	153	7	160
73	Midi-Pyrénées	65	2	19	482	Cantaous	441	74	515
73	Midi-Pyrénées	65	2	11	127	Capvern	1284	34	1318
73	Midi-Pyrénées	65	3	10	128	Castelbajac	109	4	113
73	Midi-Pyrénées	65	3	08	129	Castelnau-Magnoac	771	21	792
73	Midi-Pyrénées	65	3	09	130	Castelnau-Rivière-Basse	675	11	686
73	Midi-Pyrénées	65	3	17	131	Castelvieilh	223	5	228
73	Midi-Pyrénées	65	3	23	132	Castéra-Lanusse	42	0	42
73	Midi-Pyrénées	65	3	17	133	Castéra-Lou	204	5	209
73	Midi-Pyrénées	65	3	08	134	Casterets	13	1	14
73	Midi-Pyrénées	65	2	11	135	Castillon	85	2	87
73	Midi-Pyrénées	65	3	08	136	Caubous	40	1	41
73	Midi-Pyrénées	65	3	14	137	Caussade-Rivière	86	4	90
73	Midi-Pyrénées	65	1	01	138	Cauterets	1139	47	1186
73	Midi-Pyrénées	65	2	15	139	Cazarilh	40	1	41
73	Midi-Pyrénées	65	2	06	140	Cazaux-Debat	18	0	18
73	Midi-Pyrénées	65	2	06	141	Cazaux-Fréchet-Anéran-Camors	61	0	61
73	Midi-Pyrénées	65	3	17	142	Chelle-Debat	212	6	218
73	Midi-Pyrénées	65	2	11	143	Chelle-Spou	110	4	114
73	Midi-Pyrénées	65	1	12	144	Cheust	83	2	85
73	Midi-Pyrénées	65	1	13	145	Chèze	47	2	49
73	Midi-Pyrénées	65	3	21	146	Chis	295	2	297
73	Midi-Pyrénées	65	2	04	147	Cieutat	593	11	604
73	Midi-Pyrénées	65	3	08	148	Cizos	112	2	114
73	Midi-Pyrénées	65	3	23	149	Clarac	173	10	183
73	Midi-Pyrénées	65	2	11	150	Clarens	445	9	454
73	Midi-Pyrénées	65	3	17	151	Collongues	147	2	149
73	Midi-Pyrénées	65	3	17	153	Coussan	119	4	123
73	Midi-Pyrénées	65	2	15	154	Créchets	42	1	43
73	Midi-Pyrénées	65	3	08	155	Devèze	60	1	61
73	Midi-Pyrénées	65	3	17	156	Dours	228	3	231
73	Midi-Pyrénées	65	2	26	157	Ens	27	1	28
73	Midi-Pyrénées	65	2	15	158	Esbareich	74	0	74
73	Midi-Pyrénées	65	2	05	159	Escala	402	6	408
73	Midi-Pyrénées	65	3	25	160	Escaunets	113	5	118
73	Midi-Pyrénées	65	3	18	161	Escondeaux	253	8	261
73	Midi-Pyrénées	65	2	11	162	Esconnets	28	1	29
73	Midi-Pyrénées	65	2	11	163	Escots	25	0	25
73	Midi-Pyrénées	65	1	12	164	Escoubès-Pouts	100	3	103
73	Midi-Pyrénées	65	2	05	165	Esparros	165	5	170
73	Midi-Pyrénées	65	2	05	166	Espèche	57	0	57
73	Midi-Pyrénées	65	2	11	167	Espieilh	32	1	33
73	Midi-Pyrénées	65	1	13	168	Esquièze-Sère	379	16	395
73	Midi-Pyrénées	65	1	03	169	Estaing	78	2	80
73	Midi-Pyrénées	65	3	24	170	Estampures	78	2	80
73	Midi-Pyrénées	65	2	06	171	Estarvielle	31	1	32
73	Midi-Pyrénées	65	2	26	172	Estensan	41	3	44
73	Midi-Pyrénées	65	1	13	173	Esterre	200	6	206
73	Midi-Pyrénées	65	3	14	174	Estirac	107	0	107
73	Midi-Pyrénées	65	2	15	175	Ferrère	57	1	58
73	Midi-Pyrénées	65	1	03	176	Ferrières	111	3	114
73	Midi-Pyrénées	65	3	24	177	Fontrailles	145	5	150
73	Midi-Pyrénées	65	3	24	178	Fréchède	39	0	39
73	Midi-Pyrénées	65	2	11	179	Fréchendets	34	0	34
73	Midi-Pyrénées	65	2	02	180	Fréchet-Aure	13	0	13
73	Midi-Pyrénées	65	3	23	181	Fréchou-Fréchet	132	7	139
73	Midi-Pyrénées	65	1	03	182	Gaillagos	113	5	118
73	Midi-Pyrénées	65	3	10	183	Galan	727	12	739
73	Midi-Pyrénées	65	3	10	184	Galez	129	6	135
73	Midi-Pyrénées	65	3	16	185	Gardères	420	7	427
73	Midi-Pyrénées	65	2	15	186	Gaudent	47	0	47
73	Midi-Pyrénées	65	3	08	187	Gaussan	111	3	114
73	Midi-Pyrénées	65	1	13	188	Gavarnie	140	1	141
73	Midi-Pyrénées	65	3	33	189	Gayan	255	4	259
73	Midi-Pyrénées	65	2	05	190	Gazave	71	2	73
73	Midi-Pyrénées	65	1	12	191	Gazost	138	0	138
73	Midi-Pyrénées	65	1	13	192	Gèdre	251	3	254
73	Midi-Pyrénées	65	2	15	193	Gembrie	71	3	74
73	Midi-Pyrénées	65	2	19	194	Générest	94	2	96
73	Midi-Pyrénées	65	2	06	195	Génos	157	4	161
73	Midi-Pyrénées	65	3	18	196	Gensac	93	6	99
73	Midi-Pyrénées	65	1	12	197	Ger	173	5	178
73	Midi-Pyrénées	65	2	07	198	Gerde	1175	28	1203
73	Midi-Pyrénées	65	2	06	199	Germ	46	0	46
73	Midi-Pyrénées	65	1	12	200	Germs-sur-l;Oussouet	104	3	107
73	Midi-Pyrénées	65	1	12	201	Geu	174	7	181
73	Midi-Pyrénées	65	1	01	202	Gez	304	12	316
73	Midi-Pyrénées	65	1	12	203	Gez-ez-Angles	22	1	23
73	Midi-Pyrénées	65	3	17	204	Gonez	33	0	33
73	Midi-Pyrénées	65	2	02	205	Gouaux	73	1	74
73	Midi-Pyrénées	65	3	23	206	Goudon	222	10	232
73	Midi-Pyrénées	65	2	11	207	Gourgue	48	0	48
73	Midi-Pyrénées	65	2	26	208	Grailhen	19	1	20
73	Midi-Pyrénées	65	2	02	209	Grézian	96	2	98
73	Midi-Pyrénées	65	1	13	210	Grust	49	1	50
73	Midi-Pyrénées	65	2	26	211	Guchan	141	11	152
73	Midi-Pyrénées	65	2	02	212	Guchen	376	18	394
73	Midi-Pyrénées	65	3	08	213	Guizerix	124	1	125
73	Midi-Pyrénées	65	3	08	214	Hachan	41	0	41
73	Midi-Pyrénées	65	3	09	215	Hagedet	48	0	48
73	Midi-Pyrénées	65	2	04	216	Hauban	90	3	93
73	Midi-Pyrénées	65	2	19	217	Hautaget	48	1	49
73	Midi-Pyrénées	65	2	05	218	Hèches	619	11	630
73	Midi-Pyrénées	65	3	09	219	Hères	125	3	128
73	Midi-Pyrénées	65	3	16	220	Hibarette	233	6	239
73	Midi-Pyrénées	65	3	34	221	Hiis	218	1	219
73	Midi-Pyrénées	65	3	23	222	Hitte	158	0	158
73	Midi-Pyrénées	65	3	34	223	Horgues	1067	48	1115
73	Midi-Pyrénées	65	3	10	224	Houeydets	229	3	232
73	Midi-Pyrénées	65	3	17	225	Hourc	114	3	117
73	Midi-Pyrénées	65	3	33	226	Ibos	2780	182	2962
73	Midi-Pyrénées	65	2	02	228	Ilhet	130	5	135
73	Midi-Pyrénées	65	2	15	229	Ilheu	37	1	38
73	Midi-Pyrénées	65	2	15	230	Izaourt	231	13	244
73	Midi-Pyrénées	65	2	05	231	Izaux	184	11	195
73	Midi-Pyrénées	65	3	17	232	Jacque	71	0	71
73	Midi-Pyrénées	65	1	12	233	Jarret	311	7	318
73	Midi-Pyrénées	65	2	02	234	Jézeau	112	8	120
73	Midi-Pyrénées	65	3	16	235	Juillan	3975	103	4078
73	Midi-Pyrénées	65	1	12	236	Julos	340	5	345
73	Midi-Pyrénées	65	1	12	237	Juncalas	179	6	185
73	Midi-Pyrénées	65	2	04	238	Labassère	259	5	264
73	Midi-Pyrénées	65	2	05	239	Labastide	163	6	169
73	Midi-Pyrénées	65	3	14	240	Labatut-Rivière	337	17	354
73	Midi-Pyrénées	65	2	05	241	Laborde	96	4	100
73	Midi-Pyrénées	65	3	18	242	Lacassagne	209	8	217
73	Midi-Pyrénées	65	3	14	243	Lafitole	485	13	498
73	Midi-Pyrénées	65	3	33	244	Lagarde	495	8	503
73	Midi-Pyrénées	65	2	11	245	Lagrange	223	6	229
73	Midi-Pyrénées	65	3	14	248	Lahitte-Toupière	240	15	255
73	Midi-Pyrénées	65	3	08	249	Lalanne	85	0	85
73	Midi-Pyrénées	65	3	24	250	Lalanne-Trie	135	0	135
73	Midi-Pyrénées	65	3	34	251	Laloubère	1936	107	2043
73	Midi-Pyrénées	65	3	16	252	Lamarque-Pontacq	808	9	817
73	Midi-Pyrénées	65	3	24	253	Lamarque-Rustaing	57	2	59
73	Midi-Pyrénées	65	3	18	254	Laméac	128	0	128
73	Midi-Pyrénées	65	3	23	256	Lanespède	154	0	154
73	Midi-Pyrénées	65	3	16	257	Lanne	575	10	585
73	Midi-Pyrénées	65	2	11	258	Lannemezan	5817	234	6051
73	Midi-Pyrénées	65	3	17	259	Lansac	150	2	152
73	Midi-Pyrénées	65	2	02	255	Lançon	35	1	36
73	Midi-Pyrénées	65	3	24	260	Lapeyre	81	1	82
73	Midi-Pyrénées	65	3	08	261	Laran	47	0	47
73	Midi-Pyrénées	65	3	14	262	Larreule	432	16	448
73	Midi-Pyrénées	65	3	08	263	Larroque	89	6	95
73	Midi-Pyrénées	65	3	09	264	Lascazères	303	31	334
73	Midi-Pyrénées	65	3	17	265	Laslades	350	12	362
73	Midi-Pyrénées	65	3	08	266	Lassales	23	0	23
73	Midi-Pyrénées	65	1	01	267	Lau-Balagnas	500	15	515
73	Midi-Pyrénées	65	3	16	268	Layrisse	179	7	186
73	Midi-Pyrénées	65	3	18	269	Lescurry	178	3	181
73	Midi-Pyrénées	65	3	23	270	Lespouey	205	4	209
73	Midi-Pyrénées	65	1	12	271	Lézignan	373	7	380
73	Midi-Pyrénées	65	3	23	272	Lhez	78	1	79
73	Midi-Pyrénées	65	3	18	273	Liac	196	5	201
73	Midi-Pyrénées	65	3	10	274	Libaros	146	6	152
73	Midi-Pyrénées	65	2	04	275	Lies	72	2	74
73	Midi-Pyrénées	65	3	17	276	Lizos	104	3	107
73	Midi-Pyrénées	65	2	19	277	Lombrès	80	3	83
73	Midi-Pyrénées	65	2	05	278	Lomné	38	1	39
73	Midi-Pyrénées	65	2	05	279	Lortet	211	10	221
73	Midi-Pyrénées	65	1	20	280	Loubajac	405	5	410
73	Midi-Pyrénées	65	3	16	281	Loucrup	210	6	216
73	Midi-Pyrénées	65	2	06	282	Loudenvielle	284	15	299
73	Midi-Pyrénées	65	2	06	283	Loudervielle	64	0	64
73	Midi-Pyrénées	65	3	16	284	Louey	996	22	1018
73	Midi-Pyrénées	65	3	17	285	Louit	179	1	180
73	Midi-Pyrénées	65	1	98	286	Lourdes	14743	359	15102
73	Midi-Pyrénées	65	2	15	287	Loures-Barousse	735	14	749
73	Midi-Pyrénées	65	3	24	288	Lubret-Saint-Luc	72	1	73
73	Midi-Pyrénées	65	3	24	289	Luby-Betmont	105	3	108
73	Midi-Pyrénées	65	3	23	290	Luc	180	0	180
73	Midi-Pyrénées	65	1	12	291	Lugagnan	158	6	164
73	Midi-Pyrénées	65	3	16	292	Luquet	365	6	371
73	Midi-Pyrénées	65	3	24	293	Lustar	107	1	108
73	Midi-Pyrénées	65	2	11	294	Lutilhous	217	6	223
73	Midi-Pyrénées	65	1	13	295	Luz-Saint-Sauveur	1001	28	1029
73	Midi-Pyrénées	65	3	09	296	Madiran	449	16	465
73	Midi-Pyrénées	65	3	18	297	Mansan	44	0	44
73	Midi-Pyrénées	65	3	17	298	Marquerie	72	1	73
73	Midi-Pyrénées	65	3	25	299	Marsac	241	6	247
73	Midi-Pyrénées	65	2	04	300	Marsas	68	1	69
73	Midi-Pyrénées	65	3	17	301	Marseillan	211	6	217
73	Midi-Pyrénées	65	3	23	303	Mascaras	392	7	399
73	Midi-Pyrénées	65	3	14	304	Maubourguet	2462	38	2500
73	Midi-Pyrénées	65	2	15	305	Mauléon-Barousse	120	0	120
73	Midi-Pyrénées	65	2	11	306	Mauvezin	233	5	238
73	Midi-Pyrénées	65	2	19	307	Mazères-de-Neste	327	15	342
73	Midi-Pyrénées	65	3	24	308	Mazerolles	118	10	128
73	Midi-Pyrénées	65	2	05	309	Mazouau	16	0	16
73	Midi-Pyrénées	65	2	04	310	Mérilheu	246	4	250
73	Midi-Pyrénées	65	3	18	311	Mingot	100	7	107
73	Midi-Pyrénées	65	2	11	312	Molère	39	0	39
73	Midi-Pyrénées	65	3	34	313	Momères	661	15	676
73	Midi-Pyrénées	65	3	18	314	Monfaucon	218	4	222
73	Midi-Pyrénées	65	3	08	315	Monléon-Magnoac	447	242	689
73	Midi-Pyrénées	65	3	08	316	Monlong	108	2	110
73	Midi-Pyrénées	65	2	06	317	Mont	32	0	32
73	Midi-Pyrénées	65	3	10	318	Montastruc	266	6	272
73	Midi-Pyrénées	65	2	19	319	Montégut	131	1	132
73	Midi-Pyrénées	65	2	04	320	Montgaillard	772	39	811
73	Midi-Pyrénées	65	3	22	321	Montignac	114	3	117
73	Midi-Pyrénées	65	2	05	322	Montoussé	233	6	239
73	Midi-Pyrénées	65	2	19	323	Montsérié	51	3	54
73	Midi-Pyrénées	65	3	23	324	Moulédous	172	4	176
73	Midi-Pyrénées	65	3	18	325	Moumoulous	47	2	49
73	Midi-Pyrénées	65	3	17	326	Mun	109	0	109
73	Midi-Pyrénées	65	2	19	327	Nestier	163	4	167
73	Midi-Pyrénées	65	2	04	328	Neuilh	109	5	114
73	Midi-Pyrénées	65	2	19	329	Nistos	243	4	247
73	Midi-Pyrénées	65	3	25	330	Nouilhan	205	2	207
73	Midi-Pyrénées	65	3	34	331	Odos	3250	145	3395
73	Midi-Pyrénées	65	3	17	332	Oléac-Debat	108	1	109
73	Midi-Pyrénées	65	3	23	333	Oléac-Dessus	98	0	98
73	Midi-Pyrénées	65	1	27	334	Omex	249	5	254
73	Midi-Pyrénées	65	2	04	335	Ordizan	476	16	492
73	Midi-Pyrénées	65	3	08	336	Organ	32	0	32
73	Midi-Pyrénées	65	3	23	337	Orieux	107	4	111
73	Midi-Pyrénées	65	2	04	338	Orignac	228	6	234
73	Midi-Pyrénées	65	3	16	339	Orincles	321	9	330
73	Midi-Pyrénées	65	3	21	340	Orleix	1832	37	1869
73	Midi-Pyrénées	65	3	33	341	Oroix	120	3	123
73	Midi-Pyrénées	65	3	24	342	Osmets	76	4	80
73	Midi-Pyrénées	65	1	27	343	Ossen	191	2	193
73	Midi-Pyrénées	65	3	16	344	Ossun	2322	61	2383
73	Midi-Pyrénées	65	1	12	345	Ossun-ez-Angles	38	0	38
73	Midi-Pyrénées	65	3	23	346	Oueilloux	160	4	164
73	Midi-Pyrénées	65	2	15	347	Ourde	31	2	33
73	Midi-Pyrénées	65	1	12	348	Ourdis-Cotdoussan	47	2	49
73	Midi-Pyrénées	65	1	12	349	Ourdon	11	0	11
73	Midi-Pyrénées	65	3	33	350	Oursbelille	1219	24	1243
73	Midi-Pyrénées	65	1	12	351	Ousté	41	2	43
73	Midi-Pyrénées	65	1	01	352	Ouzous	201	14	215
73	Midi-Pyrénées	65	3	23	353	Ozon	285	6	291
73	Midi-Pyrénées	65	2	02	354	Pailhac	67	2	69
73	Midi-Pyrénées	65	1	12	355	Paréac	64	1	65
73	Midi-Pyrénées	65	2	11	356	Péré	52	3	55
73	Midi-Pyrénées	65	3	23	357	Peyraube	141	3	144
73	Midi-Pyrénées	65	3	08	358	Peyret-Saint-André	56	0	56
73	Midi-Pyrénées	65	3	17	359	Peyriguère	23	0	23
73	Midi-Pyrénées	65	1	20	360	Peyrouse	286	4	290
73	Midi-Pyrénées	65	3	18	361	Peyrun	82	0	82
73	Midi-Pyrénées	65	1	01	362	Pierrefitte-Nestalas	1266	43	1309
73	Midi-Pyrénées	65	2	11	363	Pinas	459	13	472
73	Midi-Pyrénées	65	3	33	364	Pintac	31	2	33
73	Midi-Pyrénées	65	1	27	366	Poueyferré	842	40	882
73	Midi-Pyrénées	65	3	23	367	Poumarous	133	4	137
73	Midi-Pyrénées	65	3	08	368	Pouy	35	1	36
73	Midi-Pyrénées	65	3	17	369	Pouyastruc	650	19	669
73	Midi-Pyrénées	65	2	04	370	Pouzac	1109	20	1129
73	Midi-Pyrénées	65	1	01	371	Préchac	234	5	239
73	Midi-Pyrénées	65	3	25	372	Pujo	616	28	644
73	Midi-Pyrénées	65	3	08	373	Puntous	208	7	215
73	Midi-Pyrénées	65	3	24	374	Puydarrieux	212	10	222
73	Midi-Pyrénées	65	3	18	375	Rabastens-de-Bigorre	1439	19	1458
73	Midi-Pyrénées	65	3	10	376	Recurt	180	11	191
73	Midi-Pyrénées	65	2	11	377	Réjaumont	184	3	187
73	Midi-Pyrénées	65	3	23	378	Ricaud	72	2	74
73	Midi-Pyrénées	65	2	06	379	Ris	12	0	12
73	Midi-Pyrénées	65	3	17	380	Sabalos	147	6	153
73	Midi-Pyrénées	65	3	10	381	Sabarros	32	2	34
73	Midi-Pyrénées	65	2	15	382	Sacoué	86	2	88
73	Midi-Pyrénées	65	3	24	383	Sadournin	182	4	186
73	Midi-Pyrénées	65	2	26	384	Sailhan	127	5	132
73	Midi-Pyrénées	65	2	05	385	Saint-Arroman	103	4	107
73	Midi-Pyrénées	65	1	12	386	Saint-Créac	93	1	94
73	Midi-Pyrénées	65	3	09	387	Saint-Lanne	120	3	123
73	Midi-Pyrénées	65	2	26	388	Saint-Lary-Soulan	885	34	919
73	Midi-Pyrénées	65	2	19	389	Saint-Laurent-de-Neste	941	40	981
73	Midi-Pyrénées	65	3	25	390	Saint-Lézer	415	14	429
73	Midi-Pyrénées	65	3	34	392	Saint-Martin	376	8	384
73	Midi-Pyrénées	65	1	01	393	Saint-Pastous	120	1	121
73	Midi-Pyrénées	65	2	19	394	Saint-Paul	282	5	287
73	Midi-Pyrénées	65	1	20	395	Saint-Pé-de-Bigorre	1257	25	1282
73	Midi-Pyrénées	65	1	01	396	Saint-Savin	382	14	396
73	Midi-Pyrénées	65	3	18	397	Saint-Sever-de-Rustan	157	8	165
73	Midi-Pyrénées	65	2	15	391	Sainte-Marie	32	0	32
73	Midi-Pyrénées	65	2	15	398	Saléchan	192	6	198
73	Midi-Pyrénées	65	1	13	399	Saligos	89	2	91
73	Midi-Pyrénées	65	1	01	400	Salles	200	3	203
73	Midi-Pyrénées	65	3	22	401	Salles-Adour	458	13	471
73	Midi-Pyrénées	65	2	15	402	Samuran	20	0	20
73	Midi-Pyrénées	65	3	25	403	Sanous	83	4	87
73	Midi-Pyrénées	65	3	08	404	Sariac-Magnoac	153	4	157
73	Midi-Pyrénées	65	2	11	405	Sarlabous	70	0	70
73	Midi-Pyrénées	65	3	33	406	Sarniguet	247	4	251
73	Midi-Pyrénées	65	2	15	407	Sarp	108	1	109
73	Midi-Pyrénées	65	2	02	408	Sarrancolin	590	19	609
73	Midi-Pyrénées	65	3	18	409	Sarriac-Bigorre	285	6	291
73	Midi-Pyrénées	65	3	22	410	Sarrouilles	559	10	569
73	Midi-Pyrénées	65	1	13	411	Sassis	92	0	92
73	Midi-Pyrénées	65	3	14	412	Sauveterre	170	5	175
73	Midi-Pyrénées	65	1	13	413	Sazos	119	1	120
73	Midi-Pyrénées	65	3	18	414	Ségalas	94	2	96
73	Midi-Pyrénées	65	1	27	415	Ségus	257	3	260
73	Midi-Pyrénées	65	2	19	416	Seich	64	1	65
73	Midi-Pyrénées	65	3	22	417	Séméac	4679	163	4842
73	Midi-Pyrénées	65	3	18	418	Sénac	246	6	252
73	Midi-Pyrénées	65	3	10	419	Sentous	77	7	84
73	Midi-Pyrénées	65	1	01	420	Sère-en-Lavedan	73	4	77
73	Midi-Pyrénées	65	1	12	421	Sère-Lanso	55	0	55
73	Midi-Pyrénées	65	3	24	423	Sère-Rustaing	132	2	134
73	Midi-Pyrénées	65	3	16	422	Séron	299	3	302
73	Midi-Pyrénées	65	1	13	424	Sers	92	4	96
73	Midi-Pyrénées	65	3	25	425	Siarrouy	419	15	434
73	Midi-Pyrénées	65	3	23	426	Sinzos	143	4	147
73	Midi-Pyrénées	65	2	15	427	Siradan	292	12	304
73	Midi-Pyrénées	65	1	03	428	Sireix	68	0	68
73	Midi-Pyrénées	65	3	14	429	Sombrun	209	7	216
73	Midi-Pyrénées	65	3	17	430	Soréac	35	1	36
73	Midi-Pyrénées	65	2	15	431	Sost	99	0	99
73	Midi-Pyrénées	65	3	09	432	Soublecause	180	7	187
73	Midi-Pyrénées	65	3	34	433	Soues	3005	80	3085
73	Midi-Pyrénées	65	1	01	435	Soulom	241	9	250
73	Midi-Pyrénées	65	3	17	436	Souyeaux	291	11	302
73	Midi-Pyrénées	65	2	11	437	Tajan	146	0	146
73	Midi-Pyrénées	65	3	25	438	Talazac	71	2	73
73	Midi-Pyrénées	65	3	33	439	Tarasteix	284	5	289
73	Midi-Pyrénées	65	3	99	440	Tarbes	43034	1918	44952
73	Midi-Pyrénées	65	2	15	441	Thèbe	81	4	85
73	Midi-Pyrénées	65	3	08	442	Thermes-Magnoac	196	4	200
73	Midi-Pyrénées	65	3	17	443	Thuy	15	0	15
73	Midi-Pyrénées	65	2	19	444	Tibiran-Jaunac	273	5	278
73	Midi-Pyrénées	65	2	11	445	Tilhouse	213	8	221
73	Midi-Pyrénées	65	3	18	446	Tostat	455	6	461
73	Midi-Pyrénées	65	3	23	447	Tournay	1310	36	1346
73	Midi-Pyrénées	65	3	24	448	Tournous-Darré	81	2	83
73	Midi-Pyrénées	65	3	10	449	Tournous-Devant	111	9	120
73	Midi-Pyrénées	65	2	26	450	Tramezaïgues	33	1	34
73	Midi-Pyrénées	65	2	04	451	Trébons	698	20	718
73	Midi-Pyrénées	65	3	24	452	Trie-sur-Baïse	1069	23	1092
73	Midi-Pyrénées	65	2	15	453	Troubat	58	1	59
73	Midi-Pyrénées	65	3	18	454	Trouley-Labarthe	97	1	98
73	Midi-Pyrénées	65	2	19	455	Tuzaguet	459	17	476
73	Midi-Pyrénées	65	2	11	456	Uglas	284	12	296
73	Midi-Pyrénées	65	3	18	457	Ugnouas	75	1	76
73	Midi-Pyrénées	65	1	01	458	Uz	36	0	36
73	Midi-Pyrénées	65	2	04	459	Uzer	104	3	107
73	Midi-Pyrénées	65	3	25	460	Vic-en-Bigorre	5280	311	5591
73	Midi-Pyrénées	65	3	24	461	Vidou	88	0	88
73	Midi-Pyrénées	65	3	14	462	Vidouze	252	12	264
73	Midi-Pyrénées	65	1	13	463	Viella	78	5	83
73	Midi-Pyrénées	65	3	22	464	Vielle-Adour	497	7	504
73	Midi-Pyrénées	65	2	26	465	Vielle-Aure	356	14	370
73	Midi-Pyrénées	65	2	06	466	Vielle-Louron	80	6	86
73	Midi-Pyrénées	65	1	01	467	Vier-Bordes	94	5	99
73	Midi-Pyrénées	65	3	08	468	Vieuzos	51	2	53
73	Midi-Pyrénées	65	1	13	469	Viey	26	0	26
73	Midi-Pyrénées	65	1	27	470	Viger	133	5	138
73	Midi-Pyrénées	65	2	26	471	Vignec	212	4	216
73	Midi-Pyrénées	65	3	09	472	Villefranque	89	3	92
73	Midi-Pyrénées	65	1	01	473	Villelongue	369	6	375
73	Midi-Pyrénées	65	3	24	474	Villembits	102	2	104
73	Midi-Pyrénées	65	3	08	475	Villemur	64	1	65
73	Midi-Pyrénées	65	3	25	476	Villenave-près-Béarn	70	1	71
73	Midi-Pyrénées	65	3	25	477	Villenave-près-Marsac	69	1	70
73	Midi-Pyrénées	65	1	13	478	Viscos	44	2	46
73	Midi-Pyrénées	65	3	16	479	Visker	332	13	345
73	Midi-Pyrénées	65	1	13	480	Vizos	40	0	40
91	Languedoc-Roussillon	66	1	03	001	L; Albère	83	1	84
91	Languedoc-Roussillon	66	2	27	002	Alénya	3133	47	3180
91	Languedoc-Roussillon	66	1	02	003	Amélie-les-Bains-Palalda	3702	59	3761
91	Languedoc-Roussillon	66	3	06	004	Les Angles	566	7	573
91	Languedoc-Roussillon	66	3	13	005	Angoustrine-Villeneuve-des-Escaldes	647	34	681
91	Languedoc-Roussillon	66	2	15	006	Ansignan	193	5	198
91	Languedoc-Roussillon	66	3	16	007	Arboussols	103	3	106
91	Languedoc-Roussillon	66	1	01	008	Argelès-sur-Mer	9978	171	10149
91	Languedoc-Roussillon	66	1	02	009	Arles-sur-Tech	2728	38	2766
91	Languedoc-Roussillon	66	3	07	010	Ayguatébia-Talau	44	0	44
91	Languedoc-Roussillon	66	2	28	011	Bages	3915	50	3965
91	Languedoc-Roussillon	66	2	30	012	Baho	3153	56	3209
91	Languedoc-Roussillon	66	3	18	013	Baillestavy	95	0	95
91	Languedoc-Roussillon	66	2	30	014	Baixas	2530	36	2566
91	Languedoc-Roussillon	66	1	03	015	Banyuls-dels-Aspres	1200	24	1224
91	Languedoc-Roussillon	66	1	19	016	Banyuls-sur-Mer	4670	86	4756
91	Languedoc-Roussillon	66	2	14	017	Le Barcarès	4063	59	4122
91	Languedoc-Roussillon	66	1	02	018	La Bastide	83	2	85
91	Languedoc-Roussillon	66	2	04	019	Bélesta	221	0	221
91	Languedoc-Roussillon	66	3	06	020	Bolquère	776	36	812
91	Languedoc-Roussillon	66	2	24	021	Bompas	7246	124	7370
91	Languedoc-Roussillon	66	3	18	022	Boule-d;Amont	61	1	62
91	Languedoc-Roussillon	66	3	18	023	Bouleternère	838	22	860
91	Languedoc-Roussillon	66	1	03	024	Le Boulou	5436	77	5513
91	Languedoc-Roussillon	66	3	13	025	Bourg-Madame	1262	92	1354
91	Languedoc-Roussillon	66	2	17	026	Brouilla	1061	8	1069
91	Languedoc-Roussillon	66	3	06	027	La Cabanasse	705	13	718
91	Languedoc-Roussillon	66	2	20	028	Cabestany	9074	181	9255
91	Languedoc-Roussillon	66	2	17	029	Caixas	127	1	128
91	Languedoc-Roussillon	66	2	30	030	Calce	222	4	226
91	Languedoc-Roussillon	66	1	03	032	Calmeilles	64	0	64
91	Languedoc-Roussillon	66	2	17	033	Camélas	414	7	421
91	Languedoc-Roussillon	66	3	10	034	Campôme	108	5	113
91	Languedoc-Roussillon	66	3	16	035	Campoussy	47	1	48
91	Languedoc-Roussillon	66	3	07	036	Canaveilles	48	0	48
91	Languedoc-Roussillon	66	2	31	037	Canet-en-Roussillon	13293	235	13528
91	Languedoc-Roussillon	66	2	29	038	Canohès	4867	119	4986
91	Languedoc-Roussillon	66	2	04	039	Caramany	145	1	146
91	Languedoc-Roussillon	66	3	18	040	Casefabre	37	1	38
91	Languedoc-Roussillon	66	2	12	041	Cases-de-Pène	786	5	791
91	Languedoc-Roussillon	66	2	04	042	Cassagnes	257	4	261
91	Languedoc-Roussillon	66	3	10	043	Casteil	120	2	122
91	Languedoc-Roussillon	66	2	17	044	Castelnou	364	8	372
91	Languedoc-Roussillon	66	3	10	045	Catllar	717	27	744
91	Languedoc-Roussillon	66	3	06	047	Caudiès-de-Conflent	13	1	14
91	Languedoc-Roussillon	66	2	15	046	Caudiès-de-Fenouillèdes	620	13	633
91	Languedoc-Roussillon	66	1	19	048	Cerbère	1446	11	1457
91	Languedoc-Roussillon	66	1	03	049	Céret	7629	219	7848
91	Languedoc-Roussillon	66	2	14	050	Claira	3610	40	3650
91	Languedoc-Roussillon	66	3	10	051	Clara	240	6	246
91	Languedoc-Roussillon	66	1	03	063	Les Cluses	263	2	265
91	Languedoc-Roussillon	66	3	10	052	Codalet	352	11	363
91	Languedoc-Roussillon	66	1	19	053	Collioure	2989	37	3026
91	Languedoc-Roussillon	66	3	10	054	Conat	53	2	55
91	Languedoc-Roussillon	66	2	05	055	Corbère	661	8	669
91	Languedoc-Roussillon	66	2	05	056	Corbère-les-Cabanes	1068	15	1083
91	Languedoc-Roussillon	66	3	10	057	Corneilla-de-Conflent	470	6	476
91	Languedoc-Roussillon	66	2	28	059	Corneilla-del-Vercol	2115	33	2148
91	Languedoc-Roussillon	66	2	05	058	Corneilla-la-Rivière	1887	30	1917
91	Languedoc-Roussillon	66	1	02	060	Corsavy	231	34	265
91	Languedoc-Roussillon	66	1	11	061	Coustouges	112	0	112
91	Languedoc-Roussillon	66	3	13	062	Dorres	169	5	174
91	Languedoc-Roussillon	66	3	13	064	Égat	447	18	465
91	Languedoc-Roussillon	66	2	28	065	Elne	7898	108	8006
91	Languedoc-Roussillon	66	3	13	066	Enveitg	666	31	697
91	Languedoc-Roussillon	66	3	13	067	Err	632	19	651
91	Languedoc-Roussillon	66	3	07	068	Escaro	107	0	107
91	Languedoc-Roussillon	66	3	18	070	Espira-de-Conflent	173	4	177
91	Languedoc-Roussillon	66	2	12	069	Espira-de-l;Agly	3118	143	3261
91	Languedoc-Roussillon	66	2	04	071	Estagel	1929	36	1965
91	Languedoc-Roussillon	66	3	13	072	Estavar	408	14	422
91	Languedoc-Roussillon	66	3	18	073	Estoher	156	2	158
91	Languedoc-Roussillon	66	3	10	074	Eus	407	16	423
91	Languedoc-Roussillon	66	3	13	075	Eyne	129	2	131
91	Languedoc-Roussillon	66	3	16	076	Felluns	55	3	58
91	Languedoc-Roussillon	66	2	15	077	Fenouillet	87	3	90
91	Languedoc-Roussillon	66	3	10	078	Fillols	163	7	170
91	Languedoc-Roussillon	66	3	18	079	Finestret	192	6	198
91	Languedoc-Roussillon	66	3	13	124	Font-Romeu-Odeillo-Via	1841	260	2101
91	Languedoc-Roussillon	66	3	06	080	Fontpédrouse	132	1	133
91	Languedoc-Roussillon	66	3	06	081	Fontrabiouse	119	6	125
91	Languedoc-Roussillon	66	3	06	082	Formiguères	425	12	437
91	Languedoc-Roussillon	66	2	15	083	Fosse	39	1	40
91	Languedoc-Roussillon	66	2	17	084	Fourques	1108	17	1125
91	Languedoc-Roussillon	66	3	10	085	Fuilla	381	6	387
91	Languedoc-Roussillon	66	3	18	086	Glorianes	18	0	18
91	Languedoc-Roussillon	66	3	18	088	Ille-sur-Têt	5266	78	5344
91	Languedoc-Roussillon	66	3	18	089	Joch	231	3	234
91	Languedoc-Roussillon	66	3	07	090	Jujols	46	2	48
91	Languedoc-Roussillon	66	1	11	091	Lamanère	54	2	56
91	Languedoc-Roussillon	66	2	04	092	Lansac	104	0	104
91	Languedoc-Roussillon	66	1	01	093	Laroque-des-Albères	2078	44	2122
91	Languedoc-Roussillon	66	2	27	094	Latour-Bas-Elne	2191	35	2226
91	Languedoc-Roussillon	66	3	13	095	Latour-de-Carol	413	17	430
91	Languedoc-Roussillon	66	2	04	096	Latour-de-France	1065	18	1083
91	Languedoc-Roussillon	66	2	15	097	Lesquerde	171	0	171
91	Languedoc-Roussillon	66	3	06	098	La Llagonne	242	6	248
91	Languedoc-Roussillon	66	2	17	099	Llauro	327	3	330
91	Languedoc-Roussillon	66	3	13	100	Llo	157	5	162
91	Languedoc-Roussillon	66	2	17	101	Llupia	1948	30	1978
91	Languedoc-Roussillon	66	3	07	102	Mantet	28	0	28
91	Languedoc-Roussillon	66	3	18	103	Marquixanes	542	6	548
91	Languedoc-Roussillon	66	3	10	104	Los Masos	810	15	825
91	Languedoc-Roussillon	66	3	06	105	Matemale	287	7	294
91	Languedoc-Roussillon	66	1	03	106	Maureillas-las-Illas	2661	54	2715
91	Languedoc-Roussillon	66	2	15	107	Maury	860	8	868
91	Languedoc-Roussillon	66	2	05	108	Millas	3924	71	3995
91	Languedoc-Roussillon	66	3	10	109	Molitg-les-Bains	215	12	227
91	Languedoc-Roussillon	66	3	06	117	Mont-Louis	247	8	255
91	Languedoc-Roussillon	66	3	18	111	Montalba-le-Château	147	4	151
91	Languedoc-Roussillon	66	1	03	112	Montauriol	214	7	221
91	Languedoc-Roussillon	66	1	02	113	Montbolo	187	0	187
91	Languedoc-Roussillon	66	2	28	114	Montescot	1674	25	1699
91	Languedoc-Roussillon	66	1	01	115	Montesquieu-des-Albères	1168	21	1189
91	Languedoc-Roussillon	66	1	02	116	Montferrer	198	6	204
91	Languedoc-Roussillon	66	2	04	118	Montner	316	7	323
91	Languedoc-Roussillon	66	3	10	119	Mosset	292	6	298
91	Languedoc-Roussillon	66	3	13	120	Nahuja	68	6	74
91	Languedoc-Roussillon	66	2	05	121	Néfiach	1140	35	1175
91	Languedoc-Roussillon	66	3	10	122	Nohèdes	68	1	69
91	Languedoc-Roussillon	66	3	07	123	Nyer	162	2	164
91	Languedoc-Roussillon	66	3	07	125	Olette	384	5	389
91	Languedoc-Roussillon	66	1	03	126	Oms	295	3	298
91	Languedoc-Roussillon	66	2	12	127	Opoul-Périllos	932	6	938
91	Languedoc-Roussillon	66	3	07	128	Oreilla	15	0	15
91	Languedoc-Roussillon	66	2	28	129	Ortaffa	1317	15	1332
91	Languedoc-Roussillon	66	3	13	130	Osséja	1490	138	1628
91	Languedoc-Roussillon	66	3	13	132	Palau-de-Cerdagne	445	15	460
91	Languedoc-Roussillon	66	1	01	133	Palau-del-Vidre	2848	41	2889
91	Languedoc-Roussillon	66	2	17	134	Passa	712	11	723
91	Languedoc-Roussillon	66	2	99	136	Perpignan	117419	2117	119536
91	Languedoc-Roussillon	66	1	03	137	Le Perthus	586	6	592
91	Languedoc-Roussillon	66	2	12	138	Peyrestortes	1332	13	1345
91	Languedoc-Roussillon	66	3	16	139	Pézilla-de-Conflent	60	2	62
91	Languedoc-Roussillon	66	2	05	140	Pézilla-la-Rivière	3167	54	3221
91	Languedoc-Roussillon	66	2	12	141	Pia	7617	128	7745
91	Languedoc-Roussillon	66	3	06	142	Planès	50	1	51
91	Languedoc-Roussillon	66	2	04	143	Planèzes	100	5	105
91	Languedoc-Roussillon	66	2	29	144	Pollestres	4410	73	4483
91	Languedoc-Roussillon	66	2	17	145	Ponteilla	2787	38	2825
91	Languedoc-Roussillon	66	1	19	148	Port-Vendres	4290	80	4370
91	Languedoc-Roussillon	66	3	13	146	Porta	148	1	149
91	Languedoc-Roussillon	66	3	13	147	Porté-Puymorens	131	10	141
91	Languedoc-Roussillon	66	3	10	149	Prades	6081	370	6451
91	Languedoc-Roussillon	66	1	11	150	Prats-de-Mollo-la-Preste	1101	25	1126
91	Languedoc-Roussillon	66	3	16	151	Prats-de-Sournia	74	1	75
91	Languedoc-Roussillon	66	2	15	152	Prugnanes	106	4	110
91	Languedoc-Roussillon	66	3	18	153	Prunet-et-Belpuig	57	4	61
91	Languedoc-Roussillon	66	3	06	154	Puyvalador	72	3	75
91	Languedoc-Roussillon	66	3	07	155	Py	93	1	94
91	Languedoc-Roussillon	66	3	16	156	Rabouillet	106	4	110
91	Languedoc-Roussillon	66	3	07	157	Railleu	22	0	22
91	Languedoc-Roussillon	66	2	04	158	Rasiguères	152	3	155
91	Languedoc-Roussillon	66	3	06	159	Réal	51	0	51
91	Languedoc-Roussillon	66	1	03	160	Reynès	1204	25	1229
91	Languedoc-Roussillon	66	3	10	161	Ria-Sirach	1201	25	1226
91	Languedoc-Roussillon	66	3	18	162	Rigarda	468	12	480
91	Languedoc-Roussillon	66	2	12	164	Rivesaltes	8169	161	8330
91	Languedoc-Roussillon	66	3	18	165	Rodès	617	14	631
91	Languedoc-Roussillon	66	3	07	166	Sahorre	358	2	360
91	Languedoc-Roussillon	66	3	13	167	Saillagouse	1035	19	1054
91	Languedoc-Roussillon	66	1	01	168	Saint-André	3120	49	3169
91	Languedoc-Roussillon	66	2	15	169	Saint-Arnac	121	0	121
91	Languedoc-Roussillon	66	2	27	171	Saint-Cyprien	10476	154	10630
91	Languedoc-Roussillon	66	2	30	172	Saint-Estève	10838	195	11033
91	Languedoc-Roussillon	66	2	05	173	Saint-Féliu-d;Amont	746	8	754
91	Languedoc-Roussillon	66	2	05	174	Saint-Féliu-d;Avall	2473	39	2512
91	Languedoc-Roussillon	66	1	01	175	Saint-Génis-des-Fontaines	2778	40	2818
91	Languedoc-Roussillon	66	2	14	176	Saint-Hippolyte	2494	25	2519
91	Languedoc-Roussillon	66	2	17	177	Saint-Jean-Lasseille	857	8	865
91	Languedoc-Roussillon	66	1	03	178	Saint-Jean-Pla-de-Corts	2028	48	2076
91	Languedoc-Roussillon	66	1	11	179	Saint-Laurent-de-Cerdans	1275	14	1289
91	Languedoc-Roussillon	66	2	14	180	Saint-Laurent-de-la-Salanque	8674	111	8785
91	Languedoc-Roussillon	66	1	02	183	Saint-Marsal	97	0	97
91	Languedoc-Roussillon	66	2	15	184	Saint-Martin	56	1	57
91	Languedoc-Roussillon	66	3	18	185	Saint-Michel-de-Llotes	309	1	310
91	Languedoc-Roussillon	66	2	31	186	Saint-Nazaire	2465	47	2512
91	Languedoc-Roussillon	66	2	15	187	Saint-Paul-de-Fenouillet	1879	23	1902
91	Languedoc-Roussillon	66	3	06	188	Saint-Pierre-dels-Forcats	261	8	269
91	Languedoc-Roussillon	66	2	17	170	Sainte-Colombe-de-la-Commanderie	128	2	130
91	Languedoc-Roussillon	66	3	13	181	Sainte-Léocadie	150	3	153
91	Languedoc-Roussillon	66	2	31	182	Sainte-Marie	4636	47	4683
91	Languedoc-Roussillon	66	2	27	189	Saleilles	4576	76	4652
91	Languedoc-Roussillon	66	2	12	190	Salses-le-Château	3103	26	3129
91	Languedoc-Roussillon	66	3	07	191	Sansa	26	0	26
91	Languedoc-Roussillon	66	3	06	192	Sauto	91	0	91
91	Languedoc-Roussillon	66	3	07	193	Serdinya	214	1	215
91	Languedoc-Roussillon	66	1	11	194	Serralongue	239	4	243
91	Languedoc-Roussillon	66	2	05	195	Le Soler	7090	105	7195
91	Languedoc-Roussillon	66	1	01	196	Sorède	3029	55	3084
91	Languedoc-Roussillon	66	3	07	197	Souanyas	40	0	40
91	Languedoc-Roussillon	66	3	16	198	Sournia	469	0	469
91	Languedoc-Roussillon	66	1	03	199	Taillet	105	1	106
91	Languedoc-Roussillon	66	3	16	201	Tarerach	57	0	57
91	Languedoc-Roussillon	66	3	13	202	Targassonne	201	6	207
91	Languedoc-Roussillon	66	1	02	203	Taulis	50	0	50
91	Languedoc-Roussillon	66	3	10	204	Taurinya	326	12	338
91	Languedoc-Roussillon	66	2	04	205	Tautavel	912	13	925
91	Languedoc-Roussillon	66	1	11	206	Le Tech	87	2	89
91	Languedoc-Roussillon	66	2	17	207	Terrats	668	15	683
91	Languedoc-Roussillon	66	2	28	208	Théza	1386	68	1454
91	Languedoc-Roussillon	66	3	07	209	Thuès-Entre-Valls	33	0	33
91	Languedoc-Roussillon	66	2	17	210	Thuir	7267	106	7373
91	Languedoc-Roussillon	66	2	17	211	Tordères	173	6	179
91	Languedoc-Roussillon	66	2	14	212	Torreilles	3147	49	3196
91	Languedoc-Roussillon	66	2	29	213	Toulouges	6173	99	6272
91	Languedoc-Roussillon	66	2	17	214	Tresserre	810	10	820
91	Languedoc-Roussillon	66	3	16	215	Trévillach	122	0	122
91	Languedoc-Roussillon	66	3	16	216	Trilla	61	4	65
91	Languedoc-Roussillon	66	2	17	217	Trouillas	1757	15	1772
91	Languedoc-Roussillon	66	3	13	218	Ur	362	11	373
91	Languedoc-Roussillon	66	3	10	219	Urbanya	11	0	11
91	Languedoc-Roussillon	66	3	13	220	Valcebollère	43	2	45
91	Languedoc-Roussillon	66	3	18	221	Valmanya	43	0	43
91	Languedoc-Roussillon	66	3	10	222	Vernet-les-Bains	1439	62	1501
91	Languedoc-Roussillon	66	3	10	223	Villefranche-de-Conflent	238	3	241
91	Languedoc-Roussillon	66	2	31	224	Villelongue-de-la-Salanque	3084	48	3132
91	Languedoc-Roussillon	66	1	01	225	Villelongue-dels-Monts	1413	89	1502
91	Languedoc-Roussillon	66	2	17	226	Villemolaque	1175	16	1191
91	Languedoc-Roussillon	66	2	28	227	Villeneuve-de-la-Raho	3779	81	3860
91	Languedoc-Roussillon	66	2	30	228	Villeneuve-la-Rivière	1304	18	1322
91	Languedoc-Roussillon	66	2	12	231	Vingrau	607	9	616
91	Languedoc-Roussillon	66	3	18	230	Vinça	1934	37	1971
91	Languedoc-Roussillon	66	2	15	232	Vira	33	0	33
91	Languedoc-Roussillon	66	1	03	233	Vivès	168	2	170
91	Languedoc-Roussillon	66	3	16	234	Le Vivier	94	2	96
42	Alsace	67	6	43	001	Achenheim	2168	41	2209
42	Alsace	67	4	06	002	Adamswiller	392	10	402
42	Alsace	67	5	32	003	Albé	472	11	483
42	Alsace	67	4	13	004	Allenwiller	507	8	515
42	Alsace	67	6	10	005	Alteckendorf	750	6	756
42	Alsace	67	4	21	006	Altenheim	222	3	225
42	Alsace	67	3	14	008	Altorf	1273	11	1284
42	Alsace	67	4	20	009	Altwiller	419	11	430
42	Alsace	67	5	01	010	Andlau	1842	71	1913
42	Alsace	67	5	12	011	Artolsheim	931	15	946
42	Alsace	67	7	26	012	Aschbach	667	11	678
42	Alsace	67	4	06	013	Asswiller	285	2	287
42	Alsace	67	2	03	014	Auenheim	872	8	880
42	Alsace	67	3	14	016	Avolsheim	728	10	738
42	Alsace	67	4	06	017	Baerendorf	310	6	316
42	Alsace	67	3	33	018	Balbronn	625	7	632
42	Alsace	67	5	12	019	Baldenheim	1150	20	1170
42	Alsace	67	3	23	020	Barembach	868	20	888
42	Alsace	67	5	01	021	Barr	6830	198	7028
42	Alsace	67	5	32	022	Bassemberg	265	8	273
42	Alsace	67	2	09	023	Batzendorf	914	13	927
42	Alsace	67	7	25	025	Beinheim	1871	28	1899
42	Alsace	67	3	23	026	Bellefosse	135	1	136
42	Alsace	67	3	23	027	Belmont	177	0	177
42	Alsace	67	5	02	028	Benfeld	5662	108	5770
42	Alsace	67	4	06	029	Berg	426	4	430
42	Alsace	67	3	33	030	Bergbieten	671	15	686
42	Alsace	67	5	16	031	Bernardswiller	1422	46	1468
42	Alsace	67	5	01	032	Bernardvillé	221	7	228
42	Alsace	67	6	05	033	Bernolsheim	612	3	615
42	Alsace	67	6	31	034	Berstett	2323	21	2344
42	Alsace	67	2	09	035	Berstheim	402	6	408
42	Alsace	67	7	26	339	Betschdorf	4063	54	4117
42	Alsace	67	4	06	036	Bettwiller	335	7	342
42	Alsace	67	7	35	037	Biblisheim	348	14	362
42	Alsace	67	6	05	038	Bietlenheim	283	1	284
42	Alsace	67	6	05	039	Bilwisheim	400	7	407
42	Alsace	67	5	12	040	Bindernheim	921	15	936
42	Alsace	67	4	13	041	Birkenwald	291	8	299
42	Alsace	67	6	44	043	Bischheim	17770	268	18038
42	Alsace	67	4	04	044	Bischholtz	280	5	285
42	Alsace	67	3	18	045	Bischoffsheim	3272	66	3338
42	Alsace	67	2	03	046	Bischwiller	12703	97	12800
42	Alsace	67	4	20	047	Bissert	148	0	148
42	Alsace	67	2	15	048	Bitschhoffen	468	11	479
42	Alsace	67	6	08	049	Blaesheim	1283	11	1294
42	Alsace	67	3	23	050	Blancherupt	38	0	38
42	Alsace	67	5	01	051	Blienschwiller	339	9	348
42	Alsace	67	3	18	052	Boersch	2437	63	2500
42	Alsace	67	5	12	053	Boesenbiesen	300	11	311
42	Alsace	67	5	07	054	Bolsenheim	462	5	467
42	Alsace	67	5	02	055	Boofzheim	1227	19	1246
42	Alsace	67	5	12	056	Bootzheim	644	9	653
42	Alsace	67	4	04	057	Bosselshausen	177	4	181
42	Alsace	67	6	10	058	Bossendorf	372	6	378
42	Alsace	67	3	19	059	Bourg-Bruche	434	7	441
42	Alsace	67	5	16	060	Bourgheim	574	5	579
42	Alsace	67	4	04	061	Bouxwiller	3941	94	4035
42	Alsace	67	5	32	062	Breitenau	307	4	311
42	Alsace	67	5	32	063	Breitenbach	698	11	709
42	Alsace	67	6	43	065	Breuschwickersheim	1254	10	1264
42	Alsace	67	3	23	066	La Broque	2858	107	2965
42	Alsace	67	6	05	067	Brumath	9880	122	10002
42	Alsace	67	7	25	069	Buhl	525	6	531
42	Alsace	67	4	06	070	Burbach	323	2	325
42	Alsace	67	4	06	071	Bust	453	6	459
42	Alsace	67	4	04	068	Buswiller	190	4	194
42	Alsace	67	4	20	072	Butten	642	10	652
42	Alsace	67	5	24	073	Châtenois	4088	89	4177
42	Alsace	67	7	34	074	Cleebourg	704	18	722
42	Alsace	67	7	34	075	Climbach	512	9	521
42	Alsace	67	3	19	076	Colroy-la-Roche	478	5	483
42	Alsace	67	3	33	077	Cosswiller	564	19	583
42	Alsace	67	4	13	078	Crastatt	210	3	213
42	Alsace	67	7	25	079	Croettwiller	170	4	174
42	Alsace	67	3	14	080	Dachstein	1614	32	1646
42	Alsace	67	3	33	081	Dahlenheim	749	10	759
42	Alsace	67	2	03	082	Dalhunden	998	11	1009
42	Alsace	67	2	15	083	Dambach	796	13	809
42	Alsace	67	5	01	084	Dambach-la-Ville	1969	55	2024
42	Alsace	67	3	33	085	Dangolsheim	664	20	684
42	Alsace	67	5	07	086	Daubensand	371	9	380
42	Alsace	67	2	09	087	Dauendorf	1434	13	1447
42	Alsace	67	4	20	088	Dehlingen	375	9	384
42	Alsace	67	4	21	089	Dettwiller	2677	62	2739
42	Alsace	67	5	12	090	Diebolsheim	649	42	691
42	Alsace	67	4	20	091	Diedendorf	335	12	347
42	Alsace	67	5	32	092	Dieffenbach-au-Val	618	17	635
42	Alsace	67	7	35	093	Dieffenbach-lès-Woerth	340	6	346
42	Alsace	67	5	24	094	Dieffenthal	256	4	260
42	Alsace	67	4	06	095	Diemeringen	1628	45	1673
42	Alsace	67	4	13	096	Dimbsthal	302	7	309
42	Alsace	67	6	31	097	Dingsheim	1308	26	1334
42	Alsace	67	3	14	098	Dinsheim-sur-Bruche	1365	26	1391
42	Alsace	67	4	20	099	Domfessel	307	4	311
42	Alsace	67	6	05	100	Donnenheim	259	8	267
42	Alsace	67	3	14	101	Dorlisheim	2478	44	2522
42	Alsace	67	6	31	102	Dossenheim-Kochersberg	234	5	239
42	Alsace	67	4	04	103	Dossenheim-sur-Zinsel	1132	27	1159
42	Alsace	67	7	26	104	Drachenbronn-Birlenbach	943	10	953
42	Alsace	67	4	06	105	Drulingen	1448	29	1477
42	Alsace	67	2	03	106	Drusenheim	5052	43	5095
42	Alsace	67	6	10	107	Duntzenheim	615	8	623
42	Alsace	67	6	08	108	Duppigheim	1548	12	1560
42	Alsace	67	6	31	109	Durningen	643	17	660
42	Alsace	67	7	35	110	Durrenbach	1090	25	1115
42	Alsace	67	4	06	111	Durstel	408	8	416
42	Alsace	67	3	14	112	Duttlenheim	2876	25	2901
42	Alsace	67	7	25	113	Eberbach-Seltz	418	5	423
42	Alsace	67	5	24	115	Ebersheim	2147	32	2179
42	Alsace	67	5	24	116	Ebersmunster	465	38	503
42	Alsace	67	4	21	117	Eckartswiller	450	9	459
42	Alsace	67	6	43	118	Eckbolsheim	6421	70	6491
42	Alsace	67	6	05	119	Eckwersheim	1406	19	1425
42	Alsace	67	5	01	120	Eichhoffen	561	10	571
42	Alsace	67	5	12	121	Elsenheim	817	15	832
42	Alsace	67	2	15	123	Engwiller	470	5	475
42	Alsace	67	6	08	124	Entzheim	1752	22	1774
42	Alsace	67	5	01	125	Epfig	2168	62	2230
42	Alsace	67	4	17	126	Erckartswiller	297	3	300
42	Alsace	67	3	14	127	Ergersheim	1169	22	1191
42	Alsace	67	3	14	128	Ernolsheim-Bruche	1660	26	1686
42	Alsace	67	4	21	129	Ernolsheim-lès-Saverne	600	15	615
42	Alsace	67	5	07	130	Erstein	10791	163	10954
42	Alsace	67	6	08	131	Eschau	4776	62	4838
42	Alsace	67	7	35	132	Eschbach	930	19	949
42	Alsace	67	4	17	133	Eschbourg	493	14	507
42	Alsace	67	4	06	134	Eschwiller	180	3	183
42	Alsace	67	6	10	135	Ettendorf	815	20	835
42	Alsace	67	4	06	136	Eywiller	268	3	271
42	Alsace	67	6	08	137	Fegersheim	5367	65	5432
42	Alsace	67	6	31	138	Fessenheim-le-Bas	521	5	526
42	Alsace	67	3	33	139	Flexbourg	479	12	491
42	Alsace	67	2	03	140	Forstfeld	725	7	732
42	Alsace	67	7	35	141	Forstheim	567	14	581
42	Alsace	67	2	03	142	Fort-Louis	329	0	329
42	Alsace	67	5	32	143	Fouchy	660	10	670
42	Alsace	67	3	23	144	Fouday	371	5	376
42	Alsace	67	6	10	145	Friedolsheim	245	0	245
42	Alsace	67	5	02	146	Friesenheim	637	8	645
42	Alsace	67	7	35	147	Froeschwiller	535	10	545
42	Alsace	67	4	17	148	Frohmuhl	185	4	189
42	Alsace	67	4	21	149	Furchhausen	395	17	412
42	Alsace	67	6	31	150	Furdenheim	1230	7	1237
42	Alsace	67	6	05	151	Gambsheim	4569	54	4623
42	Alsace	67	6	08	152	Geispolsheim	7074	79	7153
42	Alsace	67	6	10	153	Geiswiller	198	2	200
42	Alsace	67	5	07	154	Gerstheim	3233	29	3262
42	Alsace	67	5	01	155	Gertwiller	1039	22	1061
42	Alsace	67	6	05	156	Geudertheim	2323	21	2344
42	Alsace	67	6	10	158	Gingsheim	318	5	323
42	Alsace	67	4	06	159	Goerlingen	255	6	261
42	Alsace	67	7	35	160	Goersdorf	1142	14	1156
42	Alsace	67	4	13	161	Gottenhouse	382	13	395
42	Alsace	67	4	21	162	Gottesheim	345	2	347
42	Alsace	67	6	31	163	Gougenheim	557	4	561
42	Alsace	67	5	16	164	Goxwiller	822	18	840
42	Alsace	67	3	23	165	Grandfontaine	401	6	407
42	Alsace	67	6	10	166	Grassendorf	203	6	209
42	Alsace	67	3	18	167	Grendelbruch	1258	42	1300
42	Alsace	67	3	14	168	Gresswiller	1538	32	1570
42	Alsace	67	6	05	169	Gries	2759	30	2789
42	Alsace	67	3	18	172	Griesheim-près-Molsheim	2036	32	2068
42	Alsace	67	6	31	173	Griesheim-sur-Souffel	1150	29	1179
42	Alsace	67	2	15	174	Gumbrechtshoffen	1191	19	1210
42	Alsace	67	2	15	176	Gundershoffen	3525	47	3572
42	Alsace	67	4	06	178	Gungwiller	278	3	281
42	Alsace	67	7	35	177	Gunstett	698	13	711
42	Alsace	67	4	13	179	Haegen	633	12	645
42	Alsace	67	2	09	180	Haguenau	34280	633	34913
42	Alsace	67	6	31	181	Handschuheim	297	2	299
42	Alsace	67	6	43	182	Hangenbieten	1469	12	1481
42	Alsace	67	4	20	183	Harskirchen	852	9	861
42	Alsace	67	7	26	184	Hatten	1954	31	1985
42	Alsace	67	4	21	185	Hattmatt	673	16	689
42	Alsace	67	7	35	186	Hegeney	380	0	380
42	Alsace	67	5	12	187	Heidolsheim	469	3	472
42	Alsace	67	3	14	188	Heiligenberg	654	11	665
42	Alsace	67	5	01	189	Heiligenstein	966	20	986
42	Alsace	67	4	13	190	Hengwiller	178	1	179
42	Alsace	67	4	20	191	Herbitzheim	1912	36	1948
42	Alsace	67	5	02	192	Herbsheim	881	8	889
42	Alsace	67	2	03	194	Herrlisheim	4757	60	4817
42	Alsace	67	5	12	195	Hessenheim	582	9	591
42	Alsace	67	5	12	196	Hilsenheim	2523	129	2652
42	Alsace	67	5	07	197	Hindisheim	1392	22	1414
42	Alsace	67	4	17	198	Hinsbourg	125	3	128
42	Alsace	67	4	20	199	Hinsingen	81	1	82
42	Alsace	67	5	07	200	Hipsheim	824	37	861
42	Alsace	67	4	06	201	Hirschland	332	12	344
42	Alsace	67	6	10	202	Hochfelden	3367	41	3408
42	Alsace	67	2	09	203	Hochstett	315	7	322
42	Alsace	67	6	44	204	Hoenheim	10495	125	10620
42	Alsace	67	6	05	205	Hoerdt	4440	64	4504
42	Alsace	67	7	26	206	Hoffen	1177	19	1196
42	Alsace	67	6	10	207	Hohatzenheim	205	3	208
42	Alsace	67	4	13	208	Hohengoeft	523	6	529
42	Alsace	67	6	10	209	Hohfrankenheim	259	4	263
42	Alsace	67	5	01	210	Le Hohwald	501	8	509
42	Alsace	67	6	08	212	Holtzheim	3015	21	3036
42	Alsace	67	7	26	213	Hunspach	680	16	696
42	Alsace	67	6	31	214	Hurtigheim	574	5	579
42	Alsace	67	2	09	215	Huttendorf	465	8	473
42	Alsace	67	5	02	216	Huttenheim	2524	39	2563
42	Alsace	67	5	07	217	Ichtratzheim	294	1	295
42	Alsace	67	6	42	218	Illkirch-Graffenstaden	26805	751	27556
42	Alsace	67	6	10	220	Ingenheim	347	1	348
42	Alsace	67	7	26	221	Ingolsheim	287	2	289
42	Alsace	67	4	04	222	Ingwiller	4156	54	4210
42	Alsace	67	5	16	223	Innenheim	1115	15	1130
42	Alsace	67	6	10	225	Issenhausen	114	5	119
42	Alsace	67	6	43	226	Ittenheim	2122	32	2154
42	Alsace	67	5	01	227	Itterswiller	267	8	275
42	Alsace	67	4	13	229	Jetterswiller	200	8	208
42	Alsace	67	2	09	230	Kaltenhouse	2279	12	2291
42	Alsace	67	2	03	231	Kauffenheim	219	2	221
42	Alsace	67	7	26	232	Keffenach	208	6	214
42	Alsace	67	5	02	233	Kertzfeld	1352	8	1360
42	Alsace	67	4	20	234	Keskastel	1582	34	1616
42	Alsace	67	7	25	235	Kesseldorf	433	4	437
42	Alsace	67	6	31	236	Kienheim	594	15	609
42	Alsace	67	6	05	237	Kilstett	2357	15	2372
42	Alsace	67	2	15	238	Kindwiller	586	12	598
42	Alsace	67	5	24	239	Kintzheim	1551	32	1583
42	Alsace	67	3	33	240	Kirchheim	639	10	649
42	Alsace	67	4	06	241	Kirrberg	178	1	179
42	Alsace	67	4	04	242	Kirrwiller	511	11	522
42	Alsace	67	4	13	244	Kleingoeft	138	5	143
42	Alsace	67	4	13	245	Knoersheim	203	6	209
42	Alsace	67	5	02	246	Kogenheim	1098	10	1108
42	Alsace	67	6	08	247	Kolbsheim	817	6	823
42	Alsace	67	5	16	248	Krautergersheim	1689	15	1704
42	Alsace	67	6	05	249	Krautwiller	186	2	188
42	Alsace	67	6	05	250	Kriegsheim	721	20	741
42	Alsace	67	6	05	252	Kurtzenhouse	999	8	1007
42	Alsace	67	6	31	253	Kuttolsheim	663	13	676
42	Alsace	67	7	26	254	Kutzenhausen	906	16	922
42	Alsace	67	5	32	255	Lalaye	439	5	444
42	Alsace	67	6	43	256	Lampertheim	2950	70	3020
42	Alsace	67	7	35	257	Lampertsloch	702	12	714
42	Alsace	67	4	13	258	Landersheim	188	4	192
42	Alsace	67	7	35	259	Langensoultzbach	913	19	932
42	Alsace	67	7	35	260	Laubach	313	3	316
42	Alsace	67	7	11	261	Lauterbourg	2274	50	2324
42	Alsace	67	7	34	263	Lembach	1695	35	1730
42	Alsace	67	2	03	264	Leutenheim	855	13	868
42	Alsace	67	4	17	265	Lichtenberg	567	7	574
42	Alsace	67	5	07	266	Limersheim	651	7	658
42	Alsace	67	6	42	267	Lingolsheim	16441	198	16639
42	Alsace	67	6	08	268	Lipsheim	2500	24	2524
42	Alsace	67	4	21	269	Littenheim	284	2	286
42	Alsace	67	6	10	270	Lixhausen	342	4	346
42	Alsace	67	7	26	271	Lobsann	608	21	629
42	Alsace	67	4	13	272	Lochwiller	434	14	448
42	Alsace	67	4	17	273	Lohr	499	11	510
42	Alsace	67	4	20	274	Lorentzen	206	1	207
42	Alsace	67	4	21	275	Lupstein	817	9	826
42	Alsace	67	3	14	276	Lutzelhouse	1830	31	1861
42	Alsace	67	5	12	277	Mackenheim	727	14	741
42	Alsace	67	4	06	278	Mackwiller	598	12	610
42	Alsace	67	4	21	279	Maennolsheim	241	2	243
42	Alsace	67	5	32	280	Maisonsgoutte	828	10	838
42	Alsace	67	5	12	281	Marckolsheim	4218	62	4280
42	Alsace	67	3	33	282	Marlenheim	3711	53	3764
42	Alsace	67	4	13	283	Marmoutier	2822	72	2894
42	Alsace	67	5	02	285	Matzenheim	1446	140	1586
42	Alsace	67	5	16	286	Meistratzheim	1411	18	1429
42	Alsace	67	6	10	287	Melsheim	584	10	594
42	Alsace	67	7	26	288	Memmelshoffen	322	5	327
42	Alsace	67	4	04	289	Menchhoffen	572	11	583
42	Alsace	67	7	26	290	Merkwiller-Pechelbronn	968	19	987
42	Alsace	67	2	15	291	Mertzwiller	3488	52	3540
42	Alsace	67	2	15	292	Mietesheim	667	15	682
42	Alsace	67	6	10	293	Minversheim	677	3	680
42	Alsace	67	5	01	295	Mittelbergheim	653	16	669
42	Alsace	67	6	43	296	Mittelhausbergen	1712	31	1743
42	Alsace	67	6	10	297	Mittelhausen	534	8	542
42	Alsace	67	6	05	298	Mittelschaeffolsheim	527	7	534
42	Alsace	67	3	18	299	Mollkirch	962	19	981
42	Alsace	67	3	14	300	Molsheim	9215	181	9396
42	Alsace	67	6	05	301	Mommenheim	1768	33	1801
42	Alsace	67	4	21	302	Monswiller	2156	26	2182
42	Alsace	67	7	35	303	Morsbronn-les-Bains	690	13	703
42	Alsace	67	2	09	304	Morschwiller	564	12	576
42	Alsace	67	7	25	305	Mothern	2038	28	2066
42	Alsace	67	3	14	306	Muhlbach-sur-Bruche	652	75	727
42	Alsace	67	4	04	307	Mulhausen	460	8	468
42	Alsace	67	7	25	308	Munchhausen	746	12	758
42	Alsace	67	6	43	309	Mundolsheim	4941	104	5045
42	Alsace	67	5	12	310	Mussig	1151	37	1188
42	Alsace	67	5	12	311	Muttersholtz	1922	38	1960
42	Alsace	67	6	10	312	Mutzenhouse	412	2	414
42	Alsace	67	3	14	313	Mutzig	5664	68	5732
42	Alsace	67	3	23	314	Natzwiller	596	10	606
42	Alsace	67	7	11	315	Neewiller-près-Lauterbourg	653	16	669
42	Alsace	67	5	32	317	Neubois	659	10	669
42	Alsace	67	6	31	228	Neugartheim-Ittlenheim	791	15	806
42	Alsace	67	2	03	319	Neuhaeusel	359	3	362
42	Alsace	67	5	32	320	Neuve-Église	624	17	641
42	Alsace	67	3	23	321	Neuviller-la-Roche	395	10	405
42	Alsace	67	4	04	322	Neuwiller-lès-Saverne	1147	22	1169
42	Alsace	67	2	15	324	Niederbronn-les-Bains	4366	77	4443
42	Alsace	67	3	14	325	Niederhaslach	1389	18	1407
42	Alsace	67	6	43	326	Niederhausbergen	1295	26	1321
42	Alsace	67	7	11	327	Niederlauterbach	948	16	964
42	Alsace	67	4	04	328	Niedermodern	816	14	830
42	Alsace	67	5	16	329	Niedernai	1232	19	1251
42	Alsace	67	7	25	330	Niederroedern	907	15	922
42	Alsace	67	2	09	331	Niederschaeffolsheim	1260	16	1276
42	Alsace	67	4	04	333	Niedersoultzbach	252	4	256
42	Alsace	67	7	34	334	Niedersteinbach	152	3	155
42	Alsace	67	3	33	335	Nordheim	783	15	798
42	Alsace	67	5	07	336	Nordhouse	1682	19	1701
42	Alsace	67	5	01	337	Nothalten	464	14	478
42	Alsace	67	5	07	338	Obenheim	1400	17	1417
42	Alsace	67	2	15	340	Oberbronn	1528	22	1550
42	Alsace	67	7	35	341	Oberdorf-Spachbach	355	6	361
42	Alsace	67	3	14	342	Oberhaslach	1780	23	1803
42	Alsace	67	6	43	343	Oberhausbergen	4835	66	4901
42	Alsace	67	7	34	344	Oberhoffen-lès-Wissembourg	316	16	332
42	Alsace	67	2	03	345	Oberhoffen-sur-Moder	3304	40	3344
42	Alsace	67	7	25	346	Oberlauterbach	549	19	568
42	Alsace	67	4	04	347	Obermodern-Zutzendorf	1656	29	1685
42	Alsace	67	5	16	348	Obernai	10731	553	11284
42	Alsace	67	7	26	349	Oberroedern	531	11	542
42	Alsace	67	6	43	350	Oberschaeffolsheim	2139	26	2165
42	Alsace	67	4	04	352	Obersoultzbach	426	8	434
42	Alsace	67	7	34	353	Obersteinbach	236	5	241
42	Alsace	67	3	33	354	Odratzheim	443	7	450
42	Alsace	67	4	20	355	Oermingen	1231	16	1247
42	Alsace	67	2	03	356	Offendorf	2169	21	2190
42	Alsace	67	2	15	358	Offwiller	817	14	831
42	Alsace	67	2	09	359	Ohlungen	1333	11	1344
42	Alsace	67	5	12	360	Ohnenheim	882	26	908
42	Alsace	67	6	05	361	Olwisheim	512	6	518
42	Alsace	67	5	24	362	Orschwiller	609	11	620
42	Alsace	67	6	31	363	Osthoffen	812	6	818
42	Alsace	67	5	07	364	Osthouse	955	12	967
42	Alsace	67	6	42	365	Ostwald	11310	100	11410
42	Alsace	67	4	21	366	Ottersthal	705	23	728
42	Alsace	67	4	13	367	Otterswiller	1366	42	1408
42	Alsace	67	3	18	368	Ottrott	1634	32	1666
42	Alsace	67	4	06	369	Ottwiller	237	3	240
42	Alsace	67	4	17	370	Petersbach	677	8	685
42	Alsace	67	4	17	371	La Petite-Pierre	615	13	628
42	Alsace	67	4	04	372	Pfaffenhoffen	2735	46	2781
42	Alsace	67	4	17	373	Pfalzweyer	321	9	330
42	Alsace	67	6	31	374	Pfettisheim	770	12	782
42	Alsace	67	6	31	375	Pfulgriesheim	1256	28	1284
42	Alsace	67	3	19	377	Plaine	963	29	992
42	Alsace	67	6	08	378	Plobsheim	3936	49	3985
42	Alsace	67	7	35	379	Preuschdorf	962	10	972
42	Alsace	67	4	21	380	Printzheim	221	1	222
42	Alsace	67	4	17	381	Puberg	338	5	343
42	Alsace	67	6	31	382	Quatzenheim	828	11	839
42	Alsace	67	4	13	383	Rangen	190	3	193
42	Alsace	67	3	19	384	Ranrupt	347	8	355
42	Alsace	67	4	20	385	Ratzwiller	252	3	255
42	Alsace	67	4	06	386	Rauwiller	222	0	222
42	Alsace	67	5	01	387	Reichsfeld	304	3	307
42	Alsace	67	2	15	388	Reichshoffen	5518	119	5637
42	Alsace	67	6	43	389	Reichstett	4397	40	4437
42	Alsace	67	4	13	391	Reinhardsmunster	473	17	490
42	Alsace	67	4	17	392	Reipertswiller	934	5	939
42	Alsace	67	7	26	394	Retschwiller	278	10	288
42	Alsace	67	4	13	395	Reutenbourg	386	5	391
42	Alsace	67	4	06	396	Rexingen	196	4	200
42	Alsace	67	5	02	397	Rhinau	2696	38	2734
42	Alsace	67	5	12	398	Richtolsheim	349	3	352
42	Alsace	67	7	34	400	Riedseltz	1119	24	1143
42	Alsace	67	4	20	401	Rimsdorf	292	4	296
42	Alsace	67	6	10	402	Ringeldorf	87	0	87
42	Alsace	67	6	10	403	Ringendorf	434	6	440
42	Alsace	67	7	26	404	Rittershoffen	895	18	913
42	Alsace	67	2	03	405	Roeschwoog	2162	31	2193
42	Alsace	67	6	31	406	Rohr	273	8	281
42	Alsace	67	2	03	407	Rohrwiller	1675	14	1689
42	Alsace	67	3	33	408	Romanswiller	1356	17	1373
42	Alsace	67	2	03	409	Roppenheim	941	17	958
42	Alsace	67	3	18	410	Rosenwiller	674	16	690
42	Alsace	67	3	18	411	Rosheim	4834	102	4936
42	Alsace	67	5	02	412	Rossfeld	848	12	860
42	Alsace	67	4	17	413	Rosteig	584	3	587
42	Alsace	67	3	23	414	Rothau	1589	19	1608
42	Alsace	67	2	15	415	Rothbach	469	13	482
42	Alsace	67	7	34	416	Rott	472	5	477
42	Alsace	67	6	05	417	Rottelsheim	327	2	329
42	Alsace	67	2	03	418	Rountzenheim	1045	21	1066
42	Alsace	67	3	23	420	Russ	1229	21	1250
42	Alsace	67	3	19	421	Saales	850	10	860
42	Alsace	67	5	12	422	Saasenheim	601	14	615
42	Alsace	67	6	10	423	Saessolsheim	516	9	525
42	Alsace	67	3	19	424	Saint-Blaise-la-Roche	225	1	226
42	Alsace	67	4	21	425	Saint-Jean-Saverne	601	23	624
42	Alsace	67	5	32	426	Saint-Martin	348	3	351
42	Alsace	67	5	32	427	Saint-Maurice	366	15	381
42	Alsace	67	3	18	428	Saint-Nabor	476	20	496
42	Alsace	67	5	01	429	Saint-Pierre	587	9	596
42	Alsace	67	5	32	430	Saint-Pierre-Bois	726	18	744
42	Alsace	67	4	13	431	Salenthal	221	3	224
42	Alsace	67	7	11	432	Salmbach	577	14	591
42	Alsace	67	5	02	433	Sand	1139	11	1150
42	Alsace	67	4	20	434	Sarre-Union	3072	67	3139
42	Alsace	67	4	20	435	Sarrewerden	938	23	961
42	Alsace	67	3	19	436	Saulxures	538	7	545
42	Alsace	67	4	21	437	Saverne	12087	267	12354
42	Alsace	67	5	07	438	Schaeffersheim	817	7	824
42	Alsace	67	7	25	440	Schaffhouse-près-Seltz	575	11	586
42	Alsace	67	6	10	439	Schaffhouse-sur-Zorn	385	14	399
42	Alsace	67	4	04	441	Schalkendorf	316	2	318
42	Alsace	67	3	33	442	Scharrachbergheim-Irmstett	1201	53	1254
42	Alsace	67	7	11	443	Scheibenhard	822	18	840
42	Alsace	67	6	10	444	Scherlenheim	125	1	126
42	Alsace	67	5	24	445	Scherwiller	3069	64	3133
42	Alsace	67	4	04	446	Schillersdorf	438	11	449
42	Alsace	67	6	22	447	Schiltigheim	30952	266	31218
42	Alsace	67	3	23	448	Schirmeck	2429	63	2492
42	Alsace	67	2	03	449	Schirrhein	2180	28	2208
42	Alsace	67	2	03	450	Schirrhoffen	702	8	710
42	Alsace	67	7	34	451	Schleithal	1437	38	1475
42	Alsace	67	6	31	452	Schnersheim	1307	17	1324
42	Alsace	67	5	12	453	Schoenau	584	13	597
42	Alsace	67	4	17	454	Schoenbourg	442	9	451
42	Alsace	67	7	26	455	Schoenenbourg	670	6	676
42	Alsace	67	4	20	456	Schopperten	401	9	410
42	Alsace	67	2	09	458	Schweighouse-sur-Moder	4932	76	5008
42	Alsace	67	4	13	459	Schwenheim	661	8	669
42	Alsace	67	6	10	460	Schwindratzheim	1585	15	1600
42	Alsace	67	5	12	461	Schwobsheim	305	2	307
42	Alsace	67	7	34	351	Seebach	1731	55	1786
42	Alsace	67	5	24	462	Sélestat	19197	379	19576
42	Alsace	67	7	25	463	Seltz	3220	24	3244
42	Alsace	67	5	02	464	Sermersheim	791	9	800
42	Alsace	67	2	03	465	Sessenheim	2133	19	2152
42	Alsace	67	7	25	466	Siegen	514	13	527
42	Alsace	67	4	06	467	Siewiller	417	8	425
42	Alsace	67	4	20	468	Siltzheim	663	7	670
42	Alsace	67	4	13	469	Singrist	370	6	376
42	Alsace	67	3	23	470	Solbach	109	5	114
42	Alsace	67	6	43	471	Souffelweyersheim	7425	78	7503
42	Alsace	67	2	03	472	Soufflenheim	4918	51	4969
42	Alsace	67	3	14	473	Soultz-les-Bains	928	24	952
42	Alsace	67	7	26	474	Soultz-sous-Forêts	2939	42	2981
42	Alsace	67	4	17	475	Sparsbach	260	6	266
42	Alsace	67	2	03	476	Stattmatten	677	2	679
42	Alsace	67	5	32	477	Steige	589	10	599
42	Alsace	67	4	21	478	Steinbourg	1979	21	2000
42	Alsace	67	7	34	479	Steinseltz	623	5	628
42	Alsace	67	3	14	480	Still	1711	28	1739
42	Alsace	67	5	01	481	Stotzheim	1080	30	1110
42	Alsace	67	8	99	482	Strasbourg	271782	4619	276401
42	Alsace	67	4	17	483	Struth	244	5	249
42	Alsace	67	7	26	484	Stundwiller	485	7	492
42	Alsace	67	6	31	485	Stutzheim-Offenheim	1453	26	1479
42	Alsace	67	5	12	486	Sundhouse	1578	22	1600
42	Alsace	67	7	26	487	Surbourg	1620	31	1651
42	Alsace	67	4	06	488	Thal-Drulingen	176	3	179
42	Alsace	67	4	13	489	Thal-Marmoutier	767	13	780
42	Alsace	67	5	32	490	Thanvillé	591	24	615
42	Alsace	67	4	17	491	Tieffenbach	290	8	298
42	Alsace	67	3	33	492	Traenheim	690	13	703
42	Alsace	67	5	32	493	Triembach-au-Val	460	5	465
42	Alsace	67	7	25	494	Trimbach	516	7	523
42	Alsace	67	6	31	495	Truchtersheim	2937	47	2984
42	Alsace	67	2	15	496	Uberach	1196	32	1228
42	Alsace	67	2	09	497	Uhlwiller	701	9	710
42	Alsace	67	2	15	498	Uhrwiller	693	12	705
42	Alsace	67	5	32	499	Urbeis	309	17	326
42	Alsace	67	3	14	500	Urmatt	1448	18	1466
42	Alsace	67	5	07	501	Uttenheim	572	10	582
42	Alsace	67	2	15	502	Uttenhoffen	175	5	180
42	Alsace	67	4	04	503	Uttwiller	170	2	172
42	Alsace	67	5	16	504	Valff	1254	19	1273
42	Alsace	67	5	24	505	La Vancelle	382	19	401
42	Alsace	67	6	05	506	Vendenheim	5559	72	5631
42	Alsace	67	5	32	507	Villé	1848	41	1889
42	Alsace	67	4	20	508	Voellerdingen	421	10	431
42	Alsace	67	4	06	509	Volksberg	346	5	351
42	Alsace	67	2	09	510	Wahlenheim	386	4	390
42	Alsace	67	7	35	511	Walbourg	795	307	1102
42	Alsace	67	2	15	512	La Walck	1147	13	1160
42	Alsace	67	3	23	513	Waldersbach	145	1	146
42	Alsace	67	4	06	514	Waldhambach	647	13	660
42	Alsace	67	4	21	515	Waldolwisheim	535	12	547
42	Alsace	67	6	10	516	Waltenheim-sur-Zorn	719	21	740
42	Alsace	67	3	33	517	Wangen	720	20	740
42	Alsace	67	3	33	122	Wangenbourg-Engenthal	1369	20	1389
42	Alsace	67	6	05	519	La Wantzenau	5902	127	6029
42	Alsace	67	3	33	520	Wasselonne	5595	56	5651
42	Alsace	67	4	04	521	Weinbourg	421	9	430
42	Alsace	67	4	06	522	Weislingen	566	11	577
42	Alsace	67	2	09	523	Weitbruch	2656	43	2699
42	Alsace	67	4	17	524	Weiterswiller	571	18	589
42	Alsace	67	3	33	525	Westhoffen	1664	28	1692
42	Alsace	67	5	07	526	Westhouse	1398	21	1419
42	Alsace	67	4	13	527	Westhouse-Marmoutier	258	4	262
42	Alsace	67	4	06	528	Weyer	603	10	613
42	Alsace	67	6	05	529	Weyersheim	3350	52	3402
42	Alsace	67	6	10	530	Wickersheim-Wilshausen	442	8	450
42	Alsace	67	3	23	531	Wildersbach	319	9	328
42	Alsace	67	6	31	532	Willgottheim	1077	17	1094
42	Alsace	67	6	10	534	Wilwisheim	693	12	705
42	Alsace	67	4	17	535	Wimmenau	1134	18	1152
42	Alsace	67	2	15	536	Windstein	172	5	177
42	Alsace	67	7	34	537	Wingen	453	10	463
42	Alsace	67	4	17	538	Wingen-sur-Moder	1551	31	1582
42	Alsace	67	6	10	539	Wingersheim	1175	9	1184
42	Alsace	67	2	09	540	Wintershouse	876	11	887
42	Alsace	67	7	25	541	Wintzenbach	595	6	601
42	Alsace	67	6	31	542	Wintzenheim-Kochersberg	320	6	326
42	Alsace	67	3	23	543	Wisches	2195	34	2229
42	Alsace	67	7	34	544	Wissembourg	7803	281	8084
42	Alsace	67	5	02	545	Witternheim	510	9	519
42	Alsace	67	2	09	546	Wittersheim	608	14	622
42	Alsace	67	5	12	547	Wittisheim	2053	30	2083
42	Alsace	67	6	31	548	Wiwersheim	808	10	818
42	Alsace	67	7	35	550	Woerth	1811	40	1851
42	Alsace	67	6	43	551	Wolfisheim	3955	50	4005
42	Alsace	67	4	20	552	Wolfskirchen	352	13	365
42	Alsace	67	4	21	553	Wolschheim	308	5	313
42	Alsace	67	3	14	554	Wolxheim	874	17	891
42	Alsace	67	4	13	555	Zehnacker	263	6	269
42	Alsace	67	4	13	556	Zeinheim	195	2	197
42	Alsace	67	5	16	557	Zellwiller	722	11	733
42	Alsace	67	2	15	558	Zinswiller	802	10	812
42	Alsace	67	4	17	559	Zittersheim	257	8	265
42	Alsace	67	6	10	560	Zoebersdorf	177	15	192
42	Alsace	68	2	19	001	Algolsheim	1178	14	1192
42	Alsace	68	1	05	002	Altenach	386	8	394
42	Alsace	68	1	01	004	Altkirch	5765	173	5938
42	Alsace	68	5	12	005	Ammerschwihr	1864	68	1932
42	Alsace	68	1	05	006	Ammerzwiller	357	12	369
42	Alsace	68	2	02	007	Andolsheim	2202	75	2277
42	Alsace	68	2	19	008	Appenwihr	578	4	582
42	Alsace	68	2	02	009	Artzenheim	810	16	826
42	Alsace	68	1	01	010	Aspach	1144	30	1174
42	Alsace	68	6	03	011	Aspach-le-Bas	1329	40	1369
42	Alsace	68	6	25	012	Aspach-le-Haut	1470	43	1513
42	Alsace	68	4	11	013	Attenschwiller	895	18	913
42	Alsace	68	5	23	014	Aubure	398	12	410
42	Alsace	68	4	31	015	Baldersheim	2565	39	2604
42	Alsace	68	2	19	016	Balgau	915	11	926
42	Alsace	68	1	01	017	Ballersdorf	811	23	834
42	Alsace	68	1	05	018	Balschwiller	824	15	839
42	Alsace	68	2	02	019	Baltzenheim	583	8	591
42	Alsace	68	4	31	020	Bantzenheim	1639	18	1657
42	Alsace	68	4	13	021	Bartenheim	3656	56	3712
42	Alsace	68	4	31	022	Battenheim	1336	44	1380
42	Alsace	68	5	12	023	Beblenheim	973	24	997
42	Alsace	68	1	05	024	Bellemagny	191	6	197
42	Alsace	68	1	07	025	Bendorf	232	2	234
42	Alsace	68	5	12	026	Bennwihr	1281	42	1323
42	Alsace	68	1	01	027	Berentzwiller	325	10	335
42	Alsace	68	5	20	028	Bergheim	1895	34	1929
42	Alsace	68	3	08	029	Bergholtz	1081	16	1097
42	Alsace	68	3	08	030	Bergholtzzell	450	8	458
42	Alsace	68	6	03	031	Bernwiller	642	20	662
42	Alsace	68	3	24	032	Berrwiller	1163	27	1190
42	Alsace	68	1	10	033	Bettendorf	481	15	496
42	Alsace	68	1	07	034	Bettlach	329	4	333
42	Alsace	68	1	07	035	Biederthal	308	14	322
42	Alsace	68	2	19	036	Biesheim	2447	37	2484
42	Alsace	68	3	06	037	Biltzheim	378	6	384
42	Alsace	68	2	02	038	Bischwihr	974	23	997
42	Alsace	68	1	10	039	Bisel	574	9	583
42	Alsace	68	6	25	040	Bitschwiller-lès-Thann	2028	50	2078
42	Alsace	68	3	06	041	Blodelsheim	1729	25	1754
42	Alsace	68	4	11	042	Blotzheim	4121	103	4224
42	Alsace	68	3	24	043	Bollwiller	3597	54	3651
42	Alsace	68	5	14	044	Le Bonhomme	827	30	857
42	Alsace	68	6	25	045	Bourbach-le-Bas	617	9	626
42	Alsace	68	6	15	046	Bourbach-le-Haut	421	10	431
42	Alsace	68	1	07	049	Bouxwiller	456	18	474
42	Alsace	68	1	05	050	Bréchaumont	414	2	416
42	Alsace	68	2	18	051	Breitenbach-Haut-Rhin	848	25	873
42	Alsace	68	1	05	052	Bretten	169	2	171
42	Alsace	68	4	13	054	Brinckheim	348	12	360
42	Alsace	68	4	17	055	Bruebach	1031	27	1058
42	Alsace	68	4	17	056	Brunstatt	6125	178	6303
42	Alsace	68	1	05	057	Buethwiller	268	4	272
42	Alsace	68	3	08	058	Buhl	3275	68	3343
42	Alsace	68	6	03	059	Burnhaupt-le-Bas	1794	27	1821
42	Alsace	68	6	03	060	Burnhaupt-le-Haut	1626	51	1677
42	Alsace	68	4	11	061	Buschwiller	970	9	979
42	Alsace	68	1	01	062	Carspach	1980	105	2085
42	Alsace	68	6	03	063	Cernay	11268	259	11527
42	Alsace	68	4	31	064	Chalampé	949	18	967
42	Alsace	68	1	05	065	Chavannes-sur-l;Étang	613	5	618
42	Alsace	68	2	98	066	Colmar	67615	1572	69187
42	Alsace	68	1	07	067	Courtavon	327	9	336
42	Alsace	68	1	05	068	Dannemarie	2323	46	2369
42	Alsace	68	2	19	069	Dessenheim	1229	25	1254
42	Alsace	68	4	17	070	Didenheim	1738	33	1771
42	Alsace	68	1	05	071	Diefmatten	301	5	306
42	Alsace	68	4	13	072	Dietwiller	1414	29	1443
42	Alsace	68	6	15	073	Dolleren	451	9	460
42	Alsace	68	1	07	074	Durlinsdorf	501	12	513
42	Alsace	68	1	07	075	Durmenach	955	19	974
42	Alsace	68	2	02	076	Durrenentzen	947	9	956
42	Alsace	68	1	01	077	Eglingen	358	7	365
42	Alsace	68	2	26	078	Eguisheim	1683	41	1724
42	Alsace	68	1	05	079	Elbach	260	6	266
42	Alsace	68	1	01	080	Emlingen	268	5	273
42	Alsace	68	3	06	082	Ensisheim	7247	101	7348
42	Alsace	68	2	18	083	Eschbach-au-Val	378	13	391
42	Alsace	68	4	09	084	Eschentzwiller	1518	46	1564
42	Alsace	68	1	05	085	Eteimbes	351	2	353
42	Alsace	68	1	05	086	Falkwiller	187	3	190
42	Alsace	68	1	10	087	Feldbach	458	12	470
42	Alsace	68	3	24	088	Feldkirch	954	17	971
42	Alsace	68	6	22	089	Fellering	1716	35	1751
42	Alsace	68	1	07	090	Ferrette	846	20	866
42	Alsace	68	3	06	091	Fessenheim	2276	44	2320
42	Alsace	68	1	07	092	Fislis	431	9	440
42	Alsace	68	4	17	093	Flaxlanden	1462	56	1518
42	Alsace	68	4	11	094	Folgensbourg	833	26	859
42	Alsace	68	2	02	095	Fortschwihr	1224	42	1266
42	Alsace	68	1	01	096	Franken	360	4	364
42	Alsace	68	5	14	097	Fréland	1409	26	1435
42	Alsace	68	1	10	098	Friesen	601	11	612
42	Alsace	68	1	01	099	Froeningen	681	11	692
42	Alsace	68	1	10	100	Fulleren	332	3	335
42	Alsace	68	4	17	101	Galfingue	801	12	813
42	Alsace	68	6	22	102	Geishouse	486	12	498
42	Alsace	68	4	13	103	Geispitzen	427	12	439
42	Alsace	68	2	19	104	Geiswasser	327	7	334
42	Alsace	68	1	05	105	Gildwiller	292	7	299
42	Alsace	68	6	22	106	Goldbach-Altenbach	285	16	301
42	Alsace	68	1	05	107	Gommersdorf	366	9	375
42	Alsace	68	1	10	108	Grentzingen	537	17	554
42	Alsace	68	2	18	109	Griesbach-au-Val	748	19	767
42	Alsace	68	2	02	110	Grussenheim	805	17	822
42	Alsace	68	3	21	111	Gueberschwihr	832	34	866
42	Alsace	68	3	08	112	Guebwiller	11461	296	11757
42	Alsace	68	5	20	113	Guémar	1382	21	1403
42	Alsace	68	1	05	114	Guevenatten	125	7	132
42	Alsace	68	6	25	115	Guewenheim	1291	24	1315
42	Alsace	68	3	21	116	Gundolsheim	737	19	756
42	Alsace	68	2	18	117	Gunsbach	957	15	972
42	Alsace	68	4	09	118	Habsheim	4865	67	4932
42	Alsace	68	1	05	119	Hagenbach	701	24	725
42	Alsace	68	4	11	120	Hagenthal-le-Bas	1151	23	1174
42	Alsace	68	4	11	121	Hagenthal-le-Haut	609	12	621
42	Alsace	68	3	24	122	Hartmannswiller	663	12	675
42	Alsace	68	3	21	123	Hattstatt	819	16	835
42	Alsace	68	1	01	124	Hausgauen	424	14	438
42	Alsace	68	1	05	125	Hecken	433	8	441
42	Alsace	68	4	11	126	Hégenheim	3172	76	3248
42	Alsace	68	1	01	127	Heidwiller	623	17	640
42	Alsace	68	1	10	128	Heimersdorf	655	14	669
42	Alsace	68	4	17	129	Heimsbrunn	1448	23	1471
42	Alsace	68	2	19	130	Heiteren	945	19	964
42	Alsace	68	1	01	131	Heiwiller	189	5	194
42	Alsace	68	4	13	132	Helfrantzkirch	759	18	777
42	Alsace	68	1	10	133	Henflingen	198	3	201
42	Alsace	68	2	26	134	Herrlisheim-près-Colmar	1779	37	1816
42	Alsace	68	4	11	135	Hésingue	2471	35	2506
42	Alsace	68	2	19	136	Hettenschlag	340	4	344
42	Alsace	68	1	10	137	Hindlingen	639	5	644
42	Alsace	68	1	10	138	Hirsingue	2224	25	2249
42	Alsace	68	1	10	139	Hirtzbach	1315	20	1335
42	Alsace	68	3	06	140	Hirtzfelden	1152	10	1162
42	Alsace	68	1	01	141	Hochstatt	2128	43	2171
42	Alsace	68	2	18	142	Hohrod	325	9	334
42	Alsace	68	2	02	143	Holtzwihr	1353	34	1387
42	Alsace	68	4	31	144	Hombourg	1129	9	1138
42	Alsace	68	2	02	145	Horbourg-Wihr	4931	136	5067
42	Alsace	68	2	02	146	Houssen	1762	42	1804
42	Alsace	68	5	20	147	Hunawihr	597	16	613
42	Alsace	68	1	01	148	Hundsbach	310	2	312
42	Alsace	68	4	11	149	Huningue	6664	108	6772
42	Alsace	68	2	26	150	Husseren-les-Châteaux	497	13	510
42	Alsace	68	6	22	151	Husseren-Wesserling	1002	30	1032
42	Alsace	68	1	01	152	Illfurth	2469	43	2512
42	Alsace	68	5	20	153	Illhaeusern	698	16	714
42	Alsace	68	4	31	154	Illzach	14596	307	14903
42	Alsace	68	5	12	155	Ingersheim	4696	81	4777
42	Alsace	68	3	24	156	Issenheim	3434	59	3493
42	Alsace	68	2	02	157	Jebsheim	1169	10	1179
42	Alsace	68	1	01	158	Jettingen	506	4	510
42	Alsace	68	3	24	159	Jungholtz	906	16	922
42	Alsace	68	4	13	160	Kappelen	522	8	530
42	Alsace	68	5	12	161	Katzenthal	549	12	561
42	Alsace	68	5	12	162	Kaysersberg	2713	57	2770
42	Alsace	68	4	13	163	Kembs	4514	86	4600
42	Alsace	68	5	12	164	Kientzheim	759	18	777
42	Alsace	68	1	07	165	Kiffis	236	4	240
42	Alsace	68	4	27	166	Kingersheim	12779	289	13068
42	Alsace	68	6	15	167	Kirchberg	826	19	845
42	Alsace	68	4	11	168	Knoeringue	364	11	375
42	Alsace	68	1	07	169	Koestlach	517	6	523
42	Alsace	68	4	13	170	Koetzingue	569	14	583
42	Alsace	68	6	22	171	Kruth	1007	26	1033
42	Alsace	68	2	02	172	Kunheim	1763	28	1791
42	Alsace	68	5	14	173	Labaroche	2286	75	2361
42	Alsace	68	4	13	174	Landser	1562	41	1603
42	Alsace	68	5	14	175	Lapoutroie	1991	54	2045
42	Alsace	68	1	10	176	Largitzen	300	3	303
42	Alsace	68	3	08	177	Lautenbach	1576	31	1607
42	Alsace	68	3	08	178	Lautenbachzell	977	22	999
42	Alsace	68	6	15	179	Lauw	962	34	996
42	Alsace	68	6	25	180	Leimbach	836	22	858
42	Alsace	68	1	07	181	Levoncourt	251	1	252
42	Alsace	68	4	11	182	Leymen	1136	37	1173
42	Alsace	68	4	11	183	Liebenswiller	198	2	200
42	Alsace	68	1	07	184	Liebsdorf	337	6	343
42	Alsace	68	5	23	185	Lièpvre	1756	20	1776
42	Alsace	68	1	07	186	Ligsdorf	331	8	339
42	Alsace	68	1	07	187	Linsdorf	318	13	331
42	Alsace	68	3	08	188	Linthal	634	11	645
42	Alsace	68	2	19	189	Logelheim	835	23	858
42	Alsace	68	1	07	190	Lucelle	40	0	40
42	Alsace	68	1	01	191	Luemschwiller	697	4	701
42	Alsace	68	2	18	193	Luttenbach-près-Munster	765	20	785
42	Alsace	68	1	07	194	Lutter	296	7	303
42	Alsace	68	4	27	195	Lutterbach	6126	140	6266
42	Alsace	68	1	05	196	Magny	294	2	296
42	Alsace	68	4	13	197	Magstatt-le-Bas	473	15	488
42	Alsace	68	4	13	198	Magstatt-le-Haut	272	3	275
42	Alsace	68	6	22	199	Malmerspach	522	7	529
42	Alsace	68	1	05	200	Manspach	560	9	569
42	Alsace	68	6	15	201	Masevaux	3300	41	3341
42	Alsace	68	1	10	202	Mertzen	212	6	218
42	Alsace	68	3	24	203	Merxheim	1286	23	1309
42	Alsace	68	2	18	204	Metzeral	1133	18	1151
42	Alsace	68	3	06	205	Meyenheim	1243	9	1252
42	Alsace	68	6	25	206	Michelbach	365	4	369
42	Alsace	68	4	11	207	Michelbach-le-Bas	704	22	726
42	Alsace	68	4	11	208	Michelbach-le-Haut	528	4	532
42	Alsace	68	5	12	209	Mittelwihr	802	19	821
42	Alsace	68	2	18	210	Mittlach	332	12	344
42	Alsace	68	6	22	211	Mitzach	426	15	441
42	Alsace	68	1	07	212	Moernach	562	14	576
42	Alsace	68	6	22	213	Mollau	421	4	425
42	Alsace	68	1	05	214	Montreux-Jeune	337	10	347
42	Alsace	68	1	05	215	Montreux-Vieux	883	13	896
42	Alsace	68	6	22	217	Moosch	1738	28	1766
42	Alsace	68	1	07	216	Mooslargue	492	16	508
42	Alsace	68	4	17	218	Morschwiller-le-Bas	3432	80	3512
42	Alsace	68	6	15	219	Mortzwiller	324	7	331
42	Alsace	68	1	07	221	Muespach	854	19	873
42	Alsace	68	1	07	222	Muespach-le-Haut	1006	22	1028
42	Alsace	68	2	18	223	Muhlbach-sur-Munster	755	15	770
42	Alsace	68	4	99	224	Mulhouse	109588	1685	111273
42	Alsace	68	3	06	225	Munchhouse	1616	33	1649
42	Alsace	68	2	18	226	Munster	4905	99	5004
42	Alsace	68	2	02	227	Muntzenheim	1110	39	1149
42	Alsace	68	3	06	228	Munwiller	456	14	470
42	Alsace	68	3	08	229	Murbach	140	3	143
42	Alsace	68	2	19	230	Nambsheim	615	12	627
42	Alsace	68	2	19	231	Neuf-Brisach	2017	26	2043
42	Alsace	68	4	11	232	Neuwiller	527	15	542
42	Alsace	68	6	15	233	Niederbruck	453	12	465
42	Alsace	68	3	06	234	Niederentzen	444	9	453
42	Alsace	68	3	06	235	Niederhergheim	969	12	981
42	Alsace	68	5	12	237	Niedermorschwihr	547	25	572
42	Alsace	68	4	31	238	Niffer	939	12	951
42	Alsace	68	6	15	239	Oberbruck	436	9	445
42	Alsace	68	1	10	240	Oberdorf	573	11	584
42	Alsace	68	3	06	241	Oberentzen	586	15	601
42	Alsace	68	3	06	242	Oberhergheim	1176	15	1191
42	Alsace	68	1	07	243	Oberlarg	152	2	154
42	Alsace	68	2	26	244	Obermorschwihr	365	31	396
42	Alsace	68	1	01	245	Obermorschwiller	426	13	439
42	Alsace	68	2	19	246	Obersaasheim	1021	25	1046
42	Alsace	68	6	22	247	Oderen	1306	15	1321
42	Alsace	68	1	07	248	Oltingue	741	13	754
42	Alsace	68	5	14	249	Orbey	3626	71	3697
42	Alsace	68	3	08	250	Orschwihr	1009	26	1035
42	Alsace	68	3	21	251	Osenbach	885	29	914
42	Alsace	68	5	20	252	Ostheim	1588	26	1614
42	Alsace	68	4	31	253	Ottmarsheim	1899	25	1924
42	Alsace	68	4	31	254	Petit-Landau	736	12	748
42	Alsace	68	3	21	255	Pfaffenheim	1327	29	1356
42	Alsace	68	4	27	256	Pfastatt	8957	150	9107
42	Alsace	68	1	10	257	Pfetterhouse	1055	23	1078
42	Alsace	68	3	06	258	Pulversheim	2895	62	2957
42	Alsace	68	1	07	259	Raedersdorf	508	9	517
42	Alsace	68	3	24	260	Raedersheim	1149	20	1169
42	Alsace	68	6	25	261	Rammersmatt	226	5	231
42	Alsace	68	6	22	262	Ranspach	831	15	846
42	Alsace	68	4	11	263	Ranspach-le-Bas	673	10	683
42	Alsace	68	4	11	264	Ranspach-le-Haut	598	16	614
42	Alsace	68	4	13	265	Rantzwiller	802	18	820
42	Alsace	68	3	06	266	Réguisheim	1792	26	1818
42	Alsace	68	4	27	267	Reiningue	1791	28	1819
42	Alsace	68	1	05	268	Retzwiller	634	14	648
42	Alsace	68	5	20	269	Ribeauvillé	4843	183	5026
42	Alsace	68	4	27	270	Richwiller	3458	51	3509
42	Alsace	68	4	09	271	Riedisheim	12301	360	12661
42	Alsace	68	2	02	272	Riedwihr	396	8	404
42	Alsace	68	1	10	273	Riespach	720	33	753
42	Alsace	68	3	08	274	Rimbach-près-Guebwiller	237	0	237
42	Alsace	68	6	15	275	Rimbach-près-Masevaux	495	9	504
42	Alsace	68	3	08	276	Rimbachzell	215	5	220
42	Alsace	68	5	12	277	Riquewihr	1203	42	1245
42	Alsace	68	4	09	278	Rixheim	12996	255	13251
42	Alsace	68	6	25	279	Roderen	895	17	912
42	Alsace	68	5	20	280	Rodern	331	8	339
42	Alsace	68	3	06	281	Roggenhouse	482	5	487
42	Alsace	68	1	05	282	Romagny	206	6	212
42	Alsace	68	5	23	283	Rombach-le-Franc	855	21	876
42	Alsace	68	1	07	284	Roppentzwiller	721	9	730
42	Alsace	68	5	20	285	Rorschwihr	401	12	413
42	Alsace	68	4	11	286	Rosenau	2130	31	2161
42	Alsace	68	3	21	287	Rouffach	4574	300	4874
42	Alsace	68	1	10	288	Ruederbach	358	11	369
42	Alsace	68	4	31	289	Ruelisheim	2365	59	2424
42	Alsace	68	3	06	291	Rumersheim-le-Haut	1111	15	1126
42	Alsace	68	3	06	290	Rustenhart	823	9	832
42	Alsace	68	6	22	292	Saint-Amarin	2387	55	2442
42	Alsace	68	1	01	081	Saint-Bernard	503	8	511
42	Alsace	68	1	05	293	Saint-Cosme	85	3	88
42	Alsace	68	5	20	296	Saint-Hippolyte	1043	19	1062
42	Alsace	68	4	11	297	Saint-Louis	20127	354	20481
42	Alsace	68	1	10	299	Saint-Ulrich	306	6	312
42	Alsace	68	5	23	294	Sainte-Croix-aux-Mines	1997	28	2025
42	Alsace	68	2	28	295	Sainte-Croix-en-Plaine	2730	48	2778
42	Alsace	68	5	23	298	Sainte-Marie-aux-Mines	5495	145	5640
42	Alsace	68	4	31	300	Sausheim	5471	85	5556
42	Alsace	68	4	13	301	Schlierbach	1169	39	1208
42	Alsace	68	6	03	302	Schweighouse-Thann	712	20	732
42	Alsace	68	1	01	303	Schwoben	259	10	269
42	Alsace	68	6	15	304	Sentheim	1596	18	1614
42	Alsace	68	1	10	305	Seppois-le-Bas	1188	14	1202
42	Alsace	68	1	10	306	Seppois-le-Haut	506	10	516
42	Alsace	68	6	15	307	Sewen	533	4	537
42	Alsace	68	6	15	308	Sickert	329	9	338
42	Alsace	68	4	13	309	Sierentz	3009	32	3041
42	Alsace	68	5	12	310	Sigolsheim	1172	35	1207
42	Alsace	68	2	18	311	Sondernach	656	13	669
42	Alsace	68	1	07	312	Sondersdorf	344	14	358
42	Alsace	68	6	15	313	Soppe-le-Bas	704	9	713
42	Alsace	68	6	15	314	Soppe-le-Haut	564	17	581
42	Alsace	68	3	24	315	Soultz-Haut-Rhin	7267	133	7400
42	Alsace	68	2	18	316	Soultzbach-les-Bains	673	9	682
42	Alsace	68	2	18	317	Soultzeren	1182	27	1209
42	Alsace	68	3	21	318	Soultzmatt	2313	49	2362
42	Alsace	68	1	01	319	Spechbach-le-Bas	728	23	751
42	Alsace	68	1	01	320	Spechbach-le-Haut	664	17	681
42	Alsace	68	6	03	321	Staffelfelden	3657	54	3711
42	Alsace	68	6	03	322	Steinbach	1286	36	1322
42	Alsace	68	4	13	323	Steinbrunn-le-Bas	634	19	653
42	Alsace	68	4	13	324	Steinbrunn-le-Haut	587	14	601
42	Alsace	68	1	10	325	Steinsoultz	783	12	795
42	Alsace	68	1	05	326	Sternenberg	161	3	164
42	Alsace	68	4	13	327	Stetten	320	7	327
42	Alsace	68	6	22	328	Storckensohn	238	10	248
42	Alsace	68	2	18	329	Stosswihr	1409	35	1444
42	Alsace	68	1	10	330	Strueth	328	8	336
42	Alsace	68	2	02	331	Sundhoffen	1913	56	1969
42	Alsace	68	1	01	332	Tagolsheim	691	12	703
42	Alsace	68	1	01	333	Tagsdorf	323	14	337
42	Alsace	68	6	25	334	Thann	7929	170	8099
42	Alsace	68	5	20	335	Thannenkirch	476	20	496
42	Alsace	68	1	05	336	Traubach-le-Bas	516	8	524
42	Alsace	68	1	05	337	Traubach-le-Haut	541	14	555
42	Alsace	68	2	26	338	Turckheim	3739	88	3827
42	Alsace	68	1	10	340	Ueberstrass	357	12	369
42	Alsace	68	4	13	341	Uffheim	880	26	906
42	Alsace	68	6	03	342	Uffholtz	1592	29	1621
42	Alsace	68	3	24	343	Ungersheim	2025	32	2057
42	Alsace	68	6	22	344	Urbès	460	11	471
42	Alsace	68	2	02	345	Urschenheim	696	16	712
42	Alsace	68	1	05	192	Valdieu-Lutran	391	9	400
42	Alsace	68	1	07	347	Vieux-Ferrette	621	12	633
42	Alsace	68	6	25	348	Vieux-Thann	2886	72	2958
42	Alsace	68	4	11	349	Village-Neuf	3706	67	3773
42	Alsace	68	2	26	350	Voegtlinshoffen	538	24	562
42	Alsace	68	2	19	351	Vogelgrun	635	9	644
42	Alsace	68	2	19	352	Volgelsheim	2401	30	2431
42	Alsace	68	4	13	353	Wahlbach	505	10	515
42	Alsace	68	2	26	354	Walbach	872	31	903
42	Alsace	68	1	10	355	Waldighofen	1493	16	1509
42	Alsace	68	1	01	356	Walheim	927	18	945
42	Alsace	68	4	13	357	Waltenheim	562	20	582
42	Alsace	68	2	18	358	Wasserbourg	462	13	475
42	Alsace	68	6	03	359	Wattwiller	1741	39	1780
42	Alsace	68	2	19	360	Weckolsheim	614	14	628
42	Alsace	68	6	15	361	Wegscheid	339	8	347
42	Alsace	68	4	11	362	Wentzwiller	721	9	730
42	Alsace	68	1	07	363	Werentzhouse	575	16	591
42	Alsace	68	3	21	364	Westhalten	957	15	972
42	Alsace	68	2	26	365	Wettolsheim	1684	61	1745
42	Alsace	68	2	02	366	Wickerschwihr	779	18	797
42	Alsace	68	2	02	367	Widensolen	1237	19	1256
42	Alsace	68	2	18	368	Wihr-au-Val	1264	37	1301
42	Alsace	68	6	22	370	Wildenstein	191	2	193
42	Alsace	68	1	01	371	Willer	338	4	342
42	Alsace	68	6	25	372	Willer-sur-Thur	1909	31	1940
42	Alsace	68	1	07	373	Winkel	346	7	353
42	Alsace	68	2	26	374	Wintzenheim	7592	424	8016
42	Alsace	68	6	03	375	Wittelsheim	10268	176	10444
42	Alsace	68	4	27	376	Wittenheim	14194	209	14403
42	Alsace	68	1	01	377	Wittersdorf	849	22	871
42	Alsace	68	1	05	378	Wolfersdorf	374	5	379
42	Alsace	68	2	19	379	Wolfgantzen	1031	15	1046
42	Alsace	68	1	07	380	Wolschwiller	476	15	491
42	Alsace	68	3	24	381	Wuenheim	798	18	816
42	Alsace	68	4	13	382	Zaessingue	320	5	325
42	Alsace	68	5	12	383	Zellenberg	369	15	384
42	Alsace	68	4	17	384	Zillisheim	2643	76	2719
42	Alsace	68	2	26	385	Zimmerbach	855	42	897
42	Alsace	68	4	09	386	Zimmersheim	1135	31	1166
82	Rhône-Alpes	69	2	29	001	Affoux	331	7	338
82	Rhône-Alpes	69	2	23	002	Aigueperse	241	4	245
82	Rhône-Alpes	69	1	25	003	Albigny-sur-Saône	2743	37	2780
82	Rhône-Alpes	69	2	02	004	Alix	692	8	700
82	Rhône-Alpes	69	2	02	005	Ambérieux	572	9	581
82	Rhône-Alpes	69	2	01	006	Amplepuis	5205	143	5348
82	Rhône-Alpes	69	1	07	007	Ampuis	2641	56	2697
82	Rhône-Alpes	69	2	29	008	Ancy	580	4	584
82	Rhône-Alpes	69	2	02	009	Anse	5927	150	6077
82	Rhône-Alpes	69	1	03	010	L; Arbresle	6036	186	6222
82	Rhône-Alpes	69	2	04	012	Les Ardillats	574	12	586
82	Rhône-Alpes	69	2	53	013	Arnas	3300	97	3397
82	Rhône-Alpes	69	1	28	014	Aveize	1110	27	1137
82	Rhône-Alpes	69	2	04	015	Avenas	131	7	138
82	Rhône-Alpes	69	2	23	016	Azolette	125	0	125
82	Rhône-Alpes	69	2	06	017	Bagnols	695	7	702
82	Rhône-Alpes	69	2	04	018	Beaujeu	2036	40	2076
82	Rhône-Alpes	69	2	05	019	Belleville	7916	178	8094
82	Rhône-Alpes	69	2	02	020	Belmont-d;Azergues	638	8	646
82	Rhône-Alpes	69	1	03	021	Bessenay	2251	73	2324
82	Rhône-Alpes	69	1	03	022	Bibost	496	11	507
82	Rhône-Alpes	69	2	53	023	Blacé	1405	45	1450
82	Rhône-Alpes	69	2	06	024	Le Bois-d;Oingt	2242	63	2305
82	Rhône-Alpes	69	2	30	025	Bourg-de-Thizy	2627	52	2679
82	Rhône-Alpes	69	2	06	026	Le Breuil	454	8	462
82	Rhône-Alpes	69	1	26	027	Brignais	11350	168	11518
82	Rhône-Alpes	69	1	31	028	Brindas	5519	158	5677
82	Rhône-Alpes	69	1	35	029	Bron	38717	521	39238
82	Rhône-Alpes	69	1	27	030	Brullioles	767	14	781
82	Rhône-Alpes	69	1	27	031	Brussieu	1175	61	1236
82	Rhône-Alpes	69	1	03	032	Bully	2069	50	2119
82	Rhône-Alpes	69	1	25	033	Cailloux-sur-Fontaines	2480	52	2532
82	Rhône-Alpes	69	1	43	034	Caluire-et-Cuire	41209	631	41840
82	Rhône-Alpes	69	2	23	035	Cenves	395	11	406
82	Rhône-Alpes	69	2	05	036	Cercié	1152	18	1170
82	Rhône-Alpes	69	2	09	037	Chambost-Allières	784	16	800
82	Rhône-Alpes	69	1	27	038	Chambost-Longessaigne	826	22	848
82	Rhône-Alpes	69	2	06	039	Chamelet	676	18	694
82	Rhône-Alpes	69	1	52	040	Champagne-au-Mont-d;Or	5076	110	5186
82	Rhône-Alpes	69	2	30	041	La Chapelle-de-Mardore	212	4	216
82	Rhône-Alpes	69	1	28	042	La Chapelle-sur-Coise	532	18	550
82	Rhône-Alpes	69	1	38	270	Chaponnay	3695	75	3770
82	Rhône-Alpes	69	1	26	043	Chaponost	7978	239	8217
82	Rhône-Alpes	69	1	31	044	Charbonnières-les-Bains	4698	142	4840
82	Rhône-Alpes	69	2	05	045	Charentay	1128	64	1192
82	Rhône-Alpes	69	1	48	046	Charly	4421	129	4550
82	Rhône-Alpes	69	2	02	047	Charnay	1076	37	1113
82	Rhône-Alpes	69	1	08	048	Chassagny	1245	29	1274
82	Rhône-Alpes	69	1	10	049	Chasselay	2672	43	2715
82	Rhône-Alpes	69	1	44	271	Chassieu	9675	138	9813
82	Rhône-Alpes	69	2	06	050	Châtillon	2190	59	2249
82	Rhône-Alpes	69	1	24	051	Chaussan	972	42	1014
82	Rhône-Alpes	69	2	02	052	Chazay-d;Azergues	3911	110	4021
82	Rhône-Alpes	69	2	04	053	Chénas	530	12	542
82	Rhône-Alpes	69	2	09	054	Chénelette	326	8	334
82	Rhône-Alpes	69	1	10	055	Les Chères	1376	23	1399
82	Rhône-Alpes	69	2	06	056	Chessy	1752	46	1798
82	Rhône-Alpes	69	1	03	057	Chevinay	543	21	564
82	Rhône-Alpes	69	2	04	058	Chiroubles	378	9	387
82	Rhône-Alpes	69	1	10	059	Civrieux-d;Azergues	1456	20	1476
82	Rhône-Alpes	69	2	09	060	Claveisolles	639	86	725
82	Rhône-Alpes	69	2	53	061	Cogny	1106	26	1132
82	Rhône-Alpes	69	1	28	062	Coise	741	24	765
82	Rhône-Alpes	69	1	10	063	Collonges-au-Mont-d;Or	3790	104	3894
82	Rhône-Alpes	69	1	37	299	Colombier-Saugnieu	2449	25	2474
82	Rhône-Alpes	69	1	38	272	Communay	4006	45	4051
82	Rhône-Alpes	69	1	07	064	Condrieu	3831	74	3905
82	Rhône-Alpes	69	1	49	273	Corbas	10210	117	10327
82	Rhône-Alpes	69	2	05	065	Corcelles-en-Beaujolais	796	9	805
82	Rhône-Alpes	69	2	30	066	Cours-la-Ville	3857	96	3953
82	Rhône-Alpes	69	1	31	067	Courzieu	1161	21	1182
82	Rhône-Alpes	69	1	25	068	Couzon-au-Mont-d;Or	2527	36	2563
82	Rhône-Alpes	69	1	31	069	Craponne	9558	186	9744
82	Rhône-Alpes	69	2	01	070	Cublize	1248	22	1270
82	Rhône-Alpes	69	1	25	071	Curis-au-Mont-d;Or	1088	35	1123
82	Rhône-Alpes	69	1	52	072	Dardilly	8454	563	9017
82	Rhône-Alpes	69	2	29	073	Dareizé	449	12	461
82	Rhône-Alpes	69	1	44	275	Décines-Charpieu	25562	426	25988
82	Rhône-Alpes	69	2	53	074	Denicé	1316	39	1355
82	Rhône-Alpes	69	2	29	075	Dième	187	3	190
82	Rhône-Alpes	69	1	03	076	Dommartin	2737	83	2820
82	Rhône-Alpes	69	2	05	077	Dracé	962	13	975
82	Rhône-Alpes	69	1	28	078	Duerne	770	24	794
82	Rhône-Alpes	69	1	08	080	Échalas	1539	22	1561
82	Rhône-Alpes	69	1	52	081	Écully	17998	415	18413
82	Rhône-Alpes	69	2	04	082	Émeringes	218	7	225
82	Rhône-Alpes	69	1	03	083	Éveux	1107	12	1119
82	Rhône-Alpes	69	1	49	276	Feyzin	9237	70	9307
82	Rhône-Alpes	69	2	04	084	Fleurie	1244	32	1276
82	Rhône-Alpes	69	1	25	085	Fleurieu-sur-Saône	1344	39	1383
82	Rhône-Alpes	69	1	03	086	Fleurieux-sur-l;Arbresle	2222	40	2262
82	Rhône-Alpes	69	1	25	087	Fontaines-Saint-Martin	2929	90	3019
82	Rhône-Alpes	69	1	25	088	Fontaines-sur-Saône	6306	105	6411
82	Rhône-Alpes	69	1	51	089	Francheville	12929	230	13159
82	Rhône-Alpes	69	2	06	090	Frontenas	803	30	833
82	Rhône-Alpes	69	1	44	277	Genas	12126	214	12340
82	Rhône-Alpes	69	1	25	278	Genay	5014	100	5114
82	Rhône-Alpes	69	1	08	091	Givors	19118	140	19258
82	Rhône-Alpes	69	2	53	092	Gleizé	7639	282	7921
82	Rhône-Alpes	69	2	09	093	Grandris	1215	22	1237
82	Rhône-Alpes	69	1	31	094	Grézieu-la-Varenne	5018	112	5130
82	Rhône-Alpes	69	1	28	095	Grézieu-le-Marché	753	27	780
82	Rhône-Alpes	69	1	08	096	Grigny	8943	109	9052
82	Rhône-Alpes	69	1	07	097	Les Haies	751	11	762
82	Rhône-Alpes	69	1	27	098	Les Halles	462	3	465
82	Rhône-Alpes	69	1	27	099	Haute-Rivoire	1359	27	1386
82	Rhône-Alpes	69	1	48	100	Irigny	8320	184	8504
82	Rhône-Alpes	69	2	06	101	Jarnioux	591	19	610
82	Rhône-Alpes	69	1	37	279	Jonage	5768	68	5836
82	Rhône-Alpes	69	1	37	280	Jons	1298	21	1319
82	Rhône-Alpes	69	2	29	102	Joux	662	8	670
82	Rhône-Alpes	69	2	04	103	Juliénas	838	38	876
82	Rhône-Alpes	69	2	04	104	Jullié	415	13	428
82	Rhône-Alpes	69	2	53	105	Lacenas	896	34	930
82	Rhône-Alpes	69	2	02	106	Lachassagne	903	21	924
82	Rhône-Alpes	69	2	09	107	Lamure-sur-Azergues	1048	104	1152
82	Rhône-Alpes	69	2	05	108	Lancié	801	17	818
82	Rhône-Alpes	69	2	04	109	Lantignié	811	20	831
82	Rhône-Alpes	69	1	28	110	Larajasse	1780	43	1823
82	Rhône-Alpes	69	2	06	111	Légny	597	14	611
82	Rhône-Alpes	69	1	03	112	Lentilly	5355	101	5456
82	Rhône-Alpes	69	2	06	113	Létra	945	27	972
82	Rhône-Alpes	69	2	02	114	Liergues	1869	45	1914
82	Rhône-Alpes	69	2	53	115	Limas	4435	105	4540
82	Rhône-Alpes	69	1	10	116	Limonest	3215	160	3375
82	Rhône-Alpes	69	1	10	117	Lissieu	3065	45	3110
82	Rhône-Alpes	69	1	07	118	Loire-sur-Rhône	2412	28	2440
82	Rhône-Alpes	69	1	07	119	Longes	869	12	881
82	Rhône-Alpes	69	1	27	120	Longessaigne	598	19	617
82	Rhône-Alpes	69	2	02	121	Lozanne	2427	34	2461
82	Rhône-Alpes	69	2	02	122	Lucenay	1752	25	1777
82	Rhône-Alpes	69	1	13	381	Lyon 1er Arrondissement	28755	898	29653
82	Rhône-Alpes	69	1	11	382	Lyon 2e  Arrondissement	30103	562	30665
82	Rhône-Alpes	69	1	99	383	Lyon 3e  Arrondissement	96162	1243	97405
82	Rhône-Alpes	69	1	14	384	Lyon 4e  Arrondissement	34988	585	35573
82	Rhône-Alpes	69	1	16	385	Lyon 5e  Arrondissement	46738	1332	48070
82	Rhône-Alpes	69	1	99	386	Lyon 6e  Arrondissement	49088	961	50049
82	Rhône-Alpes	69	1	99	387	Lyon 7e  Arrondissement	71171	776	71947
82	Rhône-Alpes	69	1	99	388	Lyon 8e  Arrondissement	78793	1102	79895
82	Rhône-Alpes	69	1	15	389	Lyon 9e  Arrondissement	48546	775	49321
82	Rhône-Alpes	69	2	04	124	Marchampt	448	14	462
82	Rhône-Alpes	69	1	10	125	Marcilly-d;Azergues	887	38	925
82	Rhône-Alpes	69	2	02	126	Marcy	634	18	652
82	Rhône-Alpes	69	1	31	127	Marcy-l;Étoile	3506	78	3584
82	Rhône-Alpes	69	2	30	128	Mardore	518	17	535
82	Rhône-Alpes	69	1	38	281	Marennes	1603	19	1622
82	Rhône-Alpes	69	2	30	129	Marnand	617	12	629
82	Rhône-Alpes	69	2	01	130	Meaux-la-Montagne	230	0	230
82	Rhône-Alpes	69	1	31	131	Messimy	3321	50	3371
82	Rhône-Alpes	69	1	28	132	Meys	717	23	740
82	Rhône-Alpes	69	1	37	282	Meyzieu	30272	400	30672
82	Rhône-Alpes	69	1	08	133	Millery	3549	81	3630
82	Rhône-Alpes	69	1	38	283	Mions	11793	138	11931
82	Rhône-Alpes	69	2	06	134	Moiré	204	9	213
82	Rhône-Alpes	69	2	23	135	Monsols	959	18	977
82	Rhône-Alpes	69	1	08	136	Montagny	2539	44	2583
82	Rhône-Alpes	69	1	25	284	Montanay	2781	93	2874
82	Rhône-Alpes	69	2	53	137	Montmelas-Saint-Sorlin	385	12	397
82	Rhône-Alpes	69	1	27	138	Montromant	426	8	434
82	Rhône-Alpes	69	1	27	139	Montrottier	1347	68	1415
82	Rhône-Alpes	69	2	02	140	Morancé	2075	53	2128
82	Rhône-Alpes	69	1	24	141	Mornant	5514	184	5698
82	Rhône-Alpes	69	1	50	142	La Mulatière	6480	92	6572
82	Rhône-Alpes	69	1	25	143	Neuville-sur-Saône	7275	147	7422
82	Rhône-Alpes	69	1	03	144	Nuelles	647	13	660
82	Rhône-Alpes	69	2	05	145	Odenas	825	27	852
82	Rhône-Alpes	69	2	06	146	Oingt	618	18	636
82	Rhône-Alpes	69	2	29	147	Les Olmes	786	31	817
82	Rhône-Alpes	69	1	24	148	Orliénas	2250	53	2303
82	Rhône-Alpes	69	1	40	149	Oullins	25152	261	25413
82	Rhône-Alpes	69	2	23	150	Ouroux	339	34	373
82	Rhône-Alpes	69	2	53	151	Le Perréon	1395	33	1428
82	Rhône-Alpes	69	1	48	152	Pierre-Bénite	9982	79	10061
82	Rhône-Alpes	69	1	25	153	Poleymieux-au-Mont-d;Or	1263	35	1298
82	Rhône-Alpes	69	1	31	154	Pollionnay	2042	48	2090
82	Rhône-Alpes	69	1	28	155	Pomeys	1023	37	1060
82	Rhône-Alpes	69	2	02	156	Pommiers	2254	86	2340
82	Rhône-Alpes	69	2	30	158	Pont-Trambouze	515	8	523
82	Rhône-Alpes	69	2	29	157	Pontcharra-sur-Turdine	2483	50	2533
82	Rhône-Alpes	69	2	02	159	Pouilly-le-Monial	910	30	940
82	Rhône-Alpes	69	2	09	160	Poule-les-Écharmeaux	1081	20	1101
82	Rhône-Alpes	69	2	23	161	Propières	470	66	536
82	Rhône-Alpes	69	1	37	285	Pusignan	3565	70	3635
82	Rhône-Alpes	69	2	04	162	Quincié-en-Beaujolais	1199	29	1228
82	Rhône-Alpes	69	1	25	163	Quincieux	3002	56	3058
82	Rhône-Alpes	69	2	09	164	Ranchal	320	10	330
82	Rhône-Alpes	69	2	04	165	Régnié-Durette	1044	31	1075
82	Rhône-Alpes	69	1	39	286	Rillieux-la-Pape	29952	423	30375
82	Rhône-Alpes	69	1	24	166	Riverie	284	4	288
82	Rhône-Alpes	69	2	53	167	Rivolet	558	20	578
82	Rhône-Alpes	69	1	25	168	Rochetaillée-sur-Saône	1525	21	1546
82	Rhône-Alpes	69	2	01	169	Ronno	598	23	621
82	Rhône-Alpes	69	1	24	170	Rontalon	1148	24	1172
82	Rhône-Alpes	69	1	03	171	Sain-Bel	2242	37	2279
82	Rhône-Alpes	69	1	08	179	Saint-Andéol-le-Château	1564	21	1585
82	Rhône-Alpes	69	1	24	180	Saint-André-la-Côte	282	12	294
82	Rhône-Alpes	69	2	29	181	Saint-Appolinaire	164	3	167
82	Rhône-Alpes	69	1	37	287	Saint-Bonnet-de-Mure	6466	95	6561
82	Rhône-Alpes	69	2	23	182	Saint-Bonnet-des-Bruyères	374	5	379
82	Rhône-Alpes	69	2	09	183	Saint-Bonnet-le-Troncy	312	6	318
82	Rhône-Alpes	69	2	23	185	Saint-Christophe	236	6	242
82	Rhône-Alpes	69	2	23	186	Saint-Clément-de-Vers	225	12	237
82	Rhône-Alpes	69	1	27	187	Saint-Clément-les-Places	655	11	666
82	Rhône-Alpes	69	2	29	188	Saint-Clément-sur-Valsonne	746	19	765
82	Rhône-Alpes	69	1	10	191	Saint-Cyr-au-Mont-d;Or	5587	184	5771
82	Rhône-Alpes	69	2	53	192	Saint-Cyr-le-Chatoux	123	3	126
82	Rhône-Alpes	69	1	07	193	Saint-Cyr-sur-le-Rhône	1224	47	1271
82	Rhône-Alpes	69	1	10	194	Saint-Didier-au-Mont-d;Or	6419	187	6606
82	Rhône-Alpes	69	1	24	195	Saint-Didier-sous-Riverie	1178	30	1208
82	Rhône-Alpes	69	2	04	196	Saint-Didier-sur-Beaujeu	646	5	651
82	Rhône-Alpes	69	2	05	197	Saint-Étienne-des-Oullières	1864	31	1895
82	Rhône-Alpes	69	2	05	198	Saint-Étienne-la-Varenne	693	16	709
82	Rhône-Alpes	69	1	49	199	Saint-Fons	16666	121	16787
82	Rhône-Alpes	69	2	29	200	Saint-Forgeux	1422	28	1450
82	Rhône-Alpes	69	1	27	203	Saint-Genis-l;Argentière	1045	30	1075
82	Rhône-Alpes	69	1	26	204	Saint-Genis-Laval	20357	625	20982
82	Rhône-Alpes	69	1	31	205	Saint-Genis-les-Ollières	4640	115	4755
82	Rhône-Alpes	69	2	05	206	Saint-Georges-de-Reneins	4227	76	4303
82	Rhône-Alpes	69	1	25	207	Saint-Germain-au-Mont-d;Or	2766	49	2815
82	Rhône-Alpes	69	1	03	208	Saint-Germain-sur-l;Arbresle	1352	35	1387
82	Rhône-Alpes	69	2	23	209	Saint-Igny-de-Vers	597	9	606
82	Rhône-Alpes	69	2	23	210	Saint-Jacques-des-Arrêts	110	4	114
82	Rhône-Alpes	69	2	05	211	Saint-Jean-d;Ardières	3347	92	3439
82	Rhône-Alpes	69	1	08	213	Saint-Jean-de-Touslas	831	18	849
82	Rhône-Alpes	69	2	02	212	Saint-Jean-des-Vignes	388	9	397
82	Rhône-Alpes	69	2	30	214	Saint-Jean-la-Bussière	1102	40	1142
82	Rhône-Alpes	69	2	53	215	Saint-Julien	816	19	835
82	Rhône-Alpes	69	1	03	216	Saint-Julien-sur-Bibost	535	16	551
82	Rhône-Alpes	69	2	01	217	Saint-Just-d;Avray	759	57	816
82	Rhône-Alpes	69	2	05	218	Saint-Lager	930	17	947
82	Rhône-Alpes	69	1	24	219	Saint-Laurent-d;Agny	2111	61	2172
82	Rhône-Alpes	69	2	06	222	Saint-Laurent-d;Oingt	811	33	844
82	Rhône-Alpes	69	1	27	220	Saint-Laurent-de-Chamousset	1868	99	1967
82	Rhône-Alpes	69	1	37	288	Saint-Laurent-de-Mure	5100	65	5165
82	Rhône-Alpes	69	1	31	221	Saint-Laurent-de-Vaux	256	5	261
82	Rhône-Alpes	69	2	29	223	Saint-Loup	979	28	1007
82	Rhône-Alpes	69	2	23	224	Saint-Mamert	61	3	64
82	Rhône-Alpes	69	2	29	225	Saint-Marcel-l;Éclairé	533	11	544
82	Rhône-Alpes	69	1	28	227	Saint-Martin-en-Haut	3849	159	4008
82	Rhône-Alpes	69	1	24	228	Saint-Maurice-sur-Dargoire	2160	57	2217
82	Rhône-Alpes	69	2	09	229	Saint-Nizier-d;Azergues	698	17	715
82	Rhône-Alpes	69	1	38	289	Saint-Pierre-de-Chandieu	4547	74	4621
82	Rhône-Alpes	69	1	03	231	Saint-Pierre-la-Palud	2474	66	2540
82	Rhône-Alpes	69	1	45	290	Saint-Priest	41964	464	42428
82	Rhône-Alpes	69	1	25	233	Saint-Romain-au-Mont-d;Or	1024	68	1092
82	Rhône-Alpes	69	2	29	234	Saint-Romain-de-Popey	1431	85	1516
82	Rhône-Alpes	69	1	07	235	Saint-Romain-en-Gal	1687	91	1778
82	Rhône-Alpes	69	1	08	236	Saint-Romain-en-Gier	501	3	504
82	Rhône-Alpes	69	1	24	237	Saint-Sorlin	671	31	702
82	Rhône-Alpes	69	1	38	291	Saint-Symphorien-d;Ozon	5308	57	5365
82	Rhône-Alpes	69	1	28	238	Saint-Symphorien-sur-Coise	3465	77	3542
82	Rhône-Alpes	69	2	06	239	Saint-Vérand	1094	20	1114
82	Rhône-Alpes	69	2	01	240	Saint-Vincent-de-Reins	673	15	688
82	Rhône-Alpes	69	1	24	184	Sainte-Catherine	904	26	930
82	Rhône-Alpes	69	1	07	189	Sainte-Colombe	1897	39	1936
82	Rhône-Alpes	69	1	31	190	Sainte-Consorce	1872	64	1936
82	Rhône-Alpes	69	1	27	201	Sainte-Foy-l;Argentière	1246	31	1277
82	Rhône-Alpes	69	1	50	202	Sainte-Foy-lès-Lyon	21742	487	22229
82	Rhône-Alpes	69	2	06	230	Sainte-Paule	308	11	319
82	Rhône-Alpes	69	2	53	172	Salles-Arbuissonnas-en-Beaujolais	803	24	827
82	Rhône-Alpes	69	1	03	173	Sarcey	891	27	918
82	Rhône-Alpes	69	1	39	292	Sathonay-Camp	4236	62	4298
82	Rhône-Alpes	69	1	39	293	Sathonay-Village	2148	44	2192
82	Rhône-Alpes	69	2	29	174	Les Sauvages	631	12	643
82	Rhône-Alpes	69	1	03	175	Savigny	1938	54	1992
82	Rhône-Alpes	69	1	38	294	Sérézin-du-Rhône	2488	63	2551
82	Rhône-Alpes	69	1	38	295	Simandres	1635	13	1648
82	Rhône-Alpes	69	1	49	296	Solaize	2777	32	2809
82	Rhône-Alpes	69	1	24	176	Soucieu-en-Jarrest	3769	74	3843
82	Rhône-Alpes	69	1	03	177	Sourcieux-les-Mines	1908	57	1965
82	Rhône-Alpes	69	1	27	178	Souzy	707	12	719
82	Rhône-Alpes	69	1	24	241	Taluyers	2006	34	2040
82	Rhône-Alpes	69	2	05	242	Taponas	902	17	919
82	Rhône-Alpes	69	2	29	243	Tarare	10333	190	10523
82	Rhône-Alpes	69	1	51	244	Tassin-la-Demi-Lune	19511	427	19938
82	Rhône-Alpes	69	2	06	245	Ternand	724	14	738
82	Rhône-Alpes	69	1	38	297	Ternay	5335	69	5404
82	Rhône-Alpes	69	2	06	246	Theizé	1069	52	1121
82	Rhône-Alpes	69	2	09	247	Thel	310	4	314
82	Rhône-Alpes	69	2	30	248	Thizy	2393	79	2472
82	Rhône-Alpes	69	1	31	249	Thurins	2917	49	2966
82	Rhône-Alpes	69	1	03	250	La Tour-de-Salvagny	3709	89	3798
82	Rhône-Alpes	69	1	38	298	Toussieu	2389	41	2430
82	Rhône-Alpes	69	2	23	251	Trades	117	2	119
82	Rhône-Alpes	69	1	07	252	Trèves	695	11	706
82	Rhône-Alpes	69	1	07	253	Tupin-et-Semons	616	12	628
82	Rhône-Alpes	69	2	29	254	Valsonne	851	20	871
82	Rhône-Alpes	69	1	31	255	Vaugneray	4897	110	5007
82	Rhône-Alpes	69	1	46	256	Vaulx-en-Velin	41421	549	41970
82	Rhône-Alpes	69	2	53	257	Vaux-en-Beaujolais	1043	25	1068
82	Rhône-Alpes	69	2	04	258	Vauxrenard	321	8	329
82	Rhône-Alpes	69	1	97	259	Vénissieux	59855	593	60448
82	Rhône-Alpes	69	1	48	260	Vernaison	4473	46	4519
82	Rhône-Alpes	69	2	04	261	Vernay	111	1	112
82	Rhône-Alpes	69	2	06	265	Ville-sur-Jarnioux	784	24	808
82	Rhône-Alpes	69	1	27	263	Villechenève	830	10	840
82	Rhône-Alpes	69	2	32	264	Villefranche-sur-Saône	35326	574	35900
82	Rhône-Alpes	69	1	98	266	Villeurbanne	145150	1579	146729
82	Rhône-Alpes	69	2	04	267	Villié-Morgon	1926	87	2013
82	Rhône-Alpes	69	1	26	268	Vourles	3101	85	3186
82	Rhône-Alpes	69	1	31	269	Yzeron	1036	27	1063
43	Franche-Comté	70	1	23	001	Abelcourt	340	13	353
43	Franche-Comté	70	2	05	002	Aboncourt-Gesincourt	232	12	244
43	Franche-Comté	70	2	06	003	Achey	71	2	73
43	Franche-Comté	70	1	93	004	Adelans-et-le-Val-de-Bithaine	309	11	320
43	Franche-Comté	70	1	27	005	Aillevans	142	2	144
43	Franche-Comté	70	1	22	006	Aillevillers-et-Lyaumont	1677	73	1750
43	Franche-Comté	70	1	32	007	Ailloncourt	307	5	312
43	Franche-Comté	70	1	22	008	Ainvelle	161	5	166
43	Franche-Comté	70	2	12	009	Aisey-et-Richecourt	107	3	110
43	Franche-Comté	70	1	25	010	Alaincourt	96	1	97
43	Franche-Comté	70	1	07	011	Amage	332	10	342
43	Franche-Comté	70	2	01	012	Amance	699	20	719
43	Franche-Comté	70	1	25	013	Ambiévillers	81	4	85
43	Franche-Comté	70	1	31	014	Amblans-et-Velotte	389	2	391
43	Franche-Comté	70	2	20	015	Amoncourt	337	10	347
43	Franche-Comté	70	1	07	016	Amont-et-Effreney	175	1	176
43	Franche-Comté	70	2	01	017	Anchenoncourt-et-Chazel	239	3	242
43	Franche-Comté	70	2	09	018	Ancier	475	17	492
43	Franche-Comté	70	2	29	019	Andelarre	119	3	122
43	Franche-Comté	70	2	29	020	Andelarrot	242	9	251
43	Franche-Comté	70	1	13	021	Andornay	205	5	210
43	Franche-Comté	70	2	09	022	Angirey	132	5	137
43	Franche-Comté	70	1	25	023	Anjeux	164	9	173
43	Franche-Comté	70	2	09	024	Apremont	433	9	442
43	Franche-Comté	70	2	05	025	Arbecey	240	8	248
43	Franche-Comté	70	2	09	026	Arc-lès-Gray	2598	71	2669
43	Franche-Comté	70	2	04	027	Argillières	73	1	74
43	Franche-Comté	70	2	24	028	Aroz	154	3	157
43	Franche-Comté	70	1	13	029	Arpenans	240	4	244
43	Franche-Comté	70	2	19	030	Arsans	42	1	43
43	Franche-Comté	70	1	27	031	Athesans-Étroitefontaine	662	6	668
43	Franche-Comté	70	2	02	032	Attricourt	36	1	37
43	Franche-Comté	70	2	05	035	Augicourt	168	5	173
43	Franche-Comté	70	2	21	036	Aulx-lès-Cromary	143	1	144
43	Franche-Comté	70	2	06	037	Autet	313	29	342
43	Franche-Comté	70	2	17	038	Authoison	288	6	294
43	Franche-Comté	70	2	10	039	Autoreille	297	3	300
43	Franche-Comté	70	1	27	042	Autrey-le-Vay	71	1	72
43	Franche-Comté	70	2	18	040	Autrey-lès-Cerre	226	1	227
43	Franche-Comté	70	2	02	041	Autrey-lès-Gray	441	5	446
43	Franche-Comté	70	2	02	043	Auvet-et-la-Chapelotte	246	4	250
43	Franche-Comté	70	2	20	044	Auxon	432	16	448
43	Franche-Comté	70	2	15	045	Avrigney-Virey	392	9	401
43	Franche-Comté	70	1	13	046	Les Aynans	328	11	339
43	Franche-Comté	70	2	24	047	Baignes	86	2	88
43	Franche-Comté	70	2	19	048	Bard-lès-Pesmes	128	6	134
43	Franche-Comté	70	2	12	049	Barges	103	2	105
43	Franche-Comté	70	2	17	050	La Barre	106	1	107
43	Franche-Comté	70	2	12	051	La Basse-Vaivre	44	2	46
43	Franche-Comté	70	1	25	052	Bassigney	125	0	125
43	Franche-Comté	70	2	08	053	Les Bâties	79	1	80
43	Franche-Comté	70	2	09	054	Battrans	228	5	233
43	Franche-Comté	70	1	32	055	Baudoncourt	546	10	556
43	Franche-Comté	70	2	01	056	Baulay	329	3	332
43	Franche-Comté	70	2	15	057	Bay	122	0	122
43	Franche-Comté	70	2	08	058	Beaujeu-Saint-Vallier-Pierrejux-et-Quitteur	1009	14	1023
43	Franche-Comté	70	2	17	059	Beaumotte-Aubertans	495	11	506
43	Franche-Comté	70	2	15	060	Beaumotte-lès-Pin	278	1	279
43	Franche-Comté	70	1	16	061	Belfahy	80	0	80
43	Franche-Comté	70	1	16	062	Belmont	113	4	117
43	Franche-Comté	70	1	16	063	Belonchamp	234	3	237
43	Franche-Comté	70	1	11	064	Belverne	131	0	131
43	Franche-Comté	70	2	17	065	Besnans	81	0	81
43	Franche-Comté	70	2	12	066	Betaucourt	159	1	160
43	Franche-Comté	70	1	23	067	Betoncourt-lès-Brotte	99	2	101
43	Franche-Comté	70	1	25	069	Betoncourt-Saint-Pancras	51	0	51
43	Franche-Comté	70	2	28	070	Betoncourt-sur-Mance	42	2	44
43	Franche-Comté	70	1	07	071	Beulotte-Saint-Laurent	71	1	72
43	Franche-Comté	70	1	27	072	Beveuge	86	0	86
43	Franche-Comté	70	2	12	074	Blondefontaine	248	7	255
43	Franche-Comté	70	2	15	075	Bonboillon	182	2	184
43	Franche-Comté	70	2	10	076	Bonnevent-Velloreille	345	5	350
43	Franche-Comté	70	2	18	077	Borey	233	3	236
43	Franche-Comté	70	2	05	078	Bougey	83	0	83
43	Franche-Comté	70	2	20	079	Bougnon	504	24	528
43	Franche-Comté	70	2	02	080	Bouhans-et-Feurg	281	6	287
43	Franche-Comté	70	1	31	081	Bouhans-lès-Lure	310	6	316
43	Franche-Comté	70	2	17	082	Bouhans-lès-Montbozon	115	2	117
43	Franche-Comté	70	1	25	083	Bouligney	432	9	441
43	Franche-Comté	70	2	21	084	Boulot	629	5	634
43	Franche-Comté	70	2	21	085	Boult	543	8	551
43	Franche-Comté	70	2	12	086	Bourbévelle	79	1	80
43	Franche-Comté	70	1	25	087	Bourguignon-lès-Conflans	131	3	134
43	Franche-Comté	70	2	24	088	Bourguignon-lès-la-Charité	142	1	143
43	Franche-Comté	70	2	28	089	Bourguignon-lès-Morey	54	4	58
43	Franche-Comté	70	2	24	090	Boursières	72	1	73
43	Franche-Comté	70	2	12	091	Bousseraucourt	57	2	59
43	Franche-Comté	70	2	19	092	Bresilley	175	1	176
43	Franche-Comté	70	1	32	093	Breuches	735	56	791
43	Franche-Comté	70	1	32	094	Breuchotte	313	4	317
43	Franche-Comté	70	2	20	095	Breurey-lès-Faverney	571	16	587
43	Franche-Comté	70	1	30	096	Brevilliers	641	11	652
43	Franche-Comté	70	1	22	097	Briaucourt	241	7	248
43	Franche-Comté	70	1	32	098	Brotte-lès-Luxeuil	217	11	228
43	Franche-Comté	70	2	06	099	Brotte-lès-Ray	64	1	65
43	Franche-Comté	70	2	19	101	Broye-Aubigney-Montseugny	457	16	473
43	Franche-Comté	70	2	02	100	Broye-les-Loups-et-Verfontaine	104	1	105
43	Franche-Comté	70	2	15	102	Brussey	275	3	278
43	Franche-Comté	70	1	07	103	La Bruyère	205	3	208
43	Franche-Comté	70	2	10	104	Bucey-lès-Gy	649	15	664
43	Franche-Comté	70	2	24	105	Bucey-lès-Traves	103	4	107
43	Franche-Comté	70	2	01	106	Buffignécourt	115	1	116
43	Franche-Comté	70	2	21	107	Bussières	300	7	307
43	Franche-Comté	70	2	21	109	Buthiers	309	4	313
43	Franche-Comté	70	2	18	111	Calmoutier	236	6	242
43	Franche-Comté	70	2	12	112	Cemboing	209	6	215
43	Franche-Comté	70	2	17	113	Cenans	131	1	132
43	Franche-Comté	70	2	12	114	Cendrecourt	243	8	251
43	Franche-Comté	70	2	18	115	Cerre-lès-Noroy	213	7	220
43	Franche-Comté	70	1	30	116	Chagey	675	6	681
43	Franche-Comté	70	1	30	117	Châlonvillars	1244	51	1295
43	Franche-Comté	70	2	21	118	Chambornay-lès-Bellevaux	162	3	165
43	Franche-Comté	70	2	15	119	Chambornay-lès-Pin	352	8	360
43	Franche-Comté	70	1	03	120	Champagney	3770	56	3826
43	Franche-Comté	70	1	11	121	Champey	857	13	870
43	Franche-Comté	70	2	04	122	Champlitte	1822	43	1865
43	Franche-Comté	70	2	09	124	Champtonnay	85	0	85
43	Franche-Comté	70	2	09	125	Champvans	213	2	215
43	Franche-Comté	70	2	19	126	Chancey	161	5	166
43	Franche-Comté	70	2	24	127	Chantes	129	3	132
43	Franche-Comté	70	1	32	128	La Chapelle-lès-Luxeuil	438	12	450
43	Franche-Comté	70	2	10	129	La Chapelle-Saint-Quillain	136	1	137
43	Franche-Comté	70	2	15	130	Charcenne	340	11	351
43	Franche-Comté	70	2	02	132	Chargey-lès-Gray	714	88	802
43	Franche-Comté	70	2	05	133	Chargey-lès-Port	240	4	244
43	Franche-Comté	70	2	29	134	Chariez	220	7	227
43	Franche-Comté	70	2	28	135	Charmes-Saint-Valbert	48	0	48
43	Franche-Comté	70	2	29	136	Charmoille	442	17	459
43	Franche-Comté	70	2	17	137	Chassey-lès-Montbozon	221	5	226
43	Franche-Comté	70	2	24	138	Chassey-lès-Scey	106	0	106
43	Franche-Comté	70	1	23	140	Châteney	51	2	53
43	Franche-Comté	70	1	23	141	Châtenois	124	4	128
43	Franche-Comté	70	2	19	142	Chaumercenne	152	2	154
43	Franche-Comté	70	2	28	143	Chauvirey-le-Châtel	115	3	118
43	Franche-Comté	70	2	28	144	Chauvirey-le-Vieil	32	0	32
43	Franche-Comté	70	2	21	145	Chaux-la-Lotière	369	7	376
43	Franche-Comté	70	2	20	146	Chaux-lès-Port	140	1	141
43	Franche-Comté	70	1	11	147	Chavanne	243	2	245
43	Franche-Comté	70	2	24	148	Chemilly	85	0	85
43	Franche-Comté	70	1	11	149	Chenebier	712	27	739
43	Franche-Comté	70	2	15	150	Chenevrey-et-Morogne	264	7	271
43	Franche-Comté	70	2	19	151	Chevigney	31	2	33
43	Franche-Comté	70	2	10	152	Choye	390	55	445
43	Franche-Comté	70	2	28	153	Cintrey	113	1	114
43	Franche-Comté	70	2	21	154	Cirey	347	5	352
43	Franche-Comté	70	1	32	155	Citers	839	20	859
43	Franche-Comté	70	2	10	156	Citey	98	0	98
43	Franche-Comté	70	1	03	157	Clairegoutte	408	17	425
43	Franche-Comté	70	2	24	158	Clans	120	3	123
43	Franche-Comté	70	2	17	159	Cognières	97	2	99
43	Franche-Comté	70	1	11	160	Coisevaux	343	7	350
43	Franche-Comté	70	2	18	162	Colombe-lès-Vesoul	500	18	518
43	Franche-Comté	70	2	26	163	Colombier	419	15	434
43	Franche-Comté	70	2	18	164	Colombotte	59	1	60
43	Franche-Comté	70	2	05	165	Combeaufontaine	556	44	600
43	Franche-Comté	70	2	26	166	Comberjon	173	9	182
43	Franche-Comté	70	2	20	167	Conflandey	399	11	410
43	Franche-Comté	70	1	22	168	Conflans-sur-Lanterne	650	24	674
43	Franche-Comté	70	2	06	169	Confracourt	222	3	225
43	Franche-Comté	70	2	01	170	Contréglise	113	2	115
43	Franche-Comté	70	1	22	171	Corbenay	1344	30	1374
43	Franche-Comté	70	1	32	172	La Corbière	100	1	101
43	Franche-Comté	70	2	21	174	Cordonnet	122	1	123
43	Franche-Comté	70	2	05	175	Cornot	148	6	154
43	Franche-Comté	70	1	07	176	Corravillers	201	4	205
43	Franche-Comté	70	2	12	177	Corre	588	14	602
43	Franche-Comté	70	1	31	178	La Côte	523	22	545
43	Franche-Comté	70	2	26	179	Coulevon	193	4	197
43	Franche-Comté	70	1	27	180	Courchaton	455	6	461
43	Franche-Comté	70	2	15	181	Courcuire	132	0	132
43	Franche-Comté	70	1	11	182	Courmont	101	1	102
43	Franche-Comté	70	2	04	183	Courtesoult-et-Gatey	62	1	63
43	Franche-Comté	70	1	11	184	Couthenans	777	32	809
43	Franche-Comté	70	2	09	185	Cresancey	189	4	193
43	Franche-Comté	70	1	23	186	La Creuse	74	3	77
43	Franche-Comté	70	1	27	187	Crevans-et-la-Chapelle-lès-Granges	260	4	264
43	Franche-Comté	70	1	23	188	Creveney	52	4	56
43	Franche-Comté	70	2	21	189	Cromary	239	4	243
43	Franche-Comté	70	1	25	190	Cubry-lès-Faverney	128	5	133
43	Franche-Comté	70	2	15	192	Cugney	183	6	189
43	Franche-Comté	70	2	15	193	Cult	228	5	233
43	Franche-Comté	70	1	25	194	Cuve	163	6	169
43	Franche-Comté	70	1	32	195	Dambenoît-lès-Colombe	276	4	280
43	Franche-Comté	70	1	25	196	Dampierre-lès-Conflans	260	7	267
43	Franche-Comté	70	2	17	197	Dampierre-sur-Linotte	750	14	764
43	Franche-Comté	70	2	06	198	Dampierre-sur-Salon	1303	22	1325
43	Franche-Comté	70	2	18	199	Dampvalley-lès-Colombe	112	4	116
43	Franche-Comté	70	1	25	200	Dampvalley-Saint-Pancras	49	0	49
43	Franche-Comté	70	2	06	201	Delain	221	3	224
43	Franche-Comté	70	2	12	202	Demangevelle	335	13	348
43	Franche-Comté	70	2	18	203	La Demie	138	0	138
43	Franche-Comté	70	2	06	204	Denèvre	182	6	188
43	Franche-Comté	70	1	03	205	Échavanne	198	5	203
43	Franche-Comté	70	1	30	206	Échenans-sous-Mont-Vaudois	505	11	516
43	Franche-Comté	70	2	29	207	Échenoz-la-Méline	3065	87	3152
43	Franche-Comté	70	2	17	208	Échenoz-le-Sec	309	10	319
43	Franche-Comté	70	1	16	210	Écromagny	166	8	174
43	Franche-Comté	70	2	02	211	Écuelle	86	4	90
43	Franche-Comté	70	1	32	213	Éhuns	260	8	268
43	Franche-Comté	70	2	20	214	Équevilley	129	10	139
43	Franche-Comté	70	1	03	215	Errevet	231	11	242
43	Franche-Comté	70	1	32	216	Esboz-Brest	502	19	521
43	Franche-Comté	70	1	07	217	Esmoulières	95	0	95
43	Franche-Comté	70	2	09	218	Esmoulins	157	1	158
43	Franche-Comté	70	2	18	219	Esprels	699	19	718
43	Franche-Comté	70	2	02	220	Essertenne-et-Cecey	404	8	412
43	Franche-Comté	70	1	11	221	Étobon	307	4	311
43	Franche-Comté	70	2	10	222	Étrelles-et-la-Montbleuse	85	1	86
43	Franche-Comté	70	2	15	224	Étuz	670	14	684
43	Franche-Comté	70	2	02	225	Fahy-lès-Autrey	109	8	117
43	Franche-Comté	70	1	27	226	Fallon	314	10	324
43	Franche-Comté	70	1	07	227	Faucogney-et-la-Mer	589	18	607
43	Franche-Comté	70	2	01	228	Faverney	981	39	1020
43	Franche-Comté	70	1	27	229	Faymont	255	11	266
43	Franche-Comté	70	2	06	230	Fédry	107	3	110
43	Franche-Comté	70	2	06	231	Ferrières-lès-Ray	40	2	42
43	Franche-Comté	70	2	24	232	Ferrières-lès-Scey	149	11	160
43	Franche-Comté	70	1	07	233	Les Fessey	136	3	139
43	Franche-Comté	70	2	17	234	Filain	221	10	231
43	Franche-Comté	70	2	20	235	Flagy	156	3	159
43	Franche-Comté	70	2	20	236	Fleurey-lès-Faverney	407	10	417
43	Franche-Comté	70	2	06	237	Fleurey-lès-Lavoncourt	107	4	111
43	Franche-Comté	70	1	22	238	Fleurey-lès-Saint-Loup	146	2	148
43	Franche-Comté	70	2	21	239	Fondremand	173	2	175
43	Franche-Comté	70	1	22	240	Fontaine-lès-Luxeuil	1452	21	1473
43	Franche-Comté	70	1	25	242	Fontenois-la-Ville	144	3	147
43	Franche-Comté	70	2	17	243	Fontenois-lès-Montbozon	303	5	308
43	Franche-Comté	70	2	05	244	Fouchécourt	116	1	117
43	Franche-Comté	70	1	22	245	Fougerolles	3792	175	3967
43	Franche-Comté	70	2	04	247	Fouvent-Saint-Andoche	235	4	239
43	Franche-Comté	70	1	03	248	Frahier-et-Chatebier	1230	30	1260
43	Franche-Comté	70	2	04	252	Framont	196	2	198
43	Franche-Comté	70	1	22	249	Francalmont	119	3	122
43	Franche-Comté	70	1	31	250	Franchevelle	419	3	422
43	Franche-Comté	70	2	06	251	Francourt	105	1	106
43	Franche-Comté	70	2	10	253	Frasne-le-Château	291	47	338
43	Franche-Comté	70	1	03	254	Frédéric-Fontaine	264	1	265
43	Franche-Comté	70	2	08	255	Fresne-Saint-Mamès	500	10	510
43	Franche-Comté	70	1	16	256	Fresse	728	17	745
43	Franche-Comté	70	2	08	257	Fretigney-et-Velloreille	683	5	688
43	Franche-Comté	70	1	32	258	Froideconche	1994	74	2068
43	Franche-Comté	70	1	31	259	Froideterre	341	16	357
43	Franche-Comté	70	1	13	260	Frotey-lès-Lure	634	22	656
43	Franche-Comté	70	2	26	261	Frotey-lès-Vesoul	1380	46	1426
43	Franche-Comté	70	1	31	262	Genevreuille	174	1	175
43	Franche-Comté	70	1	23	263	Genevrey	229	7	236
43	Franche-Comté	70	1	27	264	Georfans	64	0	64
43	Franche-Comté	70	2	09	265	Germigney	178	2	180
43	Franche-Comté	70	2	05	267	Gevigney-et-Mercey	470	15	485
43	Franche-Comté	70	2	10	268	Gézier-et-Fontenelay	181	2	183
43	Franche-Comté	70	1	25	269	Girefontaine	46	1	47
43	Franche-Comté	70	1	27	271	Gouhenans	431	12	443
43	Franche-Comté	70	2	05	272	Gourgeon	253	4	257
43	Franche-Comté	70	1	27	273	Grammont	74	1	75
43	Franche-Comté	70	2	19	443	La Grande-Résie	84	5	89
43	Franche-Comté	70	2	06	274	Grandecourt	35	0	35
43	Franche-Comté	70	2	24	275	Grandvelle-et-le-Perrenot	343	6	349
43	Franche-Comté	70	1	27	276	Granges-la-Ville	214	3	217
43	Franche-Comté	70	1	27	277	Granges-le-Bourg	370	4	374
43	Franche-Comté	70	2	20	278	Grattery	199	8	207
43	Franche-Comté	70	2	09	279	Gray	6016	345	6361
43	Franche-Comté	70	2	09	280	Gray-la-Ville	977	40	1017
43	Franche-Comté	70	2	08	281	Greucourt	89	3	92
43	Franche-Comté	70	2	10	282	Gy	1048	32	1080
43	Franche-Comté	70	1	16	283	Haut-du-Them-Château-Lambert	449	10	459
43	Franche-Comté	70	1	22	284	Hautevelle	256	5	261
43	Franche-Comté	70	1	94	285	Héricourt	10349	286	10635
43	Franche-Comté	70	2	15	286	Hugier	136	4	140
43	Franche-Comté	70	1	25	287	Hurecourt	56	0	56
43	Franche-Comté	70	2	21	288	Hyet	99	2	101
43	Franche-Comté	70	2	09	289	Igny	200	3	203
43	Franche-Comté	70	1	25	290	Jasney	246	3	249
43	Franche-Comté	70	2	12	291	Jonvelle	142	3	145
43	Franche-Comté	70	2	12	292	Jussey	1766	49	1815
43	Franche-Comté	70	2	05	293	Lambrey	85	3	88
43	Franche-Comté	70	1	32	294	Lantenot	372	11	383
43	Franche-Comté	70	1	16	295	La Lanterne-et-les-Armonts	185	7	192
43	Franche-Comté	70	2	17	296	Larians-et-Munans	230	2	232
43	Franche-Comté	70	2	04	297	Larret	57	1	58
43	Franche-Comté	70	2	28	298	Lavigney	122	3	125
43	Franche-Comté	70	2	06	299	Lavoncourt	337	3	340
43	Franche-Comté	70	2	24	301	Lieffrans	60	0	60
43	Franche-Comté	70	2	19	302	Lieucourt	79	0	79
43	Franche-Comté	70	2	18	303	Liévans	131	3	134
43	Franche-Comté	70	1	32	304	Linexert	131	2	133
43	Franche-Comté	70	2	02	305	Loeuilley	119	0	119
43	Franche-Comté	70	1	11	306	Lomont	378	8	386
43	Franche-Comté	70	1	27	307	Longevelle	114	4	118
43	Franche-Comté	70	1	07	308	La Longine	244	9	253
43	Franche-Comté	70	2	17	309	Loulans-Verchamp	473	7	480
43	Franche-Comté	70	1	95	310	Lure	8325	302	8627
43	Franche-Comté	70	1	14	311	Luxeuil-les-Bains	7248	367	7615
43	Franche-Comté	70	1	30	312	Luze	737	11	748
43	Franche-Comté	70	1	13	313	Lyoffans	396	6	402
43	Franche-Comté	70	1	32	314	Magnivray	171	3	174
43	Franche-Comté	70	1	22	315	Magnoncourt	432	17	449
43	Franche-Comté	70	2	17	316	Le Magnoray	101	4	105
43	Franche-Comté	70	1	27	317	Les Magny	131	3	134
43	Franche-Comté	70	1	13	318	Magny-Danigon	454	9	463
43	Franche-Comté	70	1	13	319	Magny-Jobert	102	2	104
43	Franche-Comté	70	2	12	320	Magny-lès-Jussey	116	2	118
43	Franche-Comté	70	1	13	321	Magny-Vernois	1304	27	1331
43	Franche-Comté	70	1	23	322	Mailleroncourt-Charette	317	8	325
43	Franche-Comté	70	1	25	323	Mailleroncourt-Saint-Pancras	211	4	215
43	Franche-Comté	70	2	24	324	Mailley-et-Chazelot	605	12	617
43	Franche-Comté	70	2	21	325	Maizières	304	45	349
43	Franche-Comté	70	2	21	326	La Malachère	271	1	272
43	Franche-Comté	70	2	19	327	Malans	134	5	139
43	Franche-Comté	70	1	31	328	Malbouhans	379	6	385
43	Franche-Comté	70	2	28	329	Malvillers	73	1	74
43	Franche-Comté	70	1	30	330	Mandrevillars	218	8	226
43	Franche-Comté	70	2	02	331	Mantoche	481	27	508
43	Franche-Comté	70	1	27	332	Marast	42	1	43
43	Franche-Comté	70	2	15	334	Marnay	1380	27	1407
43	Franche-Comté	70	2	17	335	Maussans	67	0	67
43	Franche-Comté	70	1	27	336	Mélecey	163	7	170
43	Franche-Comté	70	2	05	337	Melin	61	0	61
43	Franche-Comté	70	1	25	338	Melincourt	249	13	262
43	Franche-Comté	70	1	16	339	Mélisey	1677	45	1722
43	Franche-Comté	70	2	06	340	Membrey	222	41	263
43	Franche-Comté	70	2	01	341	Menoux	288	11	299
43	Franche-Comté	70	2	08	342	Mercey-sur-Saône	138	1	139
43	Franche-Comté	70	2	20	343	Mersuay	270	2	272
43	Franche-Comté	70	1	23	344	Meurcourt	308	13	321
43	Franche-Comté	70	1	16	345	Miellin	76	2	78
43	Franche-Comté	70	1	27	347	Mignavillers	349	7	356
43	Franche-Comté	70	1	13	348	Moffans-et-Vacheresse	624	13	637
43	Franche-Comté	70	1	27	349	Moimay	223	5	228
43	Franche-Comté	70	2	28	350	Molay	72	0	72
43	Franche-Comté	70	1	13	351	Mollans	244	2	246
43	Franche-Comté	70	2	29	367	Mont-le-Vernois	156	2	158
43	Franche-Comté	70	2	06	369	Mont-Saint-Léger	65	1	66
43	Franche-Comté	70	1	07	352	La Montagne	40	2	42
43	Franche-Comté	70	2	19	353	Montagney	504	12	516
43	Franche-Comté	70	2	21	355	Montarlot-lès-Rioz	288	4	292
43	Franche-Comté	70	2	10	356	Montboillon	269	3	272
43	Franche-Comté	70	2	17	357	Montbozon	546	82	628
43	Franche-Comté	70	2	26	358	Montcey	223	7	230
43	Franche-Comté	70	2	12	359	Montcourt	67	1	68
43	Franche-Comté	70	1	25	360	Montdoré	67	2	69
43	Franche-Comté	70	1	16	361	Montessaux	168	3	171
43	Franche-Comté	70	2	28	362	Montigny-lès-Cherlieu	177	0	177
43	Franche-Comté	70	2	29	363	Montigny-lès-Vesoul	658	24	682
43	Franche-Comté	70	2	18	364	Montjustin-et-Velotte	128	7	135
43	Franche-Comté	70	2	06	368	Montot	126	2	128
43	Franche-Comté	70	2	02	371	Montureux-et-Prantigny	209	7	216
43	Franche-Comté	70	2	01	372	Montureux-lès-Baulay	170	4	174
43	Franche-Comté	70	2	19	374	Motey-Besuche	112	1	113
43	Franche-Comté	70	2	08	375	Motey-sur-Saône	25	0	25
43	Franche-Comté	70	2	02	376	Nantilly	525	13	538
43	Franche-Comté	70	2	26	378	Navenne	1751	82	1833
43	Franche-Comté	70	1	23	380	Neurey-en-Vaux	164	8	172
43	Franche-Comté	70	2	18	381	Neurey-lès-la-Demie	347	3	350
43	Franche-Comté	70	2	21	383	Neuvelle-lès-Cromary	324	9	333
43	Franche-Comté	70	2	24	384	Neuvelle-lès-la-Charité	227	3	230
43	Franche-Comté	70	1	31	385	La Neuvelle-lès-Lure	335	7	342
43	Franche-Comté	70	2	05	386	La Neuvelle-lès-Scey	176	6	182
43	Franche-Comté	70	2	24	387	Noidans-le-Ferroux	624	15	639
43	Franche-Comté	70	2	29	388	Noidans-lès-Vesoul	2076	61	2137
43	Franche-Comté	70	2	09	389	Noiron	64	0	64
43	Franche-Comté	70	2	18	390	Noroy-le-Bourg	482	13	495
43	Franche-Comté	70	2	05	392	Oigney	50	1	51
43	Franche-Comté	70	2	10	393	Oiselay-et-Grachaux	397	8	405
43	Franche-Comté	70	2	09	394	Onay	73	2	75
43	Franche-Comté	70	1	27	395	Oppenans	54	1	55
43	Franche-Comté	70	1	27	396	Oricourt	34	1	35
43	Franche-Comté	70	2	17	397	Ormenans	65	1	66
43	Franche-Comté	70	1	32	398	Ormoiche	72	0	72
43	Franche-Comté	70	2	12	399	Ormoy	224	0	224
43	Franche-Comté	70	2	28	400	Ouge	122	3	125
43	Franche-Comté	70	2	24	401	Ovanches	122	2	124
43	Franche-Comté	70	2	02	402	Oyrières	428	4	432
43	Franche-Comté	70	1	13	403	Palante	183	5	188
43	Franche-Comté	70	2	12	404	Passavant-la-Rochère	659	23	682
43	Franche-Comté	70	2	21	405	Pennesières	171	2	173
43	Franche-Comté	70	2	04	406	Percey-le-Grand	93	4	97
43	Franche-Comté	70	2	21	407	Perrouse	233	3	236
43	Franche-Comté	70	2	19	408	Pesmes	1112	22	1134
43	Franche-Comté	70	2	04	409	Pierrecourt	121	4	125
43	Franche-Comté	70	2	15	410	Pin	694	5	699
43	Franche-Comté	70	1	25	411	La Pisseure	46	1	47
43	Franche-Comté	70	1	25	412	Plainemont	58	0	58
43	Franche-Comté	70	1	03	413	Plancher-Bas	1923	31	1954
43	Franche-Comté	70	1	03	414	Plancher-les-Mines	1092	12	1104
43	Franche-Comté	70	2	01	415	Polaincourt-et-Clairefontaine	809	11	820
43	Franche-Comté	70	1	31	416	Pomoy	193	6	199
43	Franche-Comté	70	2	08	418	Le Pont-de-Planches	214	6	220
43	Franche-Comté	70	1	25	419	Pont-du-Bois	116	1	117
43	Franche-Comté	70	1	27	420	Pont-sur-l;Ognon	57	4	61
43	Franche-Comté	70	2	24	417	Pontcey	278	12	290
43	Franche-Comté	70	2	20	421	Port-sur-Saône	2990	87	3077
43	Franche-Comté	70	2	02	422	Poyans	138	3	141
43	Franche-Comté	70	2	28	423	Preigney	119	2	121
43	Franche-Comté	70	1	07	425	La Proiselière-et-Langle	173	3	176
43	Franche-Comté	70	2	20	426	Provenchère	292	10	302
43	Franche-Comté	70	2	05	427	Purgerot	367	10	377
43	Franche-Comté	70	2	29	428	Pusey	1557	29	1586
43	Franche-Comté	70	2	29	429	Pusy-et-Épenoux	545	7	552
43	Franche-Comté	70	2	28	430	La Quarte	70	3	73
43	Franche-Comté	70	2	21	431	Quenoche	206	2	208
43	Franche-Comté	70	1	31	432	Quers	353	5	358
43	Franche-Comté	70	2	26	433	Quincey	1272	52	1324
43	Franche-Comté	70	1	07	435	Raddon-et-Chapendu	930	23	953
43	Franche-Comté	70	2	12	436	Raincourt	126	3	129
43	Franche-Comté	70	2	12	437	Ranzevelle	21	0	21
43	Franche-Comté	70	2	06	438	Ray-sur-Saône	216	6	222
43	Franche-Comté	70	2	24	439	Raze	331	11	342
43	Franche-Comté	70	2	06	440	Recologne	46	1	47
43	Franche-Comté	70	2	21	441	Recologne-lès-Rioz	215	3	218
43	Franche-Comté	70	2	06	442	Renaucourt	107	1	108
43	Franche-Comté	70	2	19	444	La Résie-Saint-Martin	163	2	165
43	Franche-Comté	70	1	32	445	Rignovelle	96	4	100
43	Franche-Comté	70	2	02	446	Rigny	616	16	632
43	Franche-Comté	70	2	21	447	Rioz	1891	98	1989
43	Franche-Comté	70	2	06	448	Roche-et-Raucourt	147	3	150
43	Franche-Comté	70	2	28	373	La Roche-Morey	267	6	273
43	Franche-Comté	70	2	17	449	Roche-sur-Linotte-et-Sorans-les-Cordiers	72	2	74
43	Franche-Comté	70	2	28	450	La Rochelle	36	3	39
43	Franche-Comté	70	1	03	451	Ronchamp	2919	52	2971
43	Franche-Comté	70	2	24	452	Rosey	263	7	270
43	Franche-Comté	70	1	07	453	La Rosière	86	4	90
43	Franche-Comté	70	2	28	454	Rosières-sur-Mance	77	3	80
43	Franche-Comté	70	1	13	455	Roye	1345	34	1379
43	Franche-Comté	70	2	17	456	Ruhans	146	0	146
43	Franche-Comté	70	2	24	457	Rupt-sur-Saône	119	6	125
43	Franche-Comté	70	1	16	459	Saint-Barthélemy	1149	22	1171
43	Franche-Comté	70	1	07	460	Saint-Bresson	453	5	458
43	Franche-Comté	70	2	09	461	Saint-Broing	127	3	130
43	Franche-Comté	70	1	27	462	Saint-Ferjeux	80	1	81
43	Franche-Comté	70	2	08	463	Saint-Gand	138	0	138
43	Franche-Comté	70	1	31	464	Saint-Germain	1316	37	1353
43	Franche-Comté	70	2	09	466	Saint-Loup-Nantouard	112	2	114
43	Franche-Comté	70	1	22	467	Saint-Loup-sur-Semouse	3460	105	3565
43	Franche-Comté	70	2	28	468	Saint-Marcel	118	2	120
43	Franche-Comté	70	2	01	472	Saint-Remy	568	9	577
43	Franche-Comté	70	1	32	473	Saint-Sauveur	2108	52	2160
43	Franche-Comté	70	1	27	474	Saint-Sulpice	140	1	141
43	Franche-Comté	70	1	14	475	Saint-Valbert	224	3	227
43	Franche-Comté	70	1	07	469	Sainte-Marie-en-Chanois	212	9	221
43	Franche-Comté	70	1	32	470	Sainte-Marie-en-Chaux	170	6	176
43	Franche-Comté	70	2	08	471	Sainte-Reine	35	0	35
43	Franche-Comté	70	2	01	476	Saponcourt	62	0	62
43	Franche-Comté	70	1	11	477	Saulnot	801	15	816
43	Franche-Comté	70	1	23	478	Saulx	866	20	886
43	Franche-Comté	70	2	09	479	Sauvigney-lès-Gray	113	0	113
43	Franche-Comté	70	2	19	480	Sauvigney-lès-Pesmes	172	2	174
43	Franche-Comté	70	2	06	481	Savoyeux	223	4	227
43	Franche-Comté	70	2	24	482	Scey-sur-Saône-et-Saint-Albin	1682	37	1719
43	Franche-Comté	70	2	20	483	Scye	106	4	110
43	Franche-Comté	70	1	27	484	Secenans	159	2	161
43	Franche-Comté	70	1	25	485	Selles	242	7	249
43	Franche-Comté	70	2	05	486	Semmadon	135	5	140
43	Franche-Comté	70	1	27	487	Senargent-Mignafans	285	9	294
43	Franche-Comté	70	2	01	488	Senoncourt	217	10	227
43	Franche-Comté	70	1	16	489	Servance	846	24	870
43	Franche-Comté	70	1	23	490	Servigney	104	1	105
43	Franche-Comté	70	2	08	491	Seveux	467	6	473
43	Franche-Comté	70	2	08	492	Soing-Cubry-Charentenay	467	10	477
43	Franche-Comté	70	2	21	493	Sorans-lès-Breurey	417	9	426
43	Franche-Comté	70	2	15	494	Sornay	306	4	310
43	Franche-Comté	70	2	12	496	Tartécourt	39	1	40
43	Franche-Comté	70	1	11	497	Tavey	453	6	459
43	Franche-Comté	70	1	16	498	Ternuay-Melay-et-Saint-Hilaire	519	16	535
43	Franche-Comté	70	2	06	499	Theuley	109	2	111
43	Franche-Comté	70	2	17	500	Thieffrans	177	4	181
43	Franche-Comté	70	2	17	501	Thiénans	85	2	87
43	Franche-Comté	70	2	06	502	Tincey-et-Pontrebeau	83	2	85
43	Franche-Comté	70	2	21	503	Traitiéfontaine	154	3	157
43	Franche-Comté	70	2	24	504	Traves	352	7	359
43	Franche-Comté	70	2	09	505	Le Tremblois	187	3	190
43	Franche-Comté	70	1	11	506	Trémoins	355	7	362
43	Franche-Comté	70	2	21	507	Trésilley	207	2	209
43	Franche-Comté	70	2	15	509	Tromarey	110	6	116
43	Franche-Comté	70	2	19	510	Vadans	137	3	140
43	Franche-Comté	70	2	06	511	Vaite	214	5	219
43	Franche-Comté	70	1	22	512	La Vaivre	211	1	212
43	Franche-Comté	70	2	29	513	Vaivre-et-Montoille	2293	92	2385
43	Franche-Comté	70	1	13	515	Le Val-de-Gouhenans	64	2	66
43	Franche-Comté	70	2	20	518	Le Val-Saint-Éloi	110	2	112
43	Franche-Comté	70	2	19	514	Valay	685	10	695
43	Franche-Comté	70	2	18	516	Vallerois-le-Bois	259	6	265
43	Franche-Comté	70	2	18	517	Vallerois-Lorioz	359	11	370
43	Franche-Comté	70	2	21	519	Vandelans	110	4	114
43	Franche-Comté	70	2	06	520	Vanne	93	2	95
43	Franche-Comté	70	2	10	521	Vantoux-et-Longevelle	157	6	163
43	Franche-Comté	70	2	26	522	Varogne	137	2	139
43	Franche-Comté	70	2	02	523	Vars	202	3	205
43	Franche-Comté	70	2	20	524	Vauchoux	126	6	132
43	Franche-Comté	70	2	06	525	Vauconcourt-Nervezain	228	2	230
43	Franche-Comté	70	1	25	526	Vauvillers	680	16	696
43	Franche-Comté	70	2	10	527	Vaux-le-Moncelot	76	1	77
43	Franche-Comté	70	2	09	528	Velesmes-Échevanne	521	21	542
43	Franche-Comté	70	2	09	529	Velet	418	11	429
43	Franche-Comté	70	2	24	536	Velle-le-Châtel	139	3	142
43	Franche-Comté	70	1	27	530	Vellechevreux-et-Courbenans	155	1	156
43	Franche-Comté	70	2	10	531	Velleclaire	105	2	107
43	Franche-Comté	70	2	17	532	Vellefaux	464	16	480
43	Franche-Comté	70	2	10	533	Vellefrey-et-Vellefrange	110	3	113
43	Franche-Comté	70	2	26	534	Vellefrie	134	3	137
43	Franche-Comté	70	2	24	535	Velleguindry-et-Levrecey	156	2	158
43	Franche-Comté	70	1	23	537	Velleminfroy	281	10	291
43	Franche-Comté	70	2	10	538	Vellemoz	85	2	87
43	Franche-Comté	70	2	08	539	Vellexon-Queutrey-et-Vaudey	495	10	505
43	Franche-Comté	70	2	10	540	Velloreille-lès-Choye	80	0	80
43	Franche-Comté	70	1	23	541	Velorcey	212	5	217
43	Franche-Comté	70	2	19	542	Venère	192	4	196
43	Franche-Comté	70	2	01	545	Venisey	146	5	151
43	Franche-Comté	70	2	06	546	Vereux	255	27	282
43	Franche-Comté	70	1	27	544	La Vergenne	116	0	116
43	Franche-Comté	70	1	11	547	Verlans	157	6	163
43	Franche-Comté	70	2	28	548	Vernois-sur-Mance	170	3	173
43	Franche-Comté	70	2	08	549	La Vernotte	71	3	74
43	Franche-Comté	70	2	96	550	Vesoul	15761	1173	16934
43	Franche-Comté	70	2	08	551	Vezet	189	3	192
43	Franche-Comté	70	1	27	552	Villafans	196	2	198
43	Franche-Comté	70	1	27	553	Villargent	113	2	115
43	Franche-Comté	70	2	12	554	Villars-le-Pautel	161	3	164
43	Franche-Comté	70	1	23	555	La Villedieu-en-Fontenette	184	6	190
43	Franche-Comté	70	2	10	557	Villefrancon	137	3	140
43	Franche-Comté	70	2	26	558	La Villeneuve-Bellenoye-et-la-Maize	127	0	127
43	Franche-Comté	70	2	26	559	Villeparois	211	3	214
43	Franche-Comté	70	2	21	560	Villers-Bouton	166	2	168
43	Franche-Comté	70	2	10	366	Villers-Chemin-et-Mont-lès-Étrelles	127	1	128
43	Franche-Comté	70	1	27	562	Villers-la-Ville	164	2	166
43	Franche-Comté	70	2	18	563	Villers-le-Sec	528	27	555
43	Franche-Comté	70	1	23	564	Villers-lès-Luxeuil	342	5	347
43	Franche-Comté	70	2	17	565	Villers-Pater	40	1	41
43	Franche-Comté	70	2	20	566	Villers-sur-Port	211	4	215
43	Franche-Comté	70	1	11	567	Villers-sur-Saulnot	156	1	157
43	Franche-Comté	70	2	06	568	Villers-Vaudey	61	4	65
43	Franche-Comté	70	1	27	561	Villersexel	1464	117	1581
43	Franche-Comté	70	2	26	569	Vilory	86	0	86
43	Franche-Comté	70	1	32	571	Visoncourt	32	0	32
43	Franche-Comté	70	2	28	572	Vitrey-sur-Mance	291	2	293
43	Franche-Comté	70	1	07	573	La Voivre	144	4	148
43	Franche-Comté	70	2	06	574	Volon	66	0	66
43	Franche-Comté	70	2	21	575	Voray-sur-l;Ognon	811	23	834
43	Franche-Comté	70	2	12	576	Vougécourt	150	2	152
43	Franche-Comté	70	1	13	577	Vouhenans	397	14	411
43	Franche-Comté	70	2	15	578	Vregille	173	4	177
43	Franche-Comté	70	2	24	580	Vy-le-Ferroux	175	4	179
43	Franche-Comté	70	2	17	583	Vy-lès-Filain	86	2	88
43	Franche-Comté	70	1	13	581	Vy-lès-Lure	674	20	694
43	Franche-Comté	70	2	24	582	Vy-lès-Rupt	105	2	107
43	Franche-Comté	70	1	11	579	Vyans-le-Val	414	14	428
26	Bourgogne	71	4	16	001	L; Abergement-de-Cuisery	736	16	752
26	Bourgogne	71	2	43	002	L; Abergement-Sainte-Colombe	1110	35	1145
26	Bourgogne	71	2	51	003	Allerey-sur-Saône	785	10	795
26	Bourgogne	71	2	45	004	Allériot	979	38	1017
26	Bourgogne	71	2	05	005	Aluze	235	4	239
26	Bourgogne	71	3	11	006	Amanzé	175	17	192
26	Bourgogne	71	5	41	007	Ameugny	142	2	144
26	Bourgogne	71	3	10	008	Anglure-sous-Dun	170	3	173
26	Bourgogne	71	1	24	009	Anost	692	25	717
26	Bourgogne	71	1	52	010	Antully	818	17	835
26	Bourgogne	71	3	28	011	Anzy-le-Duc	440	96	536
26	Bourgogne	71	3	28	012	Artaix	409	4	413
26	Bourgogne	71	4	39	013	Authumes	253	5	258
26	Bourgogne	71	1	95	014	Autun	14256	1374	15630
26	Bourgogne	71	1	52	015	Auxy	987	18	1005
26	Bourgogne	71	5	25	016	Azé	1049	27	1076
26	Bourgogne	71	3	21	017	Ballore	83	3	86
26	Bourgogne	71	4	34	018	Bantanges	562	13	575
26	Bourgogne	71	2	19	019	Barizey	133	5	138
26	Bourgogne	71	1	24	020	Barnay	106	3	109
26	Bourgogne	71	3	09	021	Baron	288	14	302
26	Bourgogne	71	3	11	022	Baudemont	678	17	695
26	Bourgogne	71	2	43	023	Baudrières	892	16	908
26	Bourgogne	71	3	28	024	Baugy	515	15	530
26	Bourgogne	71	3	40	025	Beaubery	371	8	379
26	Bourgogne	71	2	47	026	Beaumont-sur-Grosne	333	6	339
26	Bourgogne	71	4	02	027	Beaurepaire-en-Bresse	628	10	638
26	Bourgogne	71	4	39	028	Beauvernois	90	3	93
26	Bourgogne	71	4	39	029	Bellevesvre	274	9	283
26	Bourgogne	71	5	12	030	Bergesserin	301	15	316
26	Bourgogne	71	5	26	032	Berzé-la-Ville	536	8	544
26	Bourgogne	71	5	12	031	Berzé-le-Châtel	60	2	62
26	Bourgogne	71	2	45	033	Bey	796	18	814
26	Bourgogne	71	2	04	034	Bissey-sous-Cruchaud	347	11	358
26	Bourgogne	71	5	25	035	Bissy-la-Mâconnaise	212	4	216
26	Bourgogne	71	5	41	036	Bissy-sous-Uxelles	67	2	69
26	Bourgogne	71	2	04	037	Bissy-sur-Fley	100	5	105
26	Bourgogne	71	1	32	038	Les Bizots	457	17	474
26	Bourgogne	71	5	12	039	Blanot	164	4	168
26	Bourgogne	71	1	32	040	Blanzy	6633	211	6844
26	Bourgogne	71	3	11	041	Bois-Sainte-Marie	198	2	200
26	Bourgogne	71	5	41	042	Bonnay	300	10	310
26	Bourgogne	71	2	51	043	Les Bordes	99	2	101
26	Bourgogne	71	4	42	044	Bosjean	314	8	322
26	Bourgogne	71	4	42	045	Bouhans	152	6	158
26	Bourgogne	71	1	30	046	La Boulaye	115	5	120
26	Bourgogne	71	3	03	047	Bourbon-Lancy	5260	107	5367
26	Bourgogne	71	3	28	048	Bourg-le-Comte	209	8	217
26	Bourgogne	71	5	50	050	Bourgvilain	331	7	338
26	Bourgogne	71	2	05	051	Bouzeron	152	3	155
26	Bourgogne	71	2	47	052	Boyer	689	18	707
26	Bourgogne	71	2	51	054	Bragny-sur-Saône	588	13	601
26	Bourgogne	71	5	29	055	Brandon	303	3	306
26	Bourgogne	71	4	23	056	Branges	2393	40	2433
26	Bourgogne	71	5	12	057	Bray	121	8	129
26	Bourgogne	71	2	47	058	Bresse-sur-Grosne	211	5	216
26	Bourgogne	71	1	14	059	Le Breuil	3602	104	3706
26	Bourgogne	71	3	46	060	Briant	228	7	235
26	Bourgogne	71	4	16	061	Brienne	449	6	455
26	Bourgogne	71	1	30	062	Brion	348	19	367
26	Bourgogne	71	1	30	063	Broye	811	16	827
26	Bourgogne	71	4	23	064	Bruailles	937	23	960
26	Bourgogne	71	5	12	065	Buffières	261	5	266
26	Bourgogne	71	5	25	066	Burgy	108	2	110
26	Bourgogne	71	5	41	067	Burnand	119	8	127
26	Bourgogne	71	5	41	068	Burzy	66	2	68
26	Bourgogne	71	5	27	069	Bussières	592	21	613
26	Bourgogne	71	2	04	070	Buxy	2182	109	2291
26	Bourgogne	71	1	24	509	La Celle-en-Morvan	440	15	455
26	Bourgogne	71	3	28	071	Céron	287	3	290
26	Bourgogne	71	2	04	072	Cersot	117	3	120
26	Bourgogne	71	2	05	073	Chagny	5572	159	5731
26	Bourgogne	71	5	08	074	Chaintré	531	26	557
26	Bourgogne	71	3	03	075	Chalmoux	702	12	714
26	Bourgogne	71	2	98	076	Chalon-sur-Saône	44985	1806	46791
26	Bourgogne	71	3	28	077	Chambilly	515	8	523
26	Bourgogne	71	2	05	078	Chamilly	123	3	126
26	Bourgogne	71	4	15	079	Champagnat	496	6	502
26	Bourgogne	71	2	47	080	Champagny-sous-Uxelles	82	4	86
26	Bourgogne	71	2	53	081	Champforgeuil	2315	55	2370
26	Bourgogne	71	3	09	082	Champlecy	233	13	246
26	Bourgogne	71	5	08	084	Chânes	554	7	561
26	Bourgogne	71	1	18	085	Change	235	10	245
26	Bourgogne	71	3	09	086	Changy	441	14	455
26	Bourgogne	71	5	41	087	Chapaize	127	4	131
26	Bourgogne	71	3	20	088	La Chapelle-au-Mans	258	8	266
26	Bourgogne	71	2	47	089	La Chapelle-de-Bragny	241	6	247
26	Bourgogne	71	5	08	090	La Chapelle-de-Guinchay	3746	79	3825
26	Bourgogne	71	5	29	091	La Chapelle-du-Mont-de-France	174	1	175
26	Bourgogne	71	4	23	092	La Chapelle-Naude	518	15	533
26	Bourgogne	71	4	39	093	La Chapelle-Saint-Sauveur	675	22	697
26	Bourgogne	71	5	49	094	La Chapelle-sous-Brancion	126	7	133
26	Bourgogne	71	3	11	095	La Chapelle-sous-Dun	399	12	411
26	Bourgogne	71	1	30	096	La Chapelle-sous-Uchon	184	10	194
26	Bourgogne	71	4	34	097	La Chapelle-Thècle	478	15	493
26	Bourgogne	71	1	30	098	Charbonnat	239	8	247
26	Bourgogne	71	5	26	099	Charbonnières	350	13	363
26	Bourgogne	71	5	25	100	Chardonnay	187	4	191
26	Bourgogne	71	4	39	101	Charette-Varennes	419	10	429
26	Bourgogne	71	2	07	102	La Charmée	688	29	717
26	Bourgogne	71	1	32	103	Charmoy	271	8	279
26	Bourgogne	71	2	51	104	Charnay-lès-Chalon	177	6	183
26	Bourgogne	71	5	55	105	Charnay-lès-Mâcon	6827	354	7181
26	Bourgogne	71	3	09	106	Charolles	2794	350	3144
26	Bourgogne	71	2	19	107	Charrecey	294	7	301
26	Bourgogne	71	5	08	108	Chasselas	173	2	175
26	Bourgogne	71	2	05	109	Chassey-le-Camp	321	7	328
26	Bourgogne	71	3	10	110	Chassigny-sous-Dun	613	22	635
26	Bourgogne	71	3	20	111	Chassy	345	17	362
26	Bourgogne	71	5	12	112	Château	266	8	274
26	Bourgogne	71	3	10	113	Châteauneuf	116	1	117
26	Bourgogne	71	2	19	115	Châtel-Moron	86	1	87
26	Bourgogne	71	3	11	116	Châtenay	160	6	166
26	Bourgogne	71	2	07	117	Châtenoy-en-Bresse	974	19	993
26	Bourgogne	71	2	57	118	Châtenoy-le-Royal	5906	180	6086
26	Bourgogne	71	2	05	119	Chaudenay	1063	34	1097
26	Bourgogne	71	3	10	120	Chauffailles	3922	94	4016
26	Bourgogne	71	4	39	121	La Chaux	302	13	315
26	Bourgogne	71	1	13	122	Cheilly-lès-Maranges	498	9	507
26	Bourgogne	71	3	28	123	Chenay-le-Châtel	400	7	407
26	Bourgogne	71	2	04	124	Chenôves	223	12	235
26	Bourgogne	71	5	12	125	Chérizet	33	0	33
26	Bourgogne	71	5	26	126	Chevagny-les-Chevrières	605	38	643
26	Bourgogne	71	3	21	127	Chevagny-sur-Guye	76	4	80
26	Bourgogne	71	3	40	128	Chiddes	77	0	77
26	Bourgogne	71	1	24	129	Chissey-en-Morvan	300	3	303
26	Bourgogne	71	5	41	130	Chissey-lès-Mâcon	254	7	261
26	Bourgogne	71	2	51	131	Ciel	751	14	765
26	Bourgogne	71	3	48	132	Ciry-le-Noble	2380	65	2445
26	Bourgogne	71	3	11	133	La Clayette	1884	72	1956
26	Bourgogne	71	5	50	134	Clermain	232	4	236
26	Bourgogne	71	5	25	135	Clessé	829	21	850
26	Bourgogne	71	3	20	136	Clessy	261	12	273
26	Bourgogne	71	5	12	137	Cluny	4638	319	4957
26	Bourgogne	71	2	51	138	Clux	110	0	110
26	Bourgogne	71	3	21	139	Collonge-en-Charollais	134	1	135
26	Bourgogne	71	1	18	140	Collonge-la-Madeleine	46	1	47
26	Bourgogne	71	3	11	141	Colombier-en-Brionnais	307	5	312
26	Bourgogne	71	1	44	142	La Comelle	185	3	188
26	Bourgogne	71	4	15	143	Condal	419	6	425
26	Bourgogne	71	1	24	144	Cordesse	190	2	192
26	Bourgogne	71	5	41	145	Cormatin	555	8	563
26	Bourgogne	71	5	12	146	Cortambert	214	7	221
26	Bourgogne	71	5	41	147	Cortevaix	261	3	264
26	Bourgogne	71	3	10	148	Coublanc	885	28	913
26	Bourgogne	71	1	13	149	Couches	1485	27	1512
26	Bourgogne	71	5	08	150	Crêches-sur-Saône	2846	101	2947
26	Bourgogne	71	1	18	151	Créot	79	1	80
26	Bourgogne	71	1	22	152	Cressy-sur-Somme	233	6	239
26	Bourgogne	71	1	96	153	Le Creusot	22783	403	23186
26	Bourgogne	71	2	53	154	Crissey	2431	88	2519
26	Bourgogne	71	3	03	155	Cronat	570	14	584
26	Bourgogne	71	5	25	156	Cruzille	239	68	307
26	Bourgogne	71	4	15	157	Cuiseaux	1791	33	1824
26	Bourgogne	71	4	16	158	Cuisery	1653	50	1703
26	Bourgogne	71	2	04	159	Culles-les-Roches	191	3	194
26	Bourgogne	71	3	11	160	Curbigny	315	15	330
26	Bourgogne	71	3	20	161	Curdin	321	7	328
26	Bourgogne	71	1	52	162	Curgy	1102	49	1151
26	Bourgogne	71	5	12	163	Curtil-sous-Buffières	76	2	78
26	Bourgogne	71	5	41	164	Curtil-sous-Burnand	126	5	131
26	Bourgogne	71	1	24	165	Cussy-en-Morvan	458	4	462
26	Bourgogne	71	1	22	166	Cuzy	141	6	147
26	Bourgogne	71	2	45	167	Damerey	580	9	589
26	Bourgogne	71	4	39	168	Dampierre-en-Bresse	167	0	167
26	Bourgogne	71	5	27	169	Davayé	679	99	778
26	Bourgogne	71	2	05	170	Demigny	1759	40	1799
26	Bourgogne	71	2	05	171	Dennevy	323	4	327
26	Bourgogne	71	1	30	172	Dettey	93	3	96
26	Bourgogne	71	4	42	173	Devrouze	302	4	306
26	Bourgogne	71	1	13	174	Dezize-lès-Maranges	194	3	197
26	Bourgogne	71	4	42	175	Diconne	334	3	337
26	Bourgogne	71	3	17	176	Digoin	8303	264	8567
26	Bourgogne	71	4	15	177	Dommartin-lès-Cuiseaux	796	12	808
26	Bourgogne	71	5	29	178	Dompierre-les-Ormes	949	22	971
26	Bourgogne	71	3	48	179	Dompierre-sous-Sanvignes	71	2	73
26	Bourgogne	71	5	12	180	Donzy-le-National	190	8	198
26	Bourgogne	71	5	12	181	Donzy-le-Pertuis	157	5	162
26	Bourgogne	71	2	19	182	Dracy-le-Fort	1327	66	1393
26	Bourgogne	71	1	13	183	Dracy-lès-Couches	170	9	179
26	Bourgogne	71	1	01	184	Dracy-Saint-Loup	603	15	618
26	Bourgogne	71	3	11	185	Dyo	342	10	352
26	Bourgogne	71	2	51	186	Écuelles	206	2	208
26	Bourgogne	71	2	33	187	Écuisses	1670	37	1707
26	Bourgogne	71	1	18	188	Épertully	60	1	61
26	Bourgogne	71	2	07	189	Épervans	1616	36	1652
26	Bourgogne	71	1	18	190	Épinac	2341	60	2401
26	Bourgogne	71	1	13	191	Essertenne	442	17	459
26	Bourgogne	71	1	44	192	Étang-sur-Arroux	1958	129	2087
26	Bourgogne	71	2	47	193	Étrigny	448	20	468
26	Bourgogne	71	2	53	194	Farges-lès-Chalon	716	25	741
26	Bourgogne	71	5	49	195	Farges-lès-Mâcon	207	8	215
26	Bourgogne	71	4	02	196	Le Fay	623	8	631
26	Bourgogne	71	4	15	198	Flacey-en-Bresse	362	8	370
26	Bourgogne	71	5	12	199	Flagy	181	6	187
26	Bourgogne	71	5	25	591	Fleurville	478	20	498
26	Bourgogne	71	3	46	200	Fleury-la-Montagne	638	11	649
26	Bourgogne	71	2	04	201	Fley	245	1	246
26	Bourgogne	71	2	05	202	Fontaines	2007	365	2372
26	Bourgogne	71	3	09	203	Fontenay	44	2	46
26	Bourgogne	71	2	53	204	Fragnes	1000	36	1036
26	Bourgogne	71	4	42	205	Frangy-en-Bresse	642	13	655
26	Bourgogne	71	4	35	206	La Frette	221	1	222
26	Bourgogne	71	4	39	207	Fretterans	291	5	296
26	Bourgogne	71	4	39	208	Frontenard	234	7	241
26	Bourgogne	71	4	15	209	Frontenaud	743	18	761
26	Bourgogne	71	5	27	210	Fuissé	355	13	368
26	Bourgogne	71	3	48	212	Génelard	1432	56	1488
26	Bourgogne	71	4	16	213	La Genête	550	12	562
26	Bourgogne	71	2	36	214	Genouilly	412	17	429
26	Bourgogne	71	2	51	215	Gergy	2554	62	2616
26	Bourgogne	71	2	04	216	Germagny	197	1	198
26	Bourgogne	71	5	50	217	Germolles-sur-Grosne	143	5	148
26	Bourgogne	71	3	11	218	Gibles	629	23	652
26	Bourgogne	71	2	47	219	Gigny-sur-Saône	533	14	547
26	Bourgogne	71	3	03	220	Gilly-sur-Loire	478	12	490
26	Bourgogne	71	2	19	221	Givry	3724	229	3953
26	Bourgogne	71	2	36	222	Gourdon	874	36	910
26	Bourgogne	71	1	44	223	La Grande-Verrière	531	22	553
26	Bourgogne	71	3	37	224	Grandvaux	82	3	85
26	Bourgogne	71	2	19	225	Granges	524	10	534
26	Bourgogne	71	5	25	226	Grevilly	34	1	35
26	Bourgogne	71	1	22	227	Grury	541	10	551
26	Bourgogne	71	2	45	228	Guerfand	181	5	186
26	Bourgogne	71	3	17	229	Les Guerreaux	254	3	257
26	Bourgogne	71	3	20	230	Gueugnon	7512	262	7774
26	Bourgogne	71	3	21	231	La Guiche	618	12	630
26	Bourgogne	71	3	38	232	Hautefond	211	11	222
26	Bourgogne	71	3	38	233	L; Hôpital-le-Mercier	307	5	312
26	Bourgogne	71	4	16	234	Huilly-sur-Seille	303	1	304
26	Bourgogne	71	5	26	235	Hurigny	1908	98	2006
26	Bourgogne	71	5	26	236	Igé	878	38	916
26	Bourgogne	71	1	24	237	Igornay	508	8	516
26	Bourgogne	71	3	46	238	Iguerande	1010	18	1028
26	Bourgogne	71	1	22	239	Issy-l;Évêque	823	26	849
26	Bourgogne	71	5	12	240	Jalogny	323	7	330
26	Bourgogne	71	2	19	241	Jambles	479	20	499
26	Bourgogne	71	3	21	242	Joncy	526	15	541
26	Bourgogne	71	4	15	243	Joudes	414	11	425
26	Bourgogne	71	4	16	244	Jouvençon	432	10	442
26	Bourgogne	71	2	47	245	Jugy	301	5	306
26	Bourgogne	71	4	35	246	Juif	254	3	257
26	Bourgogne	71	2	04	247	Jully-lès-Buxy	353	8	361
26	Bourgogne	71	5	49	248	Lacrost	692	21	713
26	Bourgogne	71	2	47	249	Laives	994	33	1027
26	Bourgogne	71	5	26	250	Laizé	1061	34	1095
26	Bourgogne	71	1	30	251	Laizy	636	19	655
26	Bourgogne	71	2	47	252	Lalheue	367	11	378
26	Bourgogne	71	2	07	253	Lans	881	33	914
26	Bourgogne	71	4	39	254	Lays-sur-le-Doubs	130	0	130
26	Bourgogne	71	3	03	255	Lesme	186	6	192
26	Bourgogne	71	2	43	256	Lessard-en-Bresse	528	9	537
26	Bourgogne	71	2	05	257	Lessard-le-National	602	25	627
26	Bourgogne	71	5	08	258	Leynes	486	25	511
26	Bourgogne	71	3	46	259	Ligny-en-Brionnais	354	19	373
26	Bourgogne	71	4	16	261	Loisy	585	8	593
26	Bourgogne	71	2	51	262	Longepierre	183	1	184
26	Bourgogne	71	4	23	263	Louhans	6520	396	6916
26	Bourgogne	71	5	12	264	Lournand	335	13	348
26	Bourgogne	71	2	53	265	La Loyère	473	19	492
26	Bourgogne	71	1	24	266	Lucenay-l;Évêque	379	12	391
26	Bourgogne	71	5	25	267	Lugny	932	88	1020
26	Bourgogne	71	3	09	268	Lugny-lès-Charolles	336	13	349
26	Bourgogne	71	2	07	269	Lux	1829	57	1886
26	Bourgogne	71	5	99	270	Mâcon	34040	1078	35118
26	Bourgogne	71	3	46	271	Mailly	153	9	162
26	Bourgogne	71	5	41	272	Malay	250	11	261
26	Bourgogne	71	3	03	273	Maltat	284	6	290
26	Bourgogne	71	2	47	274	Mancey	389	17	406
26	Bourgogne	71	3	28	275	Marcigny	1908	49	1957
26	Bourgogne	71	3	09	276	Marcilly-la-Gueurce	126	3	129
26	Bourgogne	71	2	04	277	Marcilly-lès-Buxy	632	15	647
26	Bourgogne	71	2	36	278	Marigny	150	2	152
26	Bourgogne	71	3	21	279	Marizy	465	18	483
26	Bourgogne	71	1	22	280	Marly-sous-Issy	98	3	101
26	Bourgogne	71	3	48	281	Marly-sur-Arroux	333	15	348
26	Bourgogne	71	1	32	282	Marmagne	1249	42	1291
26	Bourgogne	71	2	07	283	Marnay	504	6	510
26	Bourgogne	71	5	49	284	Martailly-lès-Brancion	119	5	124
26	Bourgogne	71	3	37	285	Martigny-le-Comte	422	8	430
26	Bourgogne	71	2	36	286	Mary	228	2	230
26	Bourgogne	71	5	12	287	Massilly	374	15	389
26	Bourgogne	71	5	12	288	Massy	61	1	62
26	Bourgogne	71	5	29	289	Matour	1078	44	1122
26	Bourgogne	71	5	12	290	Mazille	399	70	469
26	Bourgogne	71	3	28	291	Melay	933	27	960
26	Bourgogne	71	2	19	292	Mellecey	1242	49	1291
26	Bourgogne	71	4	34	293	Ménetreuil	390	7	397
26	Bourgogne	71	2	19	294	Mercurey	1291	167	1458
26	Bourgogne	71	4	42	295	Mervans	1374	15	1389
26	Bourgogne	71	2	04	296	Messey-sur-Grosne	742	16	758
26	Bourgogne	71	1	30	297	Mesvres	789	19	808
26	Bourgogne	71	5	26	299	Milly-Lamartine	332	16	348
26	Bourgogne	71	4	15	300	Le Miroir	565	13	578
26	Bourgogne	71	3	03	301	Mont	195	2	197
26	Bourgogne	71	2	51	315	Mont-lès-Seurre	177	0	177
26	Bourgogne	71	2	36	320	Mont-Saint-Vincent	335	12	347
26	Bourgogne	71	2	04	302	Montagny-lès-Buxy	219	9	228
26	Bourgogne	71	4	23	303	Montagny-près-Louhans	479	9	488
26	Bourgogne	71	5	29	304	Montagny-sur-Grosne	90	2	92
26	Bourgogne	71	5	25	305	Montbellet	784	23	807
26	Bourgogne	71	2	97	306	Montceau-les-Mines	19372	483	19855
26	Bourgogne	71	3	28	307	Montceaux-l;Étoile	269	9	278
26	Bourgogne	71	2	47	308	Montceaux-Ragny	36	10	46
26	Bourgogne	71	1	32	309	Montcenis	2217	67	2284
26	Bourgogne	71	2	33	310	Montchanin	5478	102	5580
26	Bourgogne	71	4	02	311	Montcony	286	4	290
26	Bourgogne	71	2	45	312	Montcoy	274	2	276
26	Bourgogne	71	1	01	313	Monthelon	403	11	414
26	Bourgogne	71	4	39	314	Montjay	192	3	195
26	Bourgogne	71	5	29	316	Montmelard	322	8	330
26	Bourgogne	71	1	22	317	Montmort	207	2	209
26	Bourgogne	71	4	34	318	Montpont-en-Bresse	1114	23	1137
26	Bourgogne	71	4	35	319	Montret	779	9	788
26	Bourgogne	71	2	19	321	Morey	201	3	204
26	Bourgogne	71	1	18	322	Morlet	55	3	58
26	Bourgogne	71	3	40	323	Mornay	129	5	134
26	Bourgogne	71	2	04	324	Moroges	579	24	603
26	Bourgogne	71	3	17	325	La Motte-Saint-Jean	1179	42	1221
26	Bourgogne	71	4	39	326	Mouthier-en-Bresse	398	8	406
26	Bourgogne	71	3	10	327	Mussy-sous-Dun	371	10	381
26	Bourgogne	71	2	47	328	Nanton	600	16	616
26	Bourgogne	71	2	51	329	Navilly	413	6	419
26	Bourgogne	71	3	20	330	Neuvy-Grandchamp	788	31	819
26	Bourgogne	71	3	38	331	Nochize	95	2	97
26	Bourgogne	71	4	16	332	Ormes	517	10	527
26	Bourgogne	71	2	07	333	Oslon	1329	33	1362
26	Bourgogne	71	3	37	334	Oudry	384	11	395
26	Bourgogne	71	3	11	335	Ouroux-sous-le-Bois-Sainte-Marie	71	2	73
26	Bourgogne	71	2	43	336	Ouroux-sur-Saône	2987	50	3037
26	Bourgogne	71	3	46	337	Oyé	290	12	302
26	Bourgogne	71	5	49	338	Ozenay	219	9	228
26	Bourgogne	71	3	09	339	Ozolles	429	17	446
26	Bourgogne	71	3	37	340	Palinges	1526	49	1575
26	Bourgogne	71	2	51	341	Palleau	201	1	202
26	Bourgogne	71	3	38	342	Paray-le-Monial	9107	454	9561
26	Bourgogne	71	1	13	343	Paris-l;Hôpital	252	4	256
26	Bourgogne	71	5	41	344	Passy	60	1	61
26	Bourgogne	71	5	25	345	Péronne	580	21	601
26	Bourgogne	71	3	48	346	Perrecy-les-Forges	1746	37	1783
26	Bourgogne	71	1	13	347	Perreuil	511	5	516
26	Bourgogne	71	3	03	348	Perrigny-sur-Loire	147	3	150
26	Bourgogne	71	1	24	349	La Petite-Verrière	52	0	52
26	Bourgogne	71	4	39	351	Pierre-de-Bresse	1965	57	2022
26	Bourgogne	71	5	50	350	Pierreclos	915	24	939
26	Bourgogne	71	4	42	352	Le Planois	105	0	105
26	Bourgogne	71	5	49	353	Plottes	590	11	601
26	Bourgogne	71	3	38	354	Poisson	596	23	619
26	Bourgogne	71	2	51	355	Pontoux	230	5	235
26	Bourgogne	71	3	21	356	Pouilloux	1034	28	1062
26	Bourgogne	71	4	39	357	Pourlans	204	6	210
26	Bourgogne	71	3	40	358	Pressy-sous-Dondin	98	2	100
26	Bourgogne	71	5	49	359	Préty	562	31	593
26	Bourgogne	71	5	27	360	Prissé	1767	52	1819
26	Bourgogne	71	3	09	361	Prizy	65	2	67
26	Bourgogne	71	5	08	362	Pruzilly	262	8	270
26	Bourgogne	71	2	36	363	Le Puley	86	4	90
26	Bourgogne	71	4	39	364	La Racineuse	160	2	162
26	Bourgogne	71	4	16	365	Rancy	565	7	572
26	Bourgogne	71	5	49	366	Ratenelle	371	9	380
26	Bourgogne	71	4	23	367	Ratte	385	6	391
26	Bourgogne	71	1	24	368	Reclesne	305	13	318
26	Bourgogne	71	2	05	369	Remigny	440	7	447
26	Bourgogne	71	3	20	370	Rigny-sur-Arroux	654	13	667
26	Bourgogne	71	5	26	371	La Roche-Vineuse	1433	51	1484
26	Bourgogne	71	5	08	372	Romanèche-Thorins	1869	34	1903
26	Bourgogne	71	5	49	373	Romenay	1642	38	1680
26	Bourgogne	71	2	19	374	Rosey	165	4	169
26	Bourgogne	71	3	21	375	Le Rousset	253	9	262
26	Bourgogne	71	1	24	376	Roussillon-en-Morvan	277	6	283
26	Bourgogne	71	5	49	377	Royer	126	7	133
26	Bourgogne	71	2	05	378	Rully	1615	33	1648
26	Bourgogne	71	4	02	379	Sagy	1217	10	1227
26	Bourgogne	71	4	02	380	Saillenard	729	5	734
26	Bourgogne	71	5	41	381	Sailly	76	0	76
26	Bourgogne	71	3	17	382	Saint-Agnan	722	15	737
26	Bourgogne	71	5	25	383	Saint-Albain	532	21	553
26	Bourgogne	71	2	47	384	Saint-Ambreuil	533	9	542
26	Bourgogne	71	5	08	385	Saint-Amour-Bellevue	570	9	579
26	Bourgogne	71	4	35	386	Saint-André-en-Bresse	108	2	110
26	Bourgogne	71	5	12	387	Saint-André-le-Désert	257	10	267
26	Bourgogne	71	3	37	388	Saint-Aubin-en-Charollais	448	9	457
26	Bourgogne	71	3	03	389	Saint-Aubin-sur-Loire	317	3	320
26	Bourgogne	71	1	32	390	Saint-Berain-sous-Sanvignes	1030	44	1074
26	Bourgogne	71	2	19	391	Saint-Bérain-sur-Dheune	577	10	587
26	Bourgogne	71	2	04	392	Saint-Boil	471	10	481
26	Bourgogne	71	3	46	393	Saint-Bonnet-de-Cray	448	10	458
26	Bourgogne	71	3	40	394	Saint-Bonnet-de-Joux	798	33	831
26	Bourgogne	71	3	37	395	Saint-Bonnet-de-Vieille-Vigne	199	3	202
26	Bourgogne	71	4	39	396	Saint-Bonnet-en-Bresse	467	17	484
26	Bourgogne	71	2	43	398	Saint-Christophe-en-Bresse	986	9	995
26	Bourgogne	71	3	46	399	Saint-Christophe-en-Brionnais	490	14	504
26	Bourgogne	71	2	36	400	Saint-Clément-sur-Guye	131	6	137
26	Bourgogne	71	2	47	402	Saint-Cyr	742	16	758
26	Bourgogne	71	2	19	403	Saint-Denis-de-Vaux	277	6	283
26	Bourgogne	71	2	19	404	Saint-Désert	909	32	941
26	Bourgogne	71	2	45	405	Saint-Didier-en-Bresse	160	4	164
26	Bourgogne	71	3	46	406	Saint-Didier-en-Brionnais	148	3	151
26	Bourgogne	71	1	44	407	Saint-Didier-sur-Arroux	241	8	249
26	Bourgogne	71	3	10	408	Saint-Edmond	369	5	374
26	Bourgogne	71	1	13	409	Saint-Émiland	328	3	331
26	Bourgogne	71	4	35	410	Saint-Étienne-en-Bresse	845	22	867
26	Bourgogne	71	1	30	411	Saint-Eugène	174	6	180
26	Bourgogne	71	2	33	412	Saint-Eusèbe	1092	31	1123
26	Bourgogne	71	1	14	413	Saint-Firmin	809	30	839
26	Bourgogne	71	1	01	414	Saint-Forgeot	496	17	513
26	Bourgogne	71	5	25	416	Saint-Gengoux-de-Scissé	597	12	609
26	Bourgogne	71	5	41	417	Saint-Gengoux-le-National	1049	33	1082
26	Bourgogne	71	4	42	419	Saint-Germain-du-Bois	1931	54	1985
26	Bourgogne	71	2	43	420	Saint-Germain-du-Plain	2176	38	2214
26	Bourgogne	71	3	11	421	Saint-Germain-en-Brionnais	187	5	192
26	Bourgogne	71	2	04	422	Saint-Germain-lès-Buxy	273	9	282
26	Bourgogne	71	2	51	423	Saint-Gervais-en-Vallière	420	7	427
26	Bourgogne	71	1	18	424	Saint-Gervais-sur-Couches	212	4	216
26	Bourgogne	71	2	05	425	Saint-Gilles	320	6	326
26	Bourgogne	71	5	41	427	Saint-Huruge	63	1	64
26	Bourgogne	71	3	10	428	Saint-Igny-de-Roche	730	18	748
26	Bourgogne	71	1	13	431	Saint-Jean-de-Trézy	315	7	322
26	Bourgogne	71	2	19	430	Saint-Jean-de-Vaux	399	13	412
26	Bourgogne	71	3	09	433	Saint-Julien-de-Civry	503	22	525
26	Bourgogne	71	3	46	434	Saint-Julien-de-Jonzy	292	9	301
26	Bourgogne	71	2	33	435	Saint-Julien-sur-Dheune	248	1	249
26	Bourgogne	71	2	33	436	Saint-Laurent-d;Andenay	1073	27	1100
26	Bourgogne	71	3	11	437	Saint-Laurent-en-Brionnais	363	25	388
26	Bourgogne	71	1	18	438	Saint-Léger-du-Bois	556	14	570
26	Bourgogne	71	3	38	439	Saint-Léger-lès-Paray	634	23	657
26	Bourgogne	71	1	44	440	Saint-Léger-sous-Beuvray	474	8	482
26	Bourgogne	71	5	50	441	Saint-Léger-sous-la-Bussière	261	7	268
26	Bourgogne	71	2	05	442	Saint-Léger-sur-Dheune	1552	38	1590
26	Bourgogne	71	2	07	444	Saint-Loup-de-Varennes	1131	26	1157
26	Bourgogne	71	2	51	443	Saint-Loup-Géanges	1563	33	1596
26	Bourgogne	71	2	07	445	Saint-Marcel	5812	252	6064
26	Bourgogne	71	3	21	446	Saint-Marcelin-de-Cray	182	2	184
26	Bourgogne	71	2	19	447	Saint-Mard-de-Vaux	279	21	300
26	Bourgogne	71	5	26	448	Saint-Martin-Belle-Roche	1297	31	1328
26	Bourgogne	71	2	04	449	Saint-Martin-d;Auxy	90	5	95
26	Bourgogne	71	1	13	450	Saint-Martin-de-Commune	118	2	120
26	Bourgogne	71	3	10	451	Saint-Martin-de-Lixy	91	2	93
26	Bourgogne	71	3	21	452	Saint-Martin-de-Salencey	103	3	106
26	Bourgogne	71	3	28	453	Saint-Martin-du-Lac	259	12	271
26	Bourgogne	71	4	02	454	Saint-Martin-du-Mont	217	7	224
26	Bourgogne	71	2	04	455	Saint-Martin-du-Tartre	158	4	162
26	Bourgogne	71	2	45	456	Saint-Martin-en-Bresse	1866	55	1921
26	Bourgogne	71	2	51	457	Saint-Martin-en-Gâtinois	115	3	118
26	Bourgogne	71	3	21	458	Saint-Martin-la-Patrouille	53	2	55
26	Bourgogne	71	2	19	459	Saint-Martin-sous-Montaigu	331	19	350
26	Bourgogne	71	5	25	460	Saint-Maurice-de-Satonnay	416	9	425
26	Bourgogne	71	2	04	461	Saint-Maurice-des-Champs	61	4	65
26	Bourgogne	71	2	45	462	Saint-Maurice-en-Rivière	554	8	562
26	Bourgogne	71	3	10	463	Saint-Maurice-lès-Châteauneuf	583	11	594
26	Bourgogne	71	1	13	464	Saint-Maurice-lès-Couches	169	2	171
26	Bourgogne	71	2	36	465	Saint-Micaud	253	7	260
26	Bourgogne	71	1	30	466	Saint-Nizier-sur-Arroux	118	1	119
26	Bourgogne	71	1	13	468	Saint-Pierre-de-Varennes	822	31	853
26	Bourgogne	71	5	50	469	Saint-Pierre-le-Vieux	340	17	357
26	Bourgogne	71	5	50	470	Saint-Point	344	17	361
26	Bourgogne	71	2	04	471	Saint-Privé	84	2	86
26	Bourgogne	71	1	44	472	Saint-Prix	211	9	220
26	Bourgogne	71	3	11	473	Saint-Racho	174	6	180
26	Bourgogne	71	2	07	475	Saint-Rémy	6109	207	6316
26	Bourgogne	71	2	36	477	Saint-Romain-sous-Gourdon	506	25	531
26	Bourgogne	71	3	48	478	Saint-Romain-sous-Versigny	102	2	104
26	Bourgogne	71	1	14	479	Saint-Sernin-du-Bois	1808	36	1844
26	Bourgogne	71	1	13	480	Saint-Sernin-du-Plain	630	16	646
26	Bourgogne	71	5	08	481	Saint-Symphorien-d;Ancelles	1069	25	1094
26	Bourgogne	71	1	32	482	Saint-Symphorien-de-Marmagne	861	20	881
26	Bourgogne	71	3	11	483	Saint-Symphorien-des-Bois	409	16	425
26	Bourgogne	71	4	23	484	Saint-Usuge	1230	18	1248
26	Bourgogne	71	2	04	485	Saint-Vallerin	271	13	284
26	Bourgogne	71	2	56	486	Saint-Vallier	9049	283	9332
26	Bourgogne	71	5	08	487	Saint-Vérand	178	5	183
26	Bourgogne	71	3	37	490	Saint-Vincent-Bragny	982	39	1021
26	Bourgogne	71	5	12	488	Saint-Vincent-des-Prés	119	8	127
26	Bourgogne	71	4	35	489	Saint-Vincent-en-Bresse	506	14	520
26	Bourgogne	71	3	38	491	Saint-Yan	1124	35	1159
26	Bourgogne	71	5	41	492	Saint-Ythaire	132	8	140
26	Bourgogne	71	5	12	397	Sainte-Cécile	283	11	294
26	Bourgogne	71	4	34	401	Sainte-Croix	586	10	596
26	Bourgogne	71	3	46	415	Sainte-Foy	124	5	129
26	Bourgogne	71	2	04	426	Sainte-Hélène	450	7	457
26	Bourgogne	71	1	22	474	Sainte-Radegonde	178	3	181
26	Bourgogne	71	1	18	493	Saisy	312	9	321
26	Bourgogne	71	5	25	494	La Salle	561	18	579
26	Bourgogne	71	5	12	495	Salornay-sur-Guye	834	39	873
26	Bourgogne	71	1	13	496	Sampigny-lès-Maranges	162	3	165
26	Bourgogne	71	5	26	497	Sancé	1881	74	1955
26	Bourgogne	71	2	04	498	Santilly	141	2	143
26	Bourgogne	71	3	48	499	Sanvignes-les-Mines	4373	120	4493
26	Bourgogne	71	3	46	500	Sarry	120	8	128
26	Bourgogne	71	2	04	501	Sassangy	169	7	176
26	Bourgogne	71	2	53	502	Sassenay	1553	49	1602
26	Bourgogne	71	2	04	503	Saules	124	4	128
26	Bourgogne	71	2	51	504	Saunières	87	2	89
26	Bourgogne	71	2	04	505	Savianges	76	4	80
26	Bourgogne	71	4	02	506	Savigny-en-Revermont	1180	33	1213
26	Bourgogne	71	5	41	507	Savigny-sur-Grosne	174	7	181
26	Bourgogne	71	4	35	508	Savigny-sur-Seille	459	4	463
26	Bourgogne	71	3	46	510	Semur-en-Brionnais	609	23	632
26	Bourgogne	71	2	47	512	Sennecey-le-Grand	3101	65	3166
26	Bourgogne	71	5	26	513	Senozan	1109	27	1136
26	Bourgogne	71	4	42	514	Sens-sur-Seille	353	1	354
26	Bourgogne	71	2	04	515	Sercy	99	4	103
26	Bourgogne	71	4	42	516	Serley	574	2	576
26	Bourgogne	71	2	51	517	Sermesse	232	4	236
26	Bourgogne	71	5	50	518	Serrières	292	10	302
26	Bourgogne	71	4	42	519	Serrigny-en-Bresse	192	2	194
26	Bourgogne	71	2	07	520	Sevrey	1421	36	1457
26	Bourgogne	71	5	41	521	Sigy-le-Châtel	91	5	96
26	Bourgogne	71	4	16	522	Simandre	1628	21	1649
26	Bourgogne	71	4	35	523	Simard	1148	9	1157
26	Bourgogne	71	3	40	524	Sivignon	168	13	181
26	Bourgogne	71	5	26	525	Sologny	560	25	585
26	Bourgogne	71	5	27	526	Solutré-Pouilly	370	23	393
26	Bourgogne	71	1	24	527	Sommant	207	5	212
26	Bourgogne	71	4	23	528	Sornay	1961	57	2018
26	Bourgogne	71	3	40	529	Suin	284	13	297
26	Bourgogne	71	1	18	530	Sully	544	22	566
26	Bourgogne	71	1	30	531	La Tagnière	249	8	257
26	Bourgogne	71	5	41	532	Taizé	187	6	193
26	Bourgogne	71	3	10	533	Tancon	583	13	596
26	Bourgogne	71	4	42	534	Le Tartre	121	2	123
26	Bourgogne	71	1	01	535	Tavernay	513	8	521
26	Bourgogne	71	1	44	537	Thil-sur-Arroux	150	3	153
26	Bourgogne	71	4	42	538	Thurey	427	5	432
26	Bourgogne	71	1	18	539	Tintry	80	5	85
26	Bourgogne	71	1	32	540	Torcy	3097	65	3162
26	Bourgogne	71	4	39	541	Torpes	394	8	402
26	Bourgogne	71	3	48	542	Toulon-sur-Arroux	1618	36	1654
26	Bourgogne	71	5	49	543	Tournus	5849	384	6233
26	Bourgogne	71	2	51	544	Toutenant	185	1	186
26	Bourgogne	71	5	50	545	Tramayes	978	19	997
26	Bourgogne	71	5	29	546	Trambly	401	7	408
26	Bourgogne	71	5	29	547	Trivy	272	3	275
26	Bourgogne	71	2	43	548	Tronchy	238	0	238
26	Bourgogne	71	5	49	549	La Truchère	204	4	208
26	Bourgogne	71	5	49	550	Uchizy	788	24	812
26	Bourgogne	71	1	30	551	Uchon	97	4	101
26	Bourgogne	71	3	20	552	Uxeau	523	14	537
26	Bourgogne	71	3	11	553	Vareilles	234	4	238
26	Bourgogne	71	3	46	554	Varenne-l;Arconce	128	1	129
26	Bourgogne	71	3	17	557	Varenne-Saint-Germain	675	28	703
26	Bourgogne	71	2	07	555	Varennes-le-Grand	2336	28	2364
26	Bourgogne	71	5	27	556	Varennes-lès-Mâcon	554	22	576
26	Bourgogne	71	4	15	558	Varennes-Saint-Sauveur	1168	39	1207
26	Bourgogne	71	3	11	559	Varennes-sous-Dun	591	24	615
26	Bourgogne	71	3	11	561	Vauban	235	13	248
26	Bourgogne	71	3	09	562	Vaudebarrier	237	39	276
26	Bourgogne	71	2	36	563	Vaux-en-Pré	102	5	107
26	Bourgogne	71	3	09	564	Vendenesse-lès-Charolles	797	13	810
26	Bourgogne	71	3	20	565	Vendenesse-sur-Arroux	590	12	602
26	Bourgogne	71	2	51	566	Verdun-sur-le-Doubs	1138	23	1161
26	Bourgogne	71	5	27	567	Vergisson	245	12	257
26	Bourgogne	71	4	35	568	Vérissey	51	2	53
26	Bourgogne	71	2	51	570	Verjux	522	10	532
26	Bourgogne	71	3	40	571	Verosvres	437	91	528
26	Bourgogne	71	2	47	572	Vers	204	8	212
26	Bourgogne	71	3	38	573	Versaugues	207	9	216
26	Bourgogne	71	5	26	574	Verzé	729	22	751
26	Bourgogne	71	5	49	576	Le Villars	261	7	268
26	Bourgogne	71	2	45	577	Villegaudin	202	2	204
26	Bourgogne	71	2	51	578	La Villeneuve	220	6	226
26	Bourgogne	71	2	04	579	Villeneuve-en-Montagne	154	4	158
26	Bourgogne	71	4	23	580	Vincelles	424	14	438
26	Bourgogne	71	3	28	581	Vindecy	260	6	266
26	Bourgogne	71	5	12	582	La Vineuse	294	10	304
26	Bourgogne	71	5	27	583	Vinzelles	733	27	760
26	Bourgogne	71	5	25	584	Viré	1104	32	1136
26	Bourgogne	71	2	53	585	Virey-le-Grand	1281	71	1352
26	Bourgogne	71	3	09	586	Viry	247	6	253
26	Bourgogne	71	3	38	588	Vitry-en-Charollais	1117	24	1141
26	Bourgogne	71	5	12	587	Vitry-lès-Cluny	67	1	68
26	Bourgogne	71	3	03	589	Vitry-sur-Loire	456	6	462
26	Bourgogne	71	3	38	590	Volesvres	610	26	636
52	Pays de la Loire	72	3	34	001	Aigné	1546	31	1577
52	Pays de la Loire	72	2	11	002	Aillières-Beauvoir	215	9	224
52	Pays de la Loire	72	3	40	003	Allonnes	11064	138	11202
52	Pays de la Loire	72	1	15	004	Amné	505	4	509
52	Pays de la Loire	72	2	29	005	Ancinnes	896	33	929
52	Pays de la Loire	72	2	24	007	Ardenay-sur-Mérize	488	3	491
52	Pays de la Loire	72	3	36	008	Arnage	5118	302	5420
52	Pays de la Loire	72	1	17	009	Arthezé	375	7	382
52	Pays de la Loire	72	2	29	006	Arçonnay	1852	195	2047
52	Pays de la Loire	72	1	27	010	Asnières-sur-Vègre	406	17	423
52	Pays de la Loire	72	2	12	011	Assé-le-Boisne	898	17	915
52	Pays de la Loire	72	2	02	012	Assé-le-Riboul	483	4	487
52	Pays de la Loire	72	1	23	013	Aubigné-Racan	2076	36	2112
52	Pays de la Loire	72	2	11	015	Les Aulneaux	106	1	107
52	Pays de la Loire	72	1	27	016	Auvers-le-Hamon	1524	44	1568
52	Pays de la Loire	72	1	15	017	Auvers-sous-Montfaucon	237	1	238
52	Pays de la Loire	72	2	22	018	Avesnes-en-Saosnois	103	2	105
52	Pays de la Loire	72	1	05	019	Avessé	376	3	379
52	Pays de la Loire	72	2	10	020	Avezé	757	21	778
52	Pays de la Loire	72	1	27	021	Avoise	539	9	548
52	Pays de la Loire	72	1	17	022	Le Bailleul	1234	17	1251
52	Pays de la Loire	72	3	01	023	Ballon	1262	21	1283
52	Pays de la Loire	72	3	34	024	La Bazoge	3630	74	3704
52	Pays de la Loire	72	1	14	025	Bazouges-sur-le-Loir	1195	44	1239
52	Pays de la Loire	72	3	01	026	Beaufay	1359	20	1379
52	Pays de la Loire	72	1	07	028	Beaumont-Pied-de-Boeuf	495	14	509
52	Pays de la Loire	72	1	06	027	Beaumont-sur-Dême	350	7	357
52	Pays de la Loire	72	2	02	029	Beaumont-sur-Sarthe	2097	23	2120
52	Pays de la Loire	72	2	32	031	Beillé	517	3	520
52	Pays de la Loire	72	2	33	032	Berfay	364	5	369
52	Pays de la Loire	72	2	08	033	Bernay-en-Champagne	458	79	537
52	Pays de la Loire	72	2	29	034	Bérus	432	15	447
52	Pays de la Loire	72	2	28	035	Bessé-sur-Braye	2322	47	2369
52	Pays de la Loire	72	2	29	036	Béthon	339	6	345
52	Pays de la Loire	72	2	11	037	Blèves	95	3	98
52	Pays de la Loire	72	2	32	038	Boëssé-le-Sec	632	6	638
52	Pays de la Loire	72	2	03	039	Bonnétable	3994	42	4036
52	Pays de la Loire	72	2	32	040	La Bosse	118	2	120
52	Pays de la Loire	72	2	32	041	Bouër	310	3	313
52	Pays de la Loire	72	2	04	042	Bouloire	2042	59	2101
52	Pays de la Loire	72	2	29	043	Bourg-le-Roi	324	8	332
52	Pays de la Loire	72	1	17	044	Bousse	441	8	449
52	Pays de la Loire	72	1	15	045	Brains-sur-Gée	705	4	709
52	Pays de la Loire	72	2	24	046	Le Breil-sur-Mérize	1475	26	1501
52	Pays de la Loire	72	3	09	047	Brette-les-Pins	2105	107	2212
52	Pays de la Loire	72	2	03	048	Briosne-lès-Sables	513	4	517
52	Pays de la Loire	72	1	16	049	La Bruère-sur-Loir	266	55	321
52	Pays de la Loire	72	1	05	050	Brûlon	1540	37	1577
52	Pays de la Loire	72	1	26	051	Cérans-Foulletourte	3242	50	3292
52	Pays de la Loire	72	1	06	052	Chahaignes	766	25	791
52	Pays de la Loire	72	3	37	053	Challes	1214	19	1233
52	Pays de la Loire	72	2	24	054	Champagné	3757	84	3841
52	Pays de la Loire	72	2	29	056	Champfleur	1421	31	1452
52	Pays de la Loire	72	2	25	057	Champrond	82	4	86
52	Pays de la Loire	72	3	37	058	Changé	6164	230	6394
52	Pays de la Loire	72	1	05	059	Chantenay-Villedieu	884	12	896
52	Pays de la Loire	72	1	16	060	La Chapelle-aux-Choux	276	5	281
52	Pays de la Loire	72	1	14	061	La Chapelle-d;Aligné	1543	22	1565
52	Pays de la Loire	72	2	10	062	La Chapelle-du-Bois	888	20	908
52	Pays de la Loire	72	1	06	063	La Chapelle-Gaugain	324	7	331
52	Pays de la Loire	72	2	28	064	La Chapelle-Huon	549	23	572
52	Pays de la Loire	72	3	34	065	La Chapelle-Saint-Aubin	2138	74	2212
52	Pays de la Loire	72	2	08	066	La Chapelle-Saint-Fray	421	8	429
52	Pays de la Loire	72	2	32	067	La Chapelle-Saint-Rémy	894	16	910
52	Pays de la Loire	72	1	06	068	La Chartre-sur-le-Loir	1461	32	1493
52	Pays de la Loire	72	2	11	069	Chassé	174	4	178
52	Pays de la Loire	72	1	15	070	Chassillé	264	5	269
52	Pays de la Loire	72	1	07	071	Château-du-Loir	4732	249	4981
52	Pays de la Loire	72	1	26	072	Château-l;Hermitage	251	2	253
52	Pays de la Loire	72	3	40	073	Chaufour-Notre-Dame	1097	18	1115
52	Pays de la Loire	72	1	15	074	Chemiré-en-Charnie	211	1	212
52	Pays de la Loire	72	1	31	075	Chemiré-le-Gaudin	930	17	947
52	Pays de la Loire	72	2	11	076	Chenay	202	3	205
52	Pays de la Loire	72	1	16	077	Chenu	426	44	470
52	Pays de la Loire	72	2	02	078	Chérancé	383	7	390
52	Pays de la Loire	72	2	29	079	Chérisay	308	3	311
52	Pays de la Loire	72	2	10	080	Cherré	1708	61	1769
52	Pays de la Loire	72	2	10	081	Cherreau	858	37	895
52	Pays de la Loire	72	2	29	082	Le Chevain	623	15	638
52	Pays de la Loire	72	1	05	083	Chevillé	406	7	413
52	Pays de la Loire	72	1	14	084	Clermont-Créans	1256	10	1266
52	Pays de la Loire	72	2	28	085	Cogners	195	7	202
52	Pays de la Loire	72	2	18	086	Commerveil	125	2	127
52	Pays de la Loire	72	2	28	087	Conflans-sur-Anille	569	5	574
52	Pays de la Loire	72	2	22	088	Congé-sur-Orne	327	7	334
52	Pays de la Loire	72	2	08	089	Conlie	1869	33	1902
52	Pays de la Loire	72	2	24	090	Connerré	2926	63	2989
52	Pays de la Loire	72	2	18	091	Contilly	144	5	149
52	Pays de la Loire	72	2	10	093	Cormes	886	25	911
52	Pays de la Loire	72	2	04	094	Coudrecieux	623	16	639
52	Pays de la Loire	72	3	38	095	Coulaines	7447	181	7628
52	Pays de la Loire	72	1	15	096	Coulans-sur-Gée	1555	91	1646
52	Pays de la Loire	72	2	02	097	Coulombiers	428	6	434
52	Pays de la Loire	72	1	23	098	Coulongé	572	12	584
52	Pays de la Loire	72	3	01	099	Courceboeufs	602	9	611
52	Pays de la Loire	72	1	17	100	Courcelles-la-Forêt	425	9	434
52	Pays de la Loire	72	3	01	101	Courcemont	680	12	692
52	Pays de la Loire	72	2	03	102	Courcival	86	0	86
52	Pays de la Loire	72	1	13	103	Courdemanche	640	8	648
52	Pays de la Loire	72	2	22	104	Courgains	597	17	614
52	Pays de la Loire	72	2	25	105	Courgenard	476	9	485
52	Pays de la Loire	72	1	27	106	Courtillers	906	31	937
52	Pays de la Loire	72	1	15	107	Crannes-en-Champagne	354	7	361
52	Pays de la Loire	72	1	14	108	Cré	803	10	813
52	Pays de la Loire	72	2	30	109	Crissé	552	8	560
52	Pays de la Loire	72	1	14	110	Crosmières	969	16	985
52	Pays de la Loire	72	2	08	111	Cures	529	12	541
52	Pays de la Loire	72	2	22	112	Dangeul	498	7	505
52	Pays de la Loire	72	2	08	113	Degré	740	16	756
52	Pays de la Loire	72	2	10	114	Dehault	282	9	291
52	Pays de la Loire	72	1	07	115	Dissay-sous-Courcillon	1009	11	1020
52	Pays de la Loire	72	2	22	116	Dissé-sous-Ballon	134	1	135
52	Pays de la Loire	72	1	16	117	Dissé-sous-le-Lude	579	11	590
52	Pays de la Loire	72	2	33	118	Dollon	1482	19	1501
52	Pays de la Loire	72	2	08	119	Domfront-en-Champagne	971	24	995
52	Pays de la Loire	72	2	02	120	Doucelles	241	8	249
52	Pays de la Loire	72	2	12	121	Douillet	316	5	321
52	Pays de la Loire	72	2	32	122	Duneau	1023	16	1039
52	Pays de la Loire	72	1	17	123	Dureil	68	0	68
52	Pays de la Loire	72	3	09	124	Écommoy	4695	59	4754
52	Pays de la Loire	72	2	28	125	Écorpain	318	10	328
52	Pays de la Loire	72	1	15	126	Épineu-le-Chevreuil	286	7	293
52	Pays de la Loire	72	1	31	127	Étival-lès-le-Mans	2041	37	2078
52	Pays de la Loire	72	2	28	128	Évaillé	398	8	406
52	Pays de la Loire	72	2	24	129	Fatines	760	16	776
52	Pays de la Loire	72	3	40	130	Fay	606	6	612
52	Pays de la Loire	72	1	31	131	Fercé-sur-Sarthe	639	4	643
52	Pays de la Loire	72	2	10	132	La Ferté-Bernard	9235	341	9576
52	Pays de la Loire	72	1	31	133	Fillé	1516	28	1544
52	Pays de la Loire	72	1	14	154	La Flèche	15087	1162	16249
52	Pays de la Loire	72	1	07	134	Flée	558	11	569
52	Pays de la Loire	72	1	26	135	La Fontaine-Saint-Martin	614	3	617
52	Pays de la Loire	72	1	05	136	Fontenay-sur-Vègre	336	11	347
52	Pays de la Loire	72	2	12	138	Fresnay-sur-Sarthe	2173	33	2206
52	Pays de la Loire	72	2	11	137	La Fresnaye-sur-Chédouet	945	20	965
52	Pays de la Loire	72	2	29	139	Fyé	1031	60	1091
52	Pays de la Loire	72	2	29	141	Gesnes-le-Gandelin	968	23	991
52	Pays de la Loire	72	1	13	143	Le Grand-Lucé	2043	23	2066
52	Pays de la Loire	72	2	29	142	Grandchamp	166	4	170
52	Pays de la Loire	72	2	25	144	Gréez-sur-Roc	384	4	388
52	Pays de la Loire	72	2	30	145	Le Grez	389	18	407
52	Pays de la Loire	72	1	31	146	Guécélard	2755	41	2796
52	Pays de la Loire	72	3	01	147	La Guierche	1086	20	1106
52	Pays de la Loire	72	2	03	148	Jauzé	94	2	96
52	Pays de la Loire	72	1	15	149	Joué-en-Charnie	629	10	639
52	Pays de la Loire	72	3	01	150	Joué-l;Abbé	1251	23	1274
52	Pays de la Loire	72	1	27	151	Juigné-sur-Sarthe	1184	35	1219
52	Pays de la Loire	72	2	02	152	Juillé	472	8	480
52	Pays de la Loire	72	1	07	153	Jupilles	573	16	589
52	Pays de la Loire	72	3	09	155	Laigné-en-Belin	2332	71	2403
52	Pays de la Loire	72	2	25	156	Lamnay	926	22	948
52	Pays de la Loire	72	2	08	157	Lavardin	740	13	753
52	Pays de la Loire	72	2	33	158	Lavaré	841	4	845
52	Pays de la Loire	72	1	06	159	Lavenay	366	9	375
52	Pays de la Loire	72	1	23	160	Lavernat	635	21	656
52	Pays de la Loire	72	1	06	161	Lhomme	910	26	936
52	Pays de la Loire	72	2	11	162	Lignières-la-Carelle	409	10	419
52	Pays de la Loire	72	1	17	163	Ligron	481	8	489
52	Pays de la Loire	72	2	29	164	Livet-en-Saosnois	76	0	76
52	Pays de la Loire	72	2	24	165	Lombron	1961	23	1984
52	Pays de la Loire	72	1	15	166	Longnes	360	10	370
52	Pays de la Loire	72	1	27	167	Louailles	769	5	774
52	Pays de la Loire	72	1	15	168	Loué	2139	40	2179
52	Pays de la Loire	72	1	31	169	Louplande	1517	20	1537
52	Pays de la Loire	72	2	18	170	Louvigny	183	4	187
52	Pays de la Loire	72	2	11	171	Louzes	103	3	106
52	Pays de la Loire	72	2	32	172	Le Luart	1381	22	1403
52	Pays de la Loire	72	2	22	174	Lucé-sous-Ballon	109	5	114
52	Pays de la Loire	72	1	07	173	Luceau	1280	27	1307
52	Pays de la Loire	72	1	16	175	Luché-Pringé	1665	24	1689
52	Pays de la Loire	72	1	16	176	Le Lude	4049	84	4133
52	Pays de la Loire	72	1	05	177	Maigné	344	10	354
52	Pays de la Loire	72	2	04	178	Maisoncelles	193	4	197
52	Pays de la Loire	72	1	17	179	Malicorne-sur-Sarthe	1970	31	2001
52	Pays de la Loire	72	2	18	180	Mamers	5473	210	5683
52	Pays de la Loire	72	3	99	181	Le Mans	142626	4482	147108
52	Pays de la Loire	72	1	26	182	Mansigné	1583	22	1605
52	Pays de la Loire	72	1	05	184	Mareil-en-Champagne	327	4	331
52	Pays de la Loire	72	1	14	185	Mareil-sur-Loir	623	10	633
52	Pays de la Loire	72	2	02	186	Maresché	869	14	883
52	Pays de la Loire	72	3	09	187	Marigné-Laillé	1539	83	1622
52	Pays de la Loire	72	2	22	189	Marolles-les-Braults	2155	61	2216
52	Pays de la Loire	72	2	28	190	Marolles-lès-Saint-Calais	275	7	282
52	Pays de la Loire	72	2	18	188	Marollette	137	10	147
52	Pays de la Loire	72	1	06	183	Marçon	1024	16	1040
52	Pays de la Loire	72	1	23	191	Mayet	3191	51	3242
52	Pays de la Loire	72	2	18	192	Les Mées	100	1	101
52	Pays de la Loire	72	2	25	193	Melleray	485	4	489
52	Pays de la Loire	72	2	22	194	Meurcé	303	4	307
52	Pays de la Loire	72	1	17	195	Mézeray	1824	32	1856
52	Pays de la Loire	72	2	08	197	Mézières-sous-Lavardin	659	7	666
52	Pays de la Loire	72	2	22	196	Mézières-sur-Ponthouin	673	3	676
52	Pays de la Loire	72	3	34	198	La Milesse	2385	54	2439
52	Pays de la Loire	72	2	12	199	Moitron-sur-Sarthe	229	7	236
52	Pays de la Loire	72	3	09	200	Moncé-en-Belin	3425	57	3482
52	Pays de la Loire	72	2	22	201	Moncé-en-Saosnois	266	5	271
52	Pays de la Loire	72	2	22	202	Monhoudou	209	10	219
52	Pays de la Loire	72	2	30	211	Mont-Saint-Jean	669	11	680
52	Pays de la Loire	72	1	07	203	Montabon	785	27	812
52	Pays de la Loire	72	2	28	204	Montaillé	585	9	594
52	Pays de la Loire	72	3	01	205	Montbizot	1706	27	1733
52	Pays de la Loire	72	2	24	241	Montfort-le-Gesnois	3083	59	3142
52	Pays de la Loire	72	2	11	207	Montigny	40	0	40
52	Pays de la Loire	72	2	25	208	Montmirail	404	5	409
52	Pays de la Loire	72	2	12	209	Montreuil-le-Chétif	311	7	318
52	Pays de la Loire	72	1	13	210	Montreuil-le-Henri	256	10	266
52	Pays de la Loire	72	2	29	212	Moulins-le-Carbonnel	730	16	746
52	Pays de la Loire	72	3	09	213	Mulsanne	4402	64	4466
52	Pays de la Loire	72	2	22	214	Nauvay	15	2	17
52	Pays de la Loire	72	2	11	215	Neufchâtel-en-Saosnois	978	13	991
52	Pays de la Loire	72	2	08	216	Neuvillalais	579	8	587
52	Pays de la Loire	72	3	38	217	Neuville-sur-Sarthe	2386	55	2441
52	Pays de la Loire	72	2	30	218	Neuvillette-en-Charnie	304	5	309
52	Pays de la Loire	72	2	08	219	Neuvy-en-Champagne	378	4	382
52	Pays de la Loire	72	2	03	220	Nogent-le-Bernard	899	64	963
52	Pays de la Loire	72	1	07	221	Nogent-sur-Loir	413	6	419
52	Pays de la Loire	72	1	27	232	Notre-Dame-du-Pé	588	6	594
52	Pays de la Loire	72	2	22	222	Nouans	284	3	287
52	Pays de la Loire	72	1	17	223	Noyen-sur-Sarthe	2611	36	2647
52	Pays de la Loire	72	2	24	224	Nuillé-le-Jalais	488	5	493
52	Pays de la Loire	72	2	29	225	Oisseau-le-Petit	704	14	718
52	Pays de la Loire	72	1	26	226	Oizé	1202	14	1216
52	Pays de la Loire	72	2	18	227	Panon	38	2	40
52	Pays de la Loire	72	1	27	228	Parcé-sur-Sarthe	2077	43	2120
52	Pays de la Loire	72	2	30	229	Parennes	556	3	559
52	Pays de la Loire	72	3	37	231	Parigné-l;Évêque	4794	75	4869
52	Pays de la Loire	72	1	31	230	Parigné-le-Pôlin	1079	96	1175
52	Pays de la Loire	72	2	22	233	Peray	63	2	65
52	Pays de la Loire	72	2	30	234	Pezé-le-Robert	365	10	375
52	Pays de la Loire	72	2	02	235	Piacé	361	11	372
52	Pays de la Loire	72	1	27	236	Pincé	196	9	205
52	Pays de la Loire	72	1	05	237	Pirmil	481	7	488
52	Pays de la Loire	72	2	18	238	Pizieux	88	1	89
52	Pays de la Loire	72	1	05	239	Poillé-sur-Vègre	654	17	671
52	Pays de la Loire	72	1	06	240	Poncé-sur-le-Loir	382	14	396
52	Pays de la Loire	72	1	26	243	Pontvallain	1654	19	1673
52	Pays de la Loire	72	1	27	244	Précigné	3141	66	3207
52	Pays de la Loire	72	2	10	245	Préval	647	13	660
52	Pays de la Loire	72	2	32	246	Prévelles	231	3	234
52	Pays de la Loire	72	1	13	248	Pruillé-l;Éguillé	787	11	798
52	Pays de la Loire	72	3	40	247	Pruillé-le-Chétif	1248	26	1274
52	Pays de la Loire	72	2	08	249	La Quinte	832	6	838
52	Pays de la Loire	72	2	28	250	Rahay	195	5	200
52	Pays de la Loire	72	2	22	251	René	377	2	379
52	Pays de la Loire	72	1	26	252	Requeil	1199	17	1216
52	Pays de la Loire	72	1	31	253	Roézé-sur-Sarthe	2815	45	2860
52	Pays de la Loire	72	2	29	254	Rouessé-Fontaine	267	3	270
52	Pays de la Loire	72	2	30	255	Rouessé-Vassé	802	18	820
52	Pays de la Loire	72	2	30	256	Rouez	781	19	800
52	Pays de la Loire	72	3	40	257	Rouillon	2201	222	2423
52	Pays de la Loire	72	2	11	258	Roullée	249	4	253
52	Pays de la Loire	72	2	03	259	Rouperroux-le-Coquet	324	2	326
52	Pays de la Loire	72	3	35	260	Ruaudin	3325	66	3391
52	Pays de la Loire	72	2	08	261	Ruillé-en-Champagne	316	9	325
52	Pays de la Loire	72	1	06	262	Ruillé-sur-Loir	1173	124	1297
52	Pays de la Loire	72	1	27	264	Sablé-sur-Sarthe	12466	523	12989
52	Pays de la Loire	72	2	22	265	Saint-Aignan	247	7	254
52	Pays de la Loire	72	2	12	266	Saint-Aubin-de-Locquenay	705	8	713
52	Pays de la Loire	72	2	10	267	Saint-Aubin-des-Coudrais	952	22	974
52	Pays de la Loire	72	3	09	268	Saint-Biez-en-Belin	721	13	734
52	Pays de la Loire	72	2	28	269	Saint-Calais	3419	224	3643
52	Pays de la Loire	72	2	18	270	Saint-Calez-en-Saosnois	170	4	174
52	Pays de la Loire	72	2	24	271	Saint-Célerin	766	13	779
52	Pays de la Loire	72	2	02	273	Saint-Christophe-du-Jambet	209	6	215
52	Pays de la Loire	72	1	05	274	Saint-Christophe-en-Champagne	197	2	199
52	Pays de la Loire	72	2	24	275	Saint-Corneille	1130	15	1145
52	Pays de la Loire	72	2	18	276	Saint-Cosme-en-Vairais	2005	39	2044
52	Pays de la Loire	72	1	15	278	Saint-Denis-d;Orques	894	14	908
52	Pays de la Loire	72	2	32	277	Saint-Denis-des-Coudrais	120	3	123
52	Pays de la Loire	72	1	13	279	Saint-Georges-de-la-Couée	173	4	177
52	Pays de la Loire	72	3	40	280	Saint-Georges-du-Bois	1813	32	1845
52	Pays de la Loire	72	2	03	281	Saint-Georges-du-Rosay	430	2	432
52	Pays de la Loire	72	2	12	282	Saint-Georges-le-Gaultier	539	8	547
52	Pays de la Loire	72	1	16	283	Saint-Germain-d;Arcé	382	2	384
52	Pays de la Loire	72	2	02	284	Saint-Germain-sur-Sarthe	551	11	562
52	Pays de la Loire	72	2	28	286	Saint-Gervais-de-Vic	383	12	395
52	Pays de la Loire	72	3	09	287	Saint-Gervais-en-Belin	2049	79	2128
52	Pays de la Loire	72	2	32	288	Saint-Hilaire-le-Lierru	137	2	139
52	Pays de la Loire	72	3	01	290	Saint-Jean-d;Assé	1483	16	1499
52	Pays de la Loire	72	1	26	291	Saint-Jean-de-la-Motte	903	22	925
52	Pays de la Loire	72	2	25	292	Saint-Jean-des-Échelles	255	4	259
52	Pays de la Loire	72	1	17	293	Saint-Jean-du-Bois	639	8	647
52	Pays de la Loire	72	2	12	294	Saint-Léonard-des-Bois	535	3	538
52	Pays de la Loire	72	2	18	295	Saint-Longis	524	12	536
52	Pays de la Loire	72	2	25	296	Saint-Maixent	784	8	792
52	Pays de la Loire	72	2	02	297	Saint-Marceau	493	12	505
52	Pays de la Loire	72	3	09	299	Saint-Mars-d;Outillé	2250	22	2272
52	Pays de la Loire	72	2	04	298	Saint-Mars-de-Locquenay	538	8	546
52	Pays de la Loire	72	2	24	300	Saint-Mars-la-Brière	2470	40	2510
52	Pays de la Loire	72	3	01	301	Saint-Mars-sous-Ballon	880	8	888
52	Pays de la Loire	72	2	10	302	Saint-Martin-des-Monts	173	5	178
52	Pays de la Loire	72	2	04	303	Saint-Michel-de-Chavaignes	802	9	811
52	Pays de la Loire	72	2	12	305	Saint-Ouen-de-Mimbré	948	16	964
52	Pays de la Loire	72	3	09	306	Saint-Ouen-en-Belin	1333	10	1343
52	Pays de la Loire	72	1	05	307	Saint-Ouen-en-Champagne	197	4	201
52	Pays de la Loire	72	2	29	308	Saint-Paterne	1611	247	1858
52	Pays de la Loire	72	2	12	309	Saint-Paul-le-Gaultier	294	9	303
52	Pays de la Loire	72	3	38	310	Saint-Pavace	1855	73	1928
52	Pays de la Loire	72	1	07	311	Saint-Pierre-de-Chevillé	360	6	366
52	Pays de la Loire	72	1	05	312	Saint-Pierre-des-Bois	212	2	214
52	Pays de la Loire	72	2	18	313	Saint-Pierre-des-Ormes	226	7	233
52	Pays de la Loire	72	1	13	314	Saint-Pierre-du-Lorouër	375	6	381
52	Pays de la Loire	72	2	30	315	Saint-Rémy-de-Sillé	760	27	787
52	Pays de la Loire	72	2	18	316	Saint-Rémy-des-Monts	680	15	695
52	Pays de la Loire	72	2	18	317	Saint-Rémy-du-Val	561	18	579
52	Pays de la Loire	72	2	11	318	Saint-Rigomer-des-Bois	419	12	431
52	Pays de la Loire	72	3	34	320	Saint-Saturnin	2497	75	2572
52	Pays de la Loire	72	2	08	321	Saint-Symphorien	561	13	574
52	Pays de la Loire	72	2	25	322	Saint-Ulphace	245	5	250
52	Pays de la Loire	72	2	12	323	Saint-Victeur	418	8	426
52	Pays de la Loire	72	2	18	324	Saint-Vincent-des-Prés	502	11	513
52	Pays de la Loire	72	1	13	325	Saint-Vincent-du-Lorouër	933	21	954
52	Pays de la Loire	72	2	28	272	Sainte-Cérotte	325	12	337
52	Pays de la Loire	72	3	01	289	Sainte-Jamme-sur-Sarthe	2077	20	2097
52	Pays de la Loire	72	2	28	304	Sainte-Osmane	194	4	198
52	Pays de la Loire	72	2	08	319	Sainte-Sabine-sur-Longève	676	12	688
52	Pays de la Loire	72	2	18	326	Saosnes	203	10	213
52	Pays de la Loire	72	1	23	327	Sarcé	292	5	297
52	Pays de la Loire	72	3	37	328	Sargé-lès-le-Mans	3541	112	3653
52	Pays de la Loire	72	3	37	329	Savigné-l;Évêque	4041	109	4150
52	Pays de la Loire	72	1	16	330	Savigné-sous-le-Lude	431	11	442
52	Pays de la Loire	72	2	32	331	Sceaux-sur-Huisne	584	12	596
52	Pays de la Loire	72	2	02	332	Ségrie	604	8	612
52	Pays de la Loire	72	2	33	333	Semur-en-Vallon	455	5	460
52	Pays de la Loire	72	2	30	334	Sillé-le-Guillaume	2364	112	2476
52	Pays de la Loire	72	2	24	335	Sillé-le-Philippe	1089	21	1110
52	Pays de la Loire	72	1	27	336	Solesmes	1372	65	1437
52	Pays de la Loire	72	2	12	337	Sougé-le-Ganelon	900	18	918
52	Pays de la Loire	72	3	01	338	Souillé	682	11	693
52	Pays de la Loire	72	1	31	339	Souligné-Flacé	718	13	731
52	Pays de la Loire	72	3	01	340	Souligné-sous-Ballon	1160	23	1183
52	Pays de la Loire	72	2	24	341	Soulitré	688	6	694
52	Pays de la Loire	72	2	10	342	Souvigné-sur-Même	178	8	186
52	Pays de la Loire	72	1	27	343	Souvigné-sur-Sarthe	610	18	628
52	Pays de la Loire	72	1	31	344	Spay	2846	47	2893
52	Pays de la Loire	72	2	24	345	Surfonds	328	8	336
52	Pays de la Loire	72	1	31	346	La Suze-sur-Sarthe	4192	76	4268
52	Pays de la Loire	72	1	05	347	Tassé	302	4	306
52	Pays de la Loire	72	1	15	348	Tassillé	139	1	140
52	Pays de la Loire	72	3	01	349	Teillé	523	10	533
52	Pays de la Loire	72	3	09	350	Teloché	3016	58	3074
52	Pays de la Loire	72	2	08	351	Tennie	1051	24	1075
52	Pays de la Loire	72	2	03	352	Terrehault	134	0	134
52	Pays de la Loire	72	2	10	353	Théligny	214	5	219
52	Pays de la Loire	72	2	22	354	Thoigné	164	6	170
52	Pays de la Loire	72	2	29	355	Thoiré-sous-Contensor	104	1	105
52	Pays de la Loire	72	1	07	356	Thoiré-sur-Dinan	432	11	443
52	Pays de la Loire	72	1	16	357	Thorée-les-Pins	684	21	705
52	Pays de la Loire	72	2	04	358	Thorigné-sur-Dué	1594	33	1627
52	Pays de la Loire	72	2	24	359	Torcé-en-Vallée	1283	7	1290
52	Pays de la Loire	72	3	34	360	Trangé	1385	31	1416
52	Pays de la Loire	72	2	04	361	Tresson	479	6	485
52	Pays de la Loire	72	2	02	362	Le Tronchet	141	0	141
52	Pays de la Loire	72	2	32	363	Tuffé	1633	15	1648
52	Pays de la Loire	72	1	23	364	Vaas	1570	89	1659
52	Pays de la Loire	72	2	33	366	Valennes	338	5	343
52	Pays de la Loire	72	1	15	367	Vallon-sur-Gée	818	9	827
52	Pays de la Loire	72	2	28	368	Vancé	340	11	351
52	Pays de la Loire	72	1	23	369	Verneil-le-Chétif	622	85	707
52	Pays de la Loire	72	2	02	370	Vernie	348	7	355
52	Pays de la Loire	72	2	18	372	Vezot	64	3	67
52	Pays de la Loire	72	2	33	373	Vibraye	2620	31	2651
52	Pays de la Loire	72	2	18	374	Villaines-la-Carelle	171	3	174
52	Pays de la Loire	72	2	10	375	Villaines-la-Gonais	527	10	537
52	Pays de la Loire	72	1	13	376	Villaines-sous-Lucé	682	24	706
52	Pays de la Loire	72	1	17	377	Villaines-sous-Malicorne	1000	12	1012
52	Pays de la Loire	72	1	27	378	Vion	1423	44	1467
52	Pays de la Loire	72	1	05	379	Viré-en-Champagne	231	4	235
52	Pays de la Loire	72	2	02	380	Vivoin	926	17	943
52	Pays de la Loire	72	1	31	381	Voivres-lès-le-Mans	1277	17	1294
52	Pays de la Loire	72	2	04	382	Volnay	853	15	868
52	Pays de la Loire	72	2	32	383	Vouvray-sur-Huisne	155	4	159
52	Pays de la Loire	72	1	07	384	Vouvray-sur-Loir	796	18	814
52	Pays de la Loire	72	3	37	386	Yvré-l;Évêque	4375	149	4524
52	Pays de la Loire	72	1	26	385	Yvré-le-Pôlin	1872	14	1886
82	Rhône-Alpes	73	2	21	001	Aiguebelette-le-Lac	240	7	247
82	Rhône-Alpes	73	3	01	002	Aiguebelle	1154	12	1166
82	Rhône-Alpes	73	1	20	003	Aigueblanche	3117	117	3234
82	Rhône-Alpes	73	2	13	004	Aillon-le-Jeune	449	11	460
82	Rhône-Alpes	73	2	13	005	Aillon-le-Vieux	175	5	180
82	Rhône-Alpes	73	1	02	006	Aime	3501	106	3607
82	Rhône-Alpes	73	3	01	007	Aiton	1774	23	1797
82	Rhône-Alpes	73	2	97	008	Aix-les-Bains	27750	689	28439
82	Rhône-Alpes	73	2	04	010	Albens	3231	65	3296
82	Rhône-Alpes	73	1	98	011	Albertville	18876	837	19713
82	Rhône-Alpes	73	3	25	012	Albiez-le-Jeune	121	2	123
82	Rhône-Alpes	73	3	25	013	Albiez-Montrond	381	13	394
82	Rhône-Alpes	73	1	05	014	Allondaz	229	1	230
82	Rhône-Alpes	73	1	08	015	Les Allues	1867	78	1945
82	Rhône-Alpes	73	2	18	017	Apremont	961	25	986
82	Rhône-Alpes	73	2	18	018	Arbin	782	6	788
82	Rhône-Alpes	73	3	01	019	Argentine	902	24	926
82	Rhône-Alpes	73	2	13	020	Arith	375	8	383
82	Rhône-Alpes	73	2	22	021	Arvillard	847	19	866
82	Rhône-Alpes	73	2	14	022	Attignat-Oncin	555	13	568
82	Rhône-Alpes	73	3	17	023	Aussois	667	31	698
82	Rhône-Alpes	73	1	20	024	Les Avanchers-Valmorel	752	27	779
82	Rhône-Alpes	73	2	24	025	Avressieux	473	8	481
82	Rhône-Alpes	73	3	17	026	Avrieux	422	24	446
82	Rhône-Alpes	73	2	21	027	Ayn	350	6	356
82	Rhône-Alpes	73	2	29	028	La Balme	252	2	254
82	Rhône-Alpes	73	2	33	029	Barberaz	4598	139	4737
82	Rhône-Alpes	73	2	34	030	Barby	3308	76	3384
82	Rhône-Alpes	73	2	34	031	Bassens	3717	134	3851
82	Rhône-Alpes	73	1	30	032	La Bâthie	2103	85	2188
82	Rhône-Alpes	73	2	14	033	La Bauche	417	6	423
82	Rhône-Alpes	73	1	06	034	Beaufort	2184	104	2288
82	Rhône-Alpes	73	2	13	036	Bellecombe-en-Bauges	644	21	665
82	Rhône-Alpes	73	1	02	038	Bellentre	944	34	978
82	Rhône-Alpes	73	2	21	039	Belmont-Tramonet	548	18	566
82	Rhône-Alpes	73	3	16	040	Bessans	343	12	355
82	Rhône-Alpes	73	2	12	041	Betton-Bettonet	297	3	300
82	Rhône-Alpes	73	2	29	042	Billième	242	4	246
82	Rhône-Alpes	73	2	04	043	La Biolle	2200	54	2254
82	Rhône-Alpes	73	1	20	045	Le Bois	363	11	374
82	Rhône-Alpes	73	1	20	046	Bonneval	106	1	107
82	Rhône-Alpes	73	3	16	047	Bonneval-sur-Arc	241	11	252
82	Rhône-Alpes	73	1	15	048	Bonvillard	341	12	353
82	Rhône-Alpes	73	3	01	049	Bonvillaret	122	1	123
82	Rhône-Alpes	73	2	19	050	Bourdeau	565	16	581
82	Rhône-Alpes	73	1	07	054	Bourg-Saint-Maurice	7705	410	8115
82	Rhône-Alpes	73	2	19	051	Le Bourget-du-Lac	4410	92	4502
82	Rhône-Alpes	73	2	22	052	Bourget-en-Huile	149	8	157
82	Rhône-Alpes	73	2	12	053	Bourgneuf	660	3	663
82	Rhône-Alpes	73	1	08	055	Bozel	2027	71	2098
82	Rhône-Alpes	73	3	16	056	Bramans	392	14	406
82	Rhône-Alpes	73	1	08	057	Brides-les-Bains	551	24	575
82	Rhône-Alpes	73	2	21	058	La Bridoire	1187	31	1218
82	Rhône-Alpes	73	2	32	059	Brison-Saint-Innocent	2156	63	2219
82	Rhône-Alpes	73	1	05	061	Césarches	391	4	395
82	Rhône-Alpes	73	2	04	062	Cessens	420	9	429
82	Rhône-Alpes	73	1	30	063	Cevins	679	11	690
82	Rhône-Alpes	73	2	33	064	Challes-les-Eaux	5087	287	5374
82	Rhône-Alpes	73	2	99	065	Chambéry	57342	1842	59184
82	Rhône-Alpes	73	3	11	067	La Chambre	1162	18	1180
82	Rhône-Alpes	73	2	12	068	Chamousset	560	15	575
82	Rhône-Alpes	73	2	12	069	Chamoux-sur-Gelon	880	22	902
82	Rhône-Alpes	73	2	12	072	Champ-Laurent	34	1	35
82	Rhône-Alpes	73	2	24	070	Champagneux	594	7	601
82	Rhône-Alpes	73	1	08	071	Champagny-en-Vanoise	679	27	706
82	Rhône-Alpes	73	2	23	073	Chanaz	513	8	521
82	Rhône-Alpes	73	3	11	074	La Chapelle	351	9	360
82	Rhône-Alpes	73	2	22	075	La Chapelle-Blanche	528	9	537
82	Rhône-Alpes	73	2	19	076	La Chapelle-du-Mont-du-Chat	255	3	258
82	Rhône-Alpes	73	2	29	078	La Chapelle-Saint-Martin	148	5	153
82	Rhône-Alpes	73	1	07	077	Les Chapelles	517	12	529
82	Rhône-Alpes	73	2	12	079	Châteauneuf	757	14	771
82	Rhône-Alpes	73	3	25	080	Le Châtel	201	9	210
82	Rhône-Alpes	73	2	13	081	Le Châtelard	658	39	697
82	Rhône-Alpes	73	2	18	082	La Chavanne	613	8	621
82	Rhône-Alpes	73	3	11	083	Les Chavannes-en-Maurienne	234	0	234
82	Rhône-Alpes	73	2	18	084	Chignin	831	16	847
82	Rhône-Alpes	73	2	23	085	Chindrieux	1235	45	1280
82	Rhône-Alpes	73	1	15	086	Cléry	421	13	434
82	Rhône-Alpes	73	2	37	087	Cognin	5913	159	6072
82	Rhône-Alpes	73	1	28	088	Cohennoz	156	10	166
82	Rhône-Alpes	73	2	12	089	Coise-Saint-Jean-Pied-Gauthier	1182	25	1207
82	Rhône-Alpes	73	2	13	090	La Compôte	226	5	231
82	Rhône-Alpes	73	2	23	091	Conjux	183	0	183
82	Rhône-Alpes	73	2	14	092	Corbel	131	4	135
82	Rhône-Alpes	73	1	02	093	La Côte-d;Aime	861	27	888
82	Rhône-Alpes	73	1	28	094	Crest-Voland	390	21	411
82	Rhône-Alpes	73	2	22	095	La Croix-de-la-Rochette	305	7	312
82	Rhône-Alpes	73	2	27	096	Cruet	1045	25	1070
82	Rhône-Alpes	73	2	34	097	Curienne	651	29	680
82	Rhône-Alpes	73	2	34	098	Les Déserts	846	12	858
82	Rhône-Alpes	73	2	22	099	Détrier	419	19	438
82	Rhône-Alpes	73	2	21	100	Domessin	1748	46	1794
82	Rhône-Alpes	73	2	13	101	Doucy-en-Bauges	98	5	103
82	Rhône-Alpes	73	2	35	103	Drumettaz-Clarafond	2384	73	2457
82	Rhône-Alpes	73	2	21	104	Dullin	402	13	415
82	Rhône-Alpes	73	2	14	105	Les Échelles	1219	29	1248
82	Rhône-Alpes	73	2	13	106	École	254	1	255
82	Rhône-Alpes	73	2	14	107	Entremont-le-Vieux	599	10	609
82	Rhône-Alpes	73	2	04	108	Épersy	342	14	356
82	Rhône-Alpes	73	3	01	109	Épierre	730	14	744
82	Rhône-Alpes	73	1	30	110	Esserts-Blay	746	16	762
82	Rhône-Alpes	73	2	22	111	Étable	353	19	372
82	Rhône-Alpes	73	1	20	112	Feissons-sur-Isère	584	17	601
82	Rhône-Alpes	73	1	08	113	Feissons-sur-Salins	196	2	198
82	Rhône-Alpes	73	1	28	114	Flumet	848	20	868
82	Rhône-Alpes	73	1	20	115	Fontaine-le-Puits	140	4	144
82	Rhône-Alpes	73	3	25	116	Fontcouverte-la-Toussuire	593	18	611
82	Rhône-Alpes	73	3	17	117	Fourneaux	759	21	780
82	Rhône-Alpes	73	2	18	118	Francin	883	20	903
82	Rhône-Alpes	73	3	17	119	Freney	121	1	122
82	Rhône-Alpes	73	2	27	120	Fréterive	489	7	496
82	Rhône-Alpes	73	1	15	121	Frontenex	1676	37	1713
82	Rhône-Alpes	73	2	24	122	Gerbaix	416	6	422
82	Rhône-Alpes	73	1	28	123	La Giettaz	446	15	461
82	Rhône-Alpes	73	1	30	124	Gilly-sur-Isère	2903	121	3024
82	Rhône-Alpes	73	1	02	126	Granier	371	9	380
82	Rhône-Alpes	73	2	24	127	Gresin	360	9	369
82	Rhône-Alpes	73	2	32	128	Grésy-sur-Aix	3986	94	4080
82	Rhône-Alpes	73	1	15	129	Grésy-sur-Isère	1261	30	1291
82	Rhône-Alpes	73	1	30	130	Grignon	1930	55	1985
82	Rhône-Alpes	73	1	20	131	Hautecour	312	7	319
82	Rhône-Alpes	73	1	06	132	Hauteluce	828	29	857
82	Rhône-Alpes	73	2	12	133	Hauteville	324	7	331
82	Rhône-Alpes	73	3	25	135	Hermillon	535	21	556
82	Rhône-Alpes	73	2	37	137	Jacob-Bellecombette	3968	95	4063
82	Rhône-Alpes	73	3	25	138	Jarrier	471	11	482
82	Rhône-Alpes	73	2	13	139	Jarsy	284	15	299
82	Rhône-Alpes	73	2	29	140	Jongieux	344	7	351
82	Rhône-Alpes	73	2	18	141	Laissaud	620	10	630
82	Rhône-Alpes	73	1	02	142	Landry	766	17	783
82	Rhône-Alpes	73	3	16	143	Lanslebourg-Mont-Cenis	621	23	644
82	Rhône-Alpes	73	3	16	144	Lanslevillard	465	17	482
82	Rhône-Alpes	73	1	20	187	La Léchère	1928	39	1967
82	Rhône-Alpes	73	2	21	145	Lépin-le-Lac	433	11	444
82	Rhône-Alpes	73	2	13	146	Lescheraines	724	13	737
82	Rhône-Alpes	73	2	29	147	Loisieux	185	8	193
82	Rhône-Alpes	73	2	29	149	Lucey	280	3	283
82	Rhône-Alpes	73	1	02	150	Mâcot-la-Plagne	1782	38	1820
82	Rhône-Alpes	73	2	18	151	Les Marches	2448	52	2500
82	Rhône-Alpes	73	2	24	152	Marcieux	185	4	189
82	Rhône-Alpes	73	1	28	153	Marthod	1372	32	1404
82	Rhône-Alpes	73	1	05	154	Mercury	2841	60	2901
82	Rhône-Alpes	73	2	35	155	Méry	1385	34	1419
82	Rhône-Alpes	73	2	29	156	Meyrieux-Trouet	281	6	287
82	Rhône-Alpes	73	3	17	157	Modane	3495	143	3638
82	Rhône-Alpes	73	2	04	158	Mognard	418	7	425
82	Rhône-Alpes	73	2	18	159	Les Mollettes	737	13	750
82	Rhône-Alpes	73	2	37	160	Montagnole	816	10	826
82	Rhône-Alpes	73	1	08	161	Montagny	656	13	669
82	Rhône-Alpes	73	1	15	162	Montailleur	627	21	648
82	Rhône-Alpes	73	3	11	163	Montaimont	160	1	161
82	Rhône-Alpes	73	2	32	164	Montcel	858	87	945
82	Rhône-Alpes	73	2	12	166	Montendry	58	0	58
82	Rhône-Alpes	73	3	11	167	Montgellafrey	67	3	70
82	Rhône-Alpes	73	3	01	168	Montgilbert	126	0	126
82	Rhône-Alpes	73	1	02	169	Montgirod	439	10	449
82	Rhône-Alpes	73	1	30	170	Monthion	459	16	475
82	Rhône-Alpes	73	2	18	171	Montmélian	4039	91	4130
82	Rhône-Alpes	73	3	25	173	Montricher-Albanne	661	25	686
82	Rhône-Alpes	73	3	01	175	Montsapey	79	0	79
82	Rhône-Alpes	73	1	07	176	Montvalezan	676	17	693
82	Rhône-Alpes	73	3	25	177	Montvernier	224	9	233
82	Rhône-Alpes	73	2	13	178	La Motte-en-Bauges	434	8	442
82	Rhône-Alpes	73	2	19	179	La Motte-Servolex	11101	519	11620
82	Rhône-Alpes	73	2	23	180	Motz	392	6	398
82	Rhône-Alpes	73	1	20	181	Moûtiers	3821	484	4305
82	Rhône-Alpes	73	2	35	182	Mouxy	2090	69	2159
82	Rhône-Alpes	73	2	18	183	Myans	1108	32	1140
82	Rhône-Alpes	73	2	21	184	Nances	434	9	443
82	Rhône-Alpes	73	1	28	186	Notre-Dame-de-Bellecombe	512	27	539
82	Rhône-Alpes	73	1	15	188	Notre-Dame-des-Millières	924	30	954
82	Rhône-Alpes	73	3	11	189	Notre-Dame-du-Cruet	188	4	192
82	Rhône-Alpes	73	1	20	190	Notre-Dame-du-Pré	271	6	277
82	Rhône-Alpes	73	2	24	191	Novalaise	1913	43	1956
82	Rhône-Alpes	73	2	13	192	Le Noyer	182	2	184
82	Rhône-Alpes	73	2	29	193	Ontex	91	1	92
82	Rhône-Alpes	73	3	26	194	Orelle	365	9	374
82	Rhône-Alpes	73	1	05	196	Pallud	713	15	728
82	Rhône-Alpes	73	1	02	197	Peisey-Nancroix	651	13	664
82	Rhône-Alpes	73	1	08	198	La Perrière	444	11	455
82	Rhône-Alpes	73	2	18	200	Planaise	512	14	526
82	Rhône-Alpes	73	1	08	201	Planay	411	10	421
82	Rhône-Alpes	73	1	15	202	Plancherine	413	10	423
82	Rhône-Alpes	73	2	21	204	Le Pont-de-Beauvoisin	2004	25	2029
82	Rhône-Alpes	73	3	25	203	Pontamafrey-Montpascal	336	14	350
82	Rhône-Alpes	73	2	22	205	Le Pontet	138	4	142
82	Rhône-Alpes	73	1	08	206	Pralognan-la-Vanoise	754	21	775
82	Rhône-Alpes	73	2	22	207	Presle	444	3	447
82	Rhône-Alpes	73	2	32	208	Pugny-Chatenod	941	35	976
82	Rhône-Alpes	73	2	34	210	Puygros	362	12	374
82	Rhône-Alpes	73	1	06	211	Queige	852	15	867
82	Rhône-Alpes	73	3	01	212	Randens	886	22	908
82	Rhône-Alpes	73	2	33	213	La Ravoire	7794	536	8330
82	Rhône-Alpes	73	2	24	214	Rochefort	203	4	207
82	Rhône-Alpes	73	2	22	215	La Rochette	3488	97	3585
82	Rhône-Alpes	73	1	30	216	Rognaix	436	12	448
82	Rhône-Alpes	73	2	22	217	Rotherens	314	4	318
82	Rhône-Alpes	73	2	23	218	Ruffieux	804	16	820
82	Rhône-Alpes	73	2	21	219	Saint-Alban-de-Montbel	620	17	637
82	Rhône-Alpes	73	3	01	220	Saint-Alban-des-Hurtières	323	14	337
82	Rhône-Alpes	73	3	11	221	Saint-Alban-des-Villards	89	0	89
82	Rhône-Alpes	73	2	34	222	Saint-Alban-Leysse	5710	225	5935
82	Rhône-Alpes	73	3	17	223	Saint-André	480	13	493
82	Rhône-Alpes	73	3	11	224	Saint-Avre	800	10	810
82	Rhône-Alpes	73	2	33	225	Saint-Baldoph	2965	75	3040
82	Rhône-Alpes	73	2	21	226	Saint-Béron	1548	37	1585
82	Rhône-Alpes	73	1	08	227	Saint-Bon-Tarentaise	1964	50	2014
82	Rhône-Alpes	73	2	37	228	Saint-Cassin	758	25	783
82	Rhône-Alpes	73	2	14	229	Saint-Christophe	517	7	524
82	Rhône-Alpes	73	3	11	230	Saint-Colomban-des-Villards	188	0	188
82	Rhône-Alpes	73	3	11	231	Saint-Étienne-de-Cuines	1200	42	1242
82	Rhône-Alpes	73	2	14	233	Saint-Franc	149	17	166
82	Rhône-Alpes	73	2	13	234	Saint-François-de-Sales	143	4	147
82	Rhône-Alpes	73	3	11	235	Saint-François-Longchamp	218	1	219
82	Rhône-Alpes	73	2	24	236	Saint-Genix-sur-Guiers	2247	38	2285
82	Rhône-Alpes	73	3	01	237	Saint-Georges-des-Hurtières	302	3	305
82	Rhône-Alpes	73	2	04	238	Saint-Germain-la-Chambotte	446	5	451
82	Rhône-Alpes	73	2	04	239	Saint-Girod	581	11	592
82	Rhône-Alpes	73	3	25	242	Saint-Jean-d;Arves	289	11	300
82	Rhône-Alpes	73	2	34	243	Saint-Jean-d;Arvey	1479	69	1548
82	Rhône-Alpes	73	1	20	244	Saint-Jean-de-Belleville	559	15	574
82	Rhône-Alpes	73	2	29	245	Saint-Jean-de-Chevelu	747	12	759
82	Rhône-Alpes	73	2	14	246	Saint-Jean-de-Couz	251	7	258
82	Rhône-Alpes	73	2	27	247	Saint-Jean-de-la-Porte	842	61	903
82	Rhône-Alpes	73	3	25	248	Saint-Jean-de-Maurienne	8242	468	8710
82	Rhône-Alpes	73	2	33	249	Saint-Jeoire-Prieuré	1067	28	1095
82	Rhône-Alpes	73	3	25	250	Saint-Julien-Mont-Denis	1630	69	1699
82	Rhône-Alpes	73	3	01	252	Saint-Léger	235	12	247
82	Rhône-Alpes	73	1	20	253	Saint-Marcel	663	14	677
82	Rhône-Alpes	73	3	26	256	Saint-Martin-d;Arc	344	18	362
82	Rhône-Alpes	73	1	20	257	Saint-Martin-de-Belleville	2543	65	2608
82	Rhône-Alpes	73	3	26	258	Saint-Martin-de-la-Porte	702	26	728
82	Rhône-Alpes	73	3	11	259	Saint-Martin-sur-la-Chambre	476	20	496
82	Rhône-Alpes	73	2	24	260	Saint-Maurice-de-Rotherens	217	1	218
82	Rhône-Alpes	73	3	26	261	Saint-Michel-de-Maurienne	2776	244	3020
82	Rhône-Alpes	73	1	28	262	Saint-Nicolas-la-Chapelle	407	51	458
82	Rhône-Alpes	73	2	32	263	Saint-Offenge-Dessous	641	21	662
82	Rhône-Alpes	73	2	32	264	Saint-Offenge-Dessus	274	7	281
82	Rhône-Alpes	73	2	04	265	Saint-Ours	547	9	556
82	Rhône-Alpes	73	1	20	266	Saint-Oyen	206	7	213
82	Rhône-Alpes	73	3	25	267	Saint-Pancrace	286	8	294
82	Rhône-Alpes	73	2	29	269	Saint-Paul	643	9	652
82	Rhône-Alpes	73	1	30	268	Saint-Paul-sur-Isère	522	91	613
82	Rhône-Alpes	73	2	27	270	Saint-Pierre-d;Albigny	3714	76	3790
82	Rhône-Alpes	73	2	29	271	Saint-Pierre-d;Alvey	282	3	285
82	Rhône-Alpes	73	2	14	274	Saint-Pierre-d;Entremont	424	22	446
82	Rhône-Alpes	73	3	01	272	Saint-Pierre-de-Belleville	174	4	178
82	Rhône-Alpes	73	2	23	273	Saint-Pierre-de-Curtille	450	9	459
82	Rhône-Alpes	73	2	14	275	Saint-Pierre-de-Genebroz	342	4	346
82	Rhône-Alpes	73	2	18	276	Saint-Pierre-de-Soucy	379	11	390
82	Rhône-Alpes	73	3	11	278	Saint-Rémy-de-Maurienne	1272	13	1285
82	Rhône-Alpes	73	3	25	280	Saint-Sorlin-d;Arves	343	4	347
82	Rhône-Alpes	73	2	37	281	Saint-Sulpice	744	23	767
82	Rhône-Alpes	73	2	14	282	Saint-Thibaud-de-Couz	947	11	958
82	Rhône-Alpes	73	1	15	283	Saint-Vital	667	20	687
82	Rhône-Alpes	73	1	07	232	Sainte-Foy-Tarentaise	767	17	784
82	Rhône-Alpes	73	2	18	240	Sainte-Hélène-du-Lac	697	17	714
82	Rhône-Alpes	73	1	15	241	Sainte-Hélène-sur-Isère	1109	30	1139
82	Rhône-Alpes	73	2	24	254	Sainte-Marie-d;Alvey	141	5	146
82	Rhône-Alpes	73	3	11	255	Sainte-Marie-de-Cuines	781	19	800
82	Rhône-Alpes	73	2	13	277	Sainte-Reine	158	1	159
82	Rhône-Alpes	73	1	20	284	Salins-les-Thermes	947	24	971
82	Rhône-Alpes	73	1	07	285	Séez	2381	68	2449
82	Rhône-Alpes	73	2	23	286	Serrières-en-Chautagne	1129	26	1155
82	Rhône-Alpes	73	3	16	287	Sollières-Sardières	190	5	195
82	Rhône-Alpes	73	2	09	288	Sonnaz	1510	46	1556
82	Rhône-Alpes	73	2	22	289	La Table	385	9	394
82	Rhône-Alpes	73	3	16	290	Termignon	418	10	428
82	Rhône-Alpes	73	1	05	292	Thénésol	246	17	263
82	Rhône-Alpes	73	2	34	293	Thoiry	448	12	460
82	Rhône-Alpes	73	2	27	294	La Thuile	285	13	298
82	Rhône-Alpes	73	1	07	296	Tignes	2178	34	2212
82	Rhône-Alpes	73	1	15	297	Tournon	560	19	579
82	Rhône-Alpes	73	1	30	298	Tours-en-Savoie	851	24	875
82	Rhône-Alpes	73	2	29	299	Traize	281	11	292
82	Rhône-Alpes	73	2	35	300	Tresserve	3117	168	3285
82	Rhône-Alpes	73	2	32	301	Trévignin	751	23	774
82	Rhône-Alpes	73	2	22	302	La Trinité	290	2	292
82	Rhône-Alpes	73	1	28	303	Ugine	7058	263	7321
82	Rhône-Alpes	73	1	07	304	Val-d;Isère	1563	41	1604
82	Rhône-Alpes	73	1	02	305	Valezan	207	5	212
82	Rhône-Alpes	73	3	26	306	Valloire	1305	45	1350
82	Rhône-Alpes	73	3	26	307	Valmeinier	432	39	471
82	Rhône-Alpes	73	1	05	308	Venthon	587	25	612
82	Rhône-Alpes	73	2	21	309	Verel-de-Montbel	292	17	309
82	Rhône-Alpes	73	2	34	310	Verel-Pragondran	433	12	445
82	Rhône-Alpes	73	2	22	311	Le Verneil	97	0	97
82	Rhône-Alpes	73	1	15	312	Verrens-Arvey	802	21	823
82	Rhône-Alpes	73	2	29	313	Verthemex	171	0	171
82	Rhône-Alpes	73	2	18	314	Villard-d;Héry	246	4	250
82	Rhône-Alpes	73	2	12	315	Villard-Léger	491	7	498
82	Rhône-Alpes	73	2	22	316	Villard-Sallet	252	6	258
82	Rhône-Alpes	73	1	06	317	Villard-sur-Doron	661	16	677
82	Rhône-Alpes	73	3	25	318	Villarembert	261	5	266
82	Rhône-Alpes	73	3	25	320	Villargondran	988	28	1016
82	Rhône-Alpes	73	1	20	321	Villarlurin	297	13	310
82	Rhône-Alpes	73	3	17	322	Villarodin-Bourget	486	10	496
82	Rhône-Alpes	73	1	07	323	Villaroger	400	7	407
82	Rhône-Alpes	73	2	18	324	Villaroux	224	9	233
82	Rhône-Alpes	73	2	37	326	Vimines	1769	71	1840
82	Rhône-Alpes	73	2	23	327	Vions	394	5	399
82	Rhône-Alpes	73	2	35	328	Viviers-du-Lac	2056	32	2088
82	Rhône-Alpes	73	2	35	329	Voglans	1681	42	1723
82	Rhône-Alpes	73	2	29	330	Yenne	2951	46	2997
82	Rhône-Alpes	74	4	01	001	Abondance	1342	145	1487
82	Rhône-Alpes	74	1	02	002	Alby-sur-Chéran	2012	36	2048
82	Rhône-Alpes	74	1	30	003	Alex	985	25	1010
82	Rhône-Alpes	74	1	02	004	Allèves	359	7	366
82	Rhône-Alpes	74	4	34	005	Allinges	3982	117	4099
82	Rhône-Alpes	74	3	11	006	Allonzier-la-Caille	1637	33	1670
82	Rhône-Alpes	74	2	17	007	Amancy	2046	71	2117
82	Rhône-Alpes	74	3	05	008	Ambilly	5890	106	5996
82	Rhône-Alpes	74	3	11	009	Andilly	778	15	793
82	Rhône-Alpes	74	1	99	010	Annecy	50379	1996	52375
82	Rhône-Alpes	74	1	30	011	Annecy-le-Vieux	19968	913	20881
82	Rhône-Alpes	74	3	96	012	Annemasse	32196	594	32790
82	Rhône-Alpes	74	4	34	013	Anthy-sur-Léman	1958	120	2078
82	Rhône-Alpes	74	2	10	014	Arâches-la-Frasse	1816	75	1891
82	Rhône-Alpes	74	3	16	015	Arbusigny	1003	11	1014
82	Rhône-Alpes	74	3	21	016	Archamps	2079	43	2122
82	Rhône-Alpes	74	2	17	018	Arenthon	1526	49	1575
82	Rhône-Alpes	74	1	30	019	Argonay	2583	305	2888
82	Rhône-Alpes	74	4	27	020	Armoy	1184	41	1225
82	Rhône-Alpes	74	3	31	021	Arthaz-Pont-Notre-Dame	1279	30	1309
82	Rhône-Alpes	74	1	28	022	Aviernoz	776	16	792
82	Rhône-Alpes	74	2	08	024	Ayse	1999	69	2068
82	Rhône-Alpes	74	4	12	025	Ballaison	1329	29	1358
82	Rhône-Alpes	74	1	29	026	La Balme-de-Sillingy	4960	128	5088
82	Rhône-Alpes	74	1	26	027	La Balme-de-Thuy	401	8	409
82	Rhône-Alpes	74	3	24	029	Bassy	450	20	470
82	Rhône-Alpes	74	4	06	030	La Baume	251	9	260
82	Rhône-Alpes	74	3	21	031	Beaumont	2125	54	2179
82	Rhône-Alpes	74	4	27	032	Bellevaux	1325	35	1360
82	Rhône-Alpes	74	4	13	033	Bernex	1241	30	1271
82	Rhône-Alpes	74	4	06	034	Le Biot	463	7	470
82	Rhône-Alpes	74	1	18	035	Bloye	533	7	540
82	Rhône-Alpes	74	1	30	036	Bluffy	329	8	337
82	Rhône-Alpes	74	4	07	037	Boëge	1748	44	1792
82	Rhône-Alpes	74	4	07	038	Bogève	1080	26	1106
82	Rhône-Alpes	74	3	31	040	Bonne	2776	143	2919
82	Rhône-Alpes	74	4	01	041	Bonnevaux	250	12	262
82	Rhône-Alpes	74	2	08	042	Bonneville	11908	413	12321
82	Rhône-Alpes	74	4	12	043	Bons-en-Chablais	4805	96	4901
82	Rhône-Alpes	74	3	21	044	Bossey	736	19	755
82	Rhône-Alpes	74	1	26	045	Le Bouchet	237	3	240
82	Rhône-Alpes	74	1	18	046	Boussy	504	23	527
82	Rhône-Alpes	74	4	12	048	Brenthonne	899	13	912
82	Rhône-Alpes	74	2	08	049	Brizon	450	5	455
82	Rhône-Alpes	74	4	07	050	Burdignin	649	22	671
82	Rhône-Alpes	74	3	11	051	Cercier	565	12	577
82	Rhône-Alpes	74	3	11	052	Cernex	897	14	911
82	Rhône-Alpes	74	4	34	053	Cervens	1092	21	1113
82	Rhône-Alpes	74	1	02	054	Chainaz-les-Frasses	605	19	624
82	Rhône-Alpes	74	3	24	055	Challonges	471	15	486
82	Rhône-Alpes	74	2	09	056	Chamonix-Mont-Blanc	8972	374	9346
82	Rhône-Alpes	74	4	13	057	Champanges	858	30	888
82	Rhône-Alpes	74	1	02	061	Chapeiry	775	37	812
82	Rhône-Alpes	74	4	01	058	La Chapelle-d;Abondance	840	13	853
82	Rhône-Alpes	74	2	17	059	La Chapelle-Rambaud	224	4	228
82	Rhône-Alpes	74	1	33	060	La Chapelle-Saint-Maurice	130	1	131
82	Rhône-Alpes	74	1	30	062	Charvonnex	1135	19	1154
82	Rhône-Alpes	74	4	01	063	Châtel	1198	31	1229
82	Rhône-Alpes	74	2	10	064	Châtillon-sur-Cluses	1185	26	1211
82	Rhône-Alpes	74	3	15	065	Chaumont	417	8	425
82	Rhône-Alpes	74	3	15	066	Chavannaz	187	6	193
82	Rhône-Alpes	74	1	33	067	Chavanod	2263	211	2474
82	Rhône-Alpes	74	3	24	068	Chêne-en-Semine	419	8	427
82	Rhône-Alpes	74	3	21	069	Chênex	616	14	630
82	Rhône-Alpes	74	4	12	070	Chens-sur-Léman	1893	47	1940
82	Rhône-Alpes	74	3	15	071	Chessenaz	181	11	192
82	Rhône-Alpes	74	1	14	072	Chevaline	205	5	210
82	Rhône-Alpes	74	4	01	073	Chevenoz	557	16	573
82	Rhône-Alpes	74	3	21	074	Chevrier	411	14	425
82	Rhône-Alpes	74	3	15	075	Chilly	1109	22	1131
82	Rhône-Alpes	74	1	29	076	Choisy	1556	40	1596
82	Rhône-Alpes	74	3	15	077	Clarafond-Arcine	895	19	914
82	Rhône-Alpes	74	1	26	079	Les Clefs	580	9	589
82	Rhône-Alpes	74	3	24	078	Clermont	420	18	438
82	Rhône-Alpes	74	1	26	080	La Clusaz	1874	42	1916
82	Rhône-Alpes	74	2	10	081	Cluses	17408	469	17877
82	Rhône-Alpes	74	3	21	082	Collonges-sous-Salève	3667	127	3794
82	Rhône-Alpes	74	2	22	083	Combloux	2080	101	2181
82	Rhône-Alpes	74	1	14	084	Cons-Sainte-Colombe	355	10	365
82	Rhône-Alpes	74	3	15	086	Contamine-Sarzin	571	14	585
82	Rhône-Alpes	74	2	08	087	Contamine-sur-Arve	1593	157	1750
82	Rhône-Alpes	74	2	19	085	Les Contamines-Montjoie	1193	36	1229
82	Rhône-Alpes	74	3	11	088	Copponex	882	25	907
82	Rhône-Alpes	74	2	22	089	Cordon	1004	27	1031
82	Rhône-Alpes	74	2	17	090	Cornier	1203	36	1239
82	Rhône-Alpes	74	2	25	091	La Côte-d;Arbroz	265	3	268
82	Rhône-Alpes	74	1	33	093	Cran-Gevrier	17227	378	17605
82	Rhône-Alpes	74	3	05	094	Cranves-Sales	5349	169	5518
82	Rhône-Alpes	74	1	18	095	Crempigny-Bonneguête	267	5	272
82	Rhône-Alpes	74	3	11	096	Cruseilles	3859	210	4069
82	Rhône-Alpes	74	1	02	097	Cusy	1757	49	1806
82	Rhône-Alpes	74	1	30	098	Cuvat	983	49	1032
82	Rhône-Alpes	74	2	22	099	Demi-Quartier	976	29	1005
82	Rhône-Alpes	74	3	24	100	Desingy	792	10	802
82	Rhône-Alpes	74	3	21	101	Dingy-en-Vuache	644	6	650
82	Rhône-Alpes	74	1	30	102	Dingy-Saint-Clair	1338	39	1377
82	Rhône-Alpes	74	2	22	103	Domancy	1817	81	1898
82	Rhône-Alpes	74	1	14	104	Doussard	3551	78	3629
82	Rhône-Alpes	74	4	12	105	Douvaine	4972	78	5050
82	Rhône-Alpes	74	4	34	106	Draillant	711	18	729
82	Rhône-Alpes	74	3	24	107	Droisy	159	0	159
82	Rhône-Alpes	74	1	33	108	Duingt	884	44	928
82	Rhône-Alpes	74	3	15	109	Éloise	862	12	874
82	Rhône-Alpes	74	2	08	110	Entremont	617	10	627
82	Rhône-Alpes	74	1	33	111	Entrevernes	206	3	209
82	Rhône-Alpes	74	1	29	112	Épagny	3899	80	3979
82	Rhône-Alpes	74	4	06	114	Essert-Romand	442	9	451
82	Rhône-Alpes	74	2	17	116	Etaux	1694	59	1753
82	Rhône-Alpes	74	1	18	117	Étercy	698	12	710
82	Rhône-Alpes	74	3	31	118	Étrembières	1887	28	1915
82	Rhône-Alpes	74	4	13	119	Évian-les-Bains	8142	210	8352
82	Rhône-Alpes	74	1	28	120	Évires	1294	24	1318
82	Rhône-Alpes	74	4	12	121	Excenevex	1010	17	1027
82	Rhône-Alpes	74	2	08	122	Faucigny	506	16	522
82	Rhône-Alpes	74	1	14	123	Faverges	6833	268	7101
82	Rhône-Alpes	74	3	21	124	Feigères	1492	37	1529
82	Rhône-Alpes	74	4	12	126	Fessy	752	30	782
82	Rhône-Alpes	74	4	13	127	Féternes	1330	51	1381
82	Rhône-Alpes	74	3	16	128	Fillinges	3153	90	3243
82	Rhône-Alpes	74	4	06	129	La Forclaz	215	2	217
82	Rhône-Alpes	74	3	24	130	Franclens	466	68	534
82	Rhône-Alpes	74	3	15	131	Frangy	1918	50	1968
82	Rhône-Alpes	74	3	31	133	Gaillard	11181	164	11345
82	Rhône-Alpes	74	2	25	134	Les Gets	1248	36	1284
82	Rhône-Alpes	74	1	14	135	Giez	574	14	588
82	Rhône-Alpes	74	1	26	136	Le Grand-Bornand	2190	53	2243
82	Rhône-Alpes	74	1	28	137	Groisy	3062	222	3284
82	Rhône-Alpes	74	1	02	138	Gruffy	1458	32	1490
82	Rhône-Alpes	74	4	07	139	Habère-Lullin	810	23	833
82	Rhône-Alpes	74	4	07	140	Habère-Poche	1226	25	1251
82	Rhône-Alpes	74	1	18	141	Hauteville-sur-Fier	825	20	845
82	Rhône-Alpes	74	1	02	142	Héry-sur-Alby	907	22	929
82	Rhône-Alpes	74	2	09	143	Les Houches	3018	88	3106
82	Rhône-Alpes	74	3	21	144	Jonzier-Épagny	711	14	725
82	Rhône-Alpes	74	3	05	145	Juvigny	637	19	656
82	Rhône-Alpes	74	4	13	146	Larringes	1241	26	1267
82	Rhône-Alpes	74	1	14	147	Lathuile	965	25	990
82	Rhône-Alpes	74	1	33	148	Leschaux	265	3	268
82	Rhône-Alpes	74	4	12	150	Loisin	1406	31	1437
82	Rhône-Alpes	74	1	18	151	Lornay	496	10	506
82	Rhône-Alpes	74	1	29	152	Lovagny	1171	34	1205
82	Rhône-Alpes	74	3	05	153	Lucinges	1547	46	1593
82	Rhône-Alpes	74	4	13	154	Lugrin	2308	47	2355
82	Rhône-Alpes	74	4	27	155	Lullin	837	21	858
82	Rhône-Alpes	74	4	12	156	Lully	675	15	690
82	Rhône-Alpes	74	4	27	157	Lyaud	1502	44	1546
82	Rhône-Alpes	74	3	05	158	Machilly	957	13	970
82	Rhône-Alpes	74	2	10	159	Magland	3149	62	3211
82	Rhône-Alpes	74	1	26	160	Manigod	986	18	1004
82	Rhône-Alpes	74	2	08	162	Marcellaz	775	18	793
82	Rhône-Alpes	74	1	18	161	Marcellaz-Albanais	1775	46	1821
82	Rhône-Alpes	74	4	34	163	Margencel	1822	78	1900
82	Rhône-Alpes	74	2	08	164	Marignier	6159	177	6336
82	Rhône-Alpes	74	1	18	165	Marigny-Saint-Marcel	650	21	671
82	Rhône-Alpes	74	4	27	166	Marin	1588	78	1666
82	Rhône-Alpes	74	1	14	167	Marlens	850	13	863
82	Rhône-Alpes	74	3	15	168	Marlioz	691	9	700
82	Rhône-Alpes	74	2	32	169	Marnaz	5169	133	5302
82	Rhône-Alpes	74	1	18	170	Massingy	830	28	858
82	Rhône-Alpes	74	4	12	171	Massongy	1424	33	1457
82	Rhône-Alpes	74	4	13	172	Maxilly-sur-Léman	1336	37	1373
82	Rhône-Alpes	74	2	22	173	Megève	3705	184	3889
82	Rhône-Alpes	74	2	20	174	Mégevette	527	8	535
82	Rhône-Alpes	74	4	13	175	Meillerie	314	4	318
82	Rhône-Alpes	74	1	30	176	Menthon-Saint-Bernard	1873	75	1948
82	Rhône-Alpes	74	3	11	177	Menthonnex-en-Bornes	926	4	930
82	Rhône-Alpes	74	3	24	178	Menthonnex-sous-Clermont	638	16	654
82	Rhône-Alpes	74	1	29	179	Mésigny	686	14	700
82	Rhône-Alpes	74	4	12	180	Messery	2103	47	2150
82	Rhône-Alpes	74	1	29	181	Metz-Tessy	2708	92	2800
82	Rhône-Alpes	74	1	29	182	Meythet	8421	162	8583
82	Rhône-Alpes	74	2	25	183	Mieussy	2116	54	2170
82	Rhône-Alpes	74	3	15	184	Minzier	862	13	875
82	Rhône-Alpes	74	3	16	185	Monnetier-Mornex	2229	46	2275
82	Rhône-Alpes	74	2	08	189	Mont-Saxonnex	1593	61	1654
82	Rhône-Alpes	74	1	33	186	Montagny-les-Lanches	590	17	607
82	Rhône-Alpes	74	1	14	187	Montmin	329	3	332
82	Rhône-Alpes	74	4	06	188	Montriond	819	26	845
82	Rhône-Alpes	74	2	23	190	Morillon	563	13	576
82	Rhône-Alpes	74	4	06	191	Morzine	2908	91	2999
82	Rhône-Alpes	74	1	18	192	Moye	1030	28	1058
82	Rhône-Alpes	74	3	16	193	La Muraz	1005	10	1015
82	Rhône-Alpes	74	1	02	194	Mûres	680	21	701
82	Rhône-Alpes	74	3	15	195	Musièges	364	9	373
82	Rhône-Alpes	74	2	32	196	Nancy-sur-Cluses	442	12	454
82	Rhône-Alpes	74	3	16	197	Nangy	1506	35	1541
82	Rhône-Alpes	74	1	30	198	Nâves-Parmelan	913	42	955
82	Rhône-Alpes	74	4	12	199	Nernier	459	13	472
82	Rhône-Alpes	74	4	13	200	Neuvecelle	2564	77	2641
82	Rhône-Alpes	74	3	21	201	Neydens	1513	45	1558
82	Rhône-Alpes	74	1	29	202	Nonglard	495	14	509
82	Rhône-Alpes	74	4	13	203	Novel	53	2	55
82	Rhône-Alpes	74	1	28	204	Les Ollières	839	18	857
82	Rhône-Alpes	74	2	20	205	Onnion	1193	24	1217
82	Rhône-Alpes	74	4	34	206	Orcier	800	20	820
82	Rhône-Alpes	74	2	19	208	Passy	11492	425	11917
82	Rhône-Alpes	74	2	08	209	Peillonnex	1422	40	1462
82	Rhône-Alpes	74	4	34	210	Perrignier	1611	31	1642
82	Rhône-Alpes	74	3	16	211	Pers-Jussy	2587	55	2642
82	Rhône-Alpes	74	2	08	212	Le Petit-Bornand-les-Glières	1144	15	1159
82	Rhône-Alpes	74	1	29	213	Poisy	6686	296	6982
82	Rhône-Alpes	74	2	22	215	Praz-sur-Arly	1334	59	1393
82	Rhône-Alpes	74	3	21	216	Présilly	681	15	696
82	Rhône-Alpes	74	1	30	217	Pringy	3984	145	4129
82	Rhône-Alpes	74	4	13	218	Publier	6240	183	6423
82	Rhône-Alpes	74	1	33	219	Quintal	1198	40	1238
82	Rhône-Alpes	74	3	16	220	Reignier-Ésery	6956	200	7156
82	Rhône-Alpes	74	2	32	221	Le Reposoir	503	6	509
82	Rhône-Alpes	74	4	27	222	Reyvroz	477	14	491
82	Rhône-Alpes	74	2	25	223	La Rivière-Enverse	451	11	462
82	Rhône-Alpes	74	2	17	224	La Roche-sur-Foron	10446	368	10814
82	Rhône-Alpes	74	1	18	225	Rumilly	13497	395	13892
82	Rhône-Alpes	74	4	07	226	Saint-André-de-Boëge	604	12	616
82	Rhône-Alpes	74	3	11	228	Saint-Blaise	325	5	330
82	Rhône-Alpes	74	3	05	229	Saint-Cergues	3157	57	3214
82	Rhône-Alpes	74	1	18	231	Saint-Eusèbe	442	5	447
82	Rhône-Alpes	74	1	33	232	Saint-Eustache	467	13	480
82	Rhône-Alpes	74	1	02	233	Saint-Félix	2168	44	2212
82	Rhône-Alpes	74	1	14	234	Saint-Ferréol	849	27	876
82	Rhône-Alpes	74	3	24	235	Saint-Germain-sur-Rhône	410	10	420
82	Rhône-Alpes	74	2	19	236	Saint-Gervais-les-Bains	5694	143	5837
82	Rhône-Alpes	74	4	13	237	Saint-Gingolph	759	15	774
82	Rhône-Alpes	74	4	06	238	Saint-Jean-d;Aulps	1180	21	1201
82	Rhône-Alpes	74	1	26	239	Saint-Jean-de-Sixt	1410	33	1443
82	Rhône-Alpes	74	2	20	240	Saint-Jean-de-Tholome	879	29	908
82	Rhône-Alpes	74	2	20	241	Saint-Jeoire	3197	102	3299
82	Rhône-Alpes	74	1	33	242	Saint-Jorioz	5717	223	5940
82	Rhône-Alpes	74	3	21	243	Saint-Julien-en-Genevois	11836	289	12125
82	Rhône-Alpes	74	2	17	244	Saint-Laurent	807	16	823
82	Rhône-Alpes	74	1	30	245	Saint-Martin-Bellevue	2445	59	2504
82	Rhône-Alpes	74	4	13	249	Saint-Paul-en-Chablais	2172	59	2231
82	Rhône-Alpes	74	2	17	250	Saint-Pierre-en-Faucigny	5872	158	6030
82	Rhône-Alpes	74	2	10	252	Saint-Sigismond	623	24	647
82	Rhône-Alpes	74	2	17	253	Saint-Sixt	898	30	928
82	Rhône-Alpes	74	1	02	254	Saint-Sylvestre	601	26	627
82	Rhône-Alpes	74	1	18	255	Sales	1616	50	1666
82	Rhône-Alpes	74	2	22	256	Sallanches	15531	653	16184
82	Rhône-Alpes	74	1	29	257	Sallenôves	574	12	586
82	Rhône-Alpes	74	2	23	258	Samoëns	2305	82	2387
82	Rhône-Alpes	74	3	11	259	Le Sappey	372	10	382
82	Rhône-Alpes	74	3	21	260	Savigny	736	7	743
82	Rhône-Alpes	74	4	07	261	Saxel	394	6	400
82	Rhône-Alpes	74	3	16	262	Scientrier	1094	10	1104
82	Rhône-Alpes	74	4	34	263	Sciez	5386	127	5513
82	Rhône-Alpes	74	2	32	264	Scionzier	7311	123	7434
82	Rhône-Alpes	74	1	26	265	Serraval	608	68	676
82	Rhône-Alpes	74	2	09	266	Servoz	926	48	974
82	Rhône-Alpes	74	1	33	267	Sévrier	3882	190	4072
82	Rhône-Alpes	74	1	33	268	Seynod	18842	657	19499
82	Rhône-Alpes	74	3	24	269	Seyssel	2353	63	2416
82	Rhône-Alpes	74	1	14	270	Seythenex	602	18	620
82	Rhône-Alpes	74	4	06	271	Seytroux	407	6	413
82	Rhône-Alpes	74	1	29	272	Sillingy	4470	100	4570
82	Rhône-Alpes	74	2	23	273	Sixt-Fer-à-Cheval	796	11	807
82	Rhône-Alpes	74	1	30	275	Talloires	1690	49	1739
82	Rhône-Alpes	74	2	25	276	Taninges	3398	100	3498
82	Rhône-Alpes	74	4	13	279	Thollon-les-Mémises	685	13	698
82	Rhône-Alpes	74	1	26	280	Thônes	5960	257	6217
82	Rhône-Alpes	74	4	95	281	Thonon-les-Bains	33925	1332	35257
82	Rhône-Alpes	74	1	28	282	Thorens-Glières	3108	75	3183
82	Rhône-Alpes	74	1	18	283	Thusy	907	15	922
82	Rhône-Alpes	74	2	08	278	Thyez	5671	176	5847
82	Rhône-Alpes	74	2	20	284	La Tour	1207	15	1222
82	Rhône-Alpes	74	3	24	285	Usinens	359	11	370
82	Rhône-Alpes	74	4	01	286	Vacheresse	775	26	801
82	Rhône-Alpes	74	4	27	287	Vailly	850	29	879
82	Rhône-Alpes	74	1	18	274	Val-de-Fier	551	7	558
82	Rhône-Alpes	74	3	21	288	Valleiry	3195	44	3239
82	Rhône-Alpes	74	1	18	289	Vallières	1446	45	1491
82	Rhône-Alpes	74	2	09	290	Vallorcine	429	9	438
82	Rhône-Alpes	74	3	15	291	Vanzy	303	9	312
82	Rhône-Alpes	74	1	18	292	Vaulx	847	20	867
82	Rhône-Alpes	74	4	12	293	Veigy-Foncenex	3568	82	3650
82	Rhône-Alpes	74	2	23	294	Verchaix	664	21	685
82	Rhône-Alpes	74	4	06	295	La Vernaz	294	4	298
82	Rhône-Alpes	74	3	21	296	Vers	702	16	718
82	Rhône-Alpes	74	1	18	297	Versonnex	549	11	560
82	Rhône-Alpes	74	3	31	298	Vétraz-Monthoux	6829	301	7130
82	Rhône-Alpes	74	1	30	299	Veyrier-du-Lac	2218	92	2310
82	Rhône-Alpes	74	4	07	301	Villard	753	15	768
82	Rhône-Alpes	74	1	26	302	Les Villards-sur-Thônes	1011	31	1042
82	Rhône-Alpes	74	1	28	303	Villaz	2818	70	2888
82	Rhône-Alpes	74	2	20	304	Ville-en-Sallaz	683	20	703
82	Rhône-Alpes	74	3	05	305	Ville-la-Grand	7881	181	8062
82	Rhône-Alpes	74	3	11	306	Villy-le-Bouveret	565	5	570
82	Rhône-Alpes	74	1	30	307	Villy-le-Pelloux	871	17	888
82	Rhône-Alpes	74	4	13	308	Vinzier	748	30	778
82	Rhône-Alpes	74	3	21	309	Viry	3525	101	3626
82	Rhône-Alpes	74	2	20	311	Viuz-en-Sallaz	3889	108	3997
82	Rhône-Alpes	74	1	02	310	Viuz-la-Chiésaz	1262	33	1295
82	Rhône-Alpes	74	2	08	312	Vougy	1482	34	1516
82	Rhône-Alpes	74	3	11	313	Vovray-en-Bornes	363	5	368
82	Rhône-Alpes	74	3	21	314	Vulbens	966	18	984
82	Rhône-Alpes	74	4	12	315	Yvoire	849	26	875
11	Île-de-France	75	1	15	101	Paris 1er Arrondissement	17308	163	17471
11	Île-de-France	75	1	16	102	Paris 2e  Arrondissement	23009	157	23166
11	Île-de-France	75	1	17	103	Paris 3e  Arrondissement	35652	702	36354
11	Île-de-France	75	1	18	104	Paris 4e  Arrondissement	28012	283	28295
11	Île-de-France	75	1	19	105	Paris 5e  Arrondissement	60938	826	61764
11	Île-de-France	75	1	20	106	Paris 6e  Arrondissement	43451	876	44327
11	Île-de-France	75	1	21	107	Paris 7e  Arrondissement	57974	885	58859
11	Île-de-France	75	1	22	108	Paris 8e  Arrondissement	41280	598	41878
11	Île-de-France	75	1	23	109	Paris 9e  Arrondissement	60139	797	60936
11	Île-de-France	75	1	24	110	Paris 10e  Arrondissement	95394	843	96237
11	Île-de-France	75	1	25	111	Paris 11e  Arrondissement	153202	1783	154985
11	Île-de-France	75	1	26	112	Paris 12e  Arrondissement	144262	1704	145966
11	Île-de-France	75	1	27	113	Paris 13e  Arrondissement	181532	1916	183448
11	Île-de-France	75	1	28	114	Paris 14e  Arrondissement	138299	1318	139617
11	Île-de-France	75	1	29	115	Paris 15e  Arrondissement	236715	2390	239105
11	Île-de-France	75	1	30	116	Paris 16e  Arrondissement	171124	2629	173753
11	Île-de-France	75	1	31	117	Paris 17e  Arrondissement	169325	1754	171079
11	Île-de-France	75	1	32	118	Paris 18e  Arrondissement	202685	1349	204034
11	Île-de-France	75	1	33	119	Paris 19e  Arrondissement	186652	1763	188415
11	Île-de-France	75	1	34	120	Paris 20e  Arrondissement	196880	1696	198576
23	Haute-Normandie	76	3	55	001	Allouville-Bellefosse	1168	27	1195
23	Haute-Normandie	76	2	20	002	Alvimare	536	4	540
23	Haute-Normandie	76	1	39	004	Ambrumesnil	526	7	533
23	Haute-Normandie	76	3	07	005	Amfreville-la-Mi-Voie	3112	36	3148
23	Haute-Normandie	76	3	15	006	Amfreville-les-Champs	160	0	160
23	Haute-Normandie	76	3	11	007	Anceaumeville	699	14	713
23	Haute-Normandie	76	1	14	008	Ancourt	723	7	730
23	Haute-Normandie	76	2	40	009	Ancourteville-sur-Héricourt	263	3	266
23	Haute-Normandie	76	3	54	010	Ancretiéville-Saint-Victor	365	7	372
23	Haute-Normandie	76	2	53	011	Ancretteville-sur-Mer	196	4	200
23	Haute-Normandie	76	2	24	012	Angerville-Bailleul	214	5	219
23	Haute-Normandie	76	2	12	014	Angerville-l;Orcher	1470	15	1485
23	Haute-Normandie	76	2	53	013	Angerville-la-Martel	898	26	924
23	Haute-Normandie	76	1	22	015	Angiens	569	10	579
23	Haute-Normandie	76	2	12	017	Anglesqueville-l;Esneval	549	8	557
23	Haute-Normandie	76	1	22	016	Anglesqueville-la-Bras-Long	119	2	121
23	Haute-Normandie	76	3	16	020	Anneville-Ambourville	1214	15	1229
23	Haute-Normandie	76	1	35	019	Anneville-sur-Scie	465	27	492
23	Haute-Normandie	76	2	24	021	Annouville-Vilmesnil	489	1	490
23	Haute-Normandie	76	3	10	022	Anquetierville	361	7	368
23	Haute-Normandie	76	2	40	023	Anvéville	263	7	270
23	Haute-Normandie	76	1	04	024	Ardouval	176	0	176
23	Haute-Normandie	76	1	01	025	Argueil	345	6	351
23	Haute-Normandie	76	1	39	026	Arques-la-Bataille	2549	36	2585
23	Haute-Normandie	76	1	18	027	Assigny	358	8	366
23	Haute-Normandie	76	1	02	028	Aubéguimont	205	2	207
23	Haute-Normandie	76	1	05	029	Aubermesnil-aux-Érables	203	5	208
23	Haute-Normandie	76	1	39	030	Aubermesnil-Beaumais	462	15	477
23	Haute-Normandie	76	2	33	031	Auberville-la-Campagne	616	8	624
23	Haute-Normandie	76	1	09	032	Auberville-la-Manuel	119	0	119
23	Haute-Normandie	76	2	24	033	Auberville-la-Renault	410	6	416
23	Haute-Normandie	76	1	52	034	Auffay	1857	33	1890
23	Haute-Normandie	76	1	02	035	Aumale	2388	50	2438
23	Haute-Normandie	76	1	03	036	Auppegard	718	9	727
23	Haute-Normandie	76	1	18	037	Auquemesnil	285	4	289
23	Haute-Normandie	76	3	11	038	Authieux-Ratiéville	405	10	415
23	Haute-Normandie	76	3	07	039	Les Authieux-sur-le-Port-Saint-Ouen	1212	33	1245
23	Haute-Normandie	76	1	22	040	Autigny	276	4	280
23	Haute-Normandie	76	3	55	041	Autretot	704	13	717
23	Haute-Normandie	76	1	38	042	Auvilliers	112	0	112
23	Haute-Normandie	76	3	55	043	Auzebosc	1071	258	1329
23	Haute-Normandie	76	2	20	044	Auzouville-Auberbosc	266	3	269
23	Haute-Normandie	76	3	54	045	Auzouville-l;Esneval	354	10	364
23	Haute-Normandie	76	3	13	046	Auzouville-sur-Ry	626	20	646
23	Haute-Normandie	76	1	03	047	Auzouville-sur-Saâne	148	4	152
23	Haute-Normandie	76	1	25	048	Avesnes-en-Bray	325	5	330
23	Haute-Normandie	76	1	18	049	Avesnes-en-Val	272	1	273
23	Haute-Normandie	76	1	03	050	Avremesnil	963	28	991
23	Haute-Normandie	76	1	03	051	Bacqueville-en-Caux	1797	28	1825
23	Haute-Normandie	76	1	34	052	Bailleul-Neuville	179	5	184
23	Haute-Normandie	76	1	34	053	Baillolet	120	4	124
23	Haute-Normandie	76	1	18	054	Bailly-en-Rivière	556	4	560
23	Haute-Normandie	76	3	55	055	Baons-le-Comte	343	9	352
23	Haute-Normandie	76	3	16	056	Bardouville	658	8	666
23	Haute-Normandie	76	3	41	057	Barentin	12108	263	12371
23	Haute-Normandie	76	1	19	058	Baromesnil	248	9	257
23	Haute-Normandie	76	1	05	059	Bazinval	357	5	362
23	Haute-Normandie	76	1	23	060	Beaubec-la-Rosière	473	10	483
23	Haute-Normandie	76	1	04	062	Beaumont-le-Hareng	224	3	227
23	Haute-Normandie	76	2	12	064	Beaurepaire	476	7	483
23	Haute-Normandie	76	1	23	065	Beaussault	388	8	396
23	Haute-Normandie	76	3	41	066	Beautot	121	2	123
23	Haute-Normandie	76	1	52	063	Beauval-en-Caux	461	15	476
23	Haute-Normandie	76	1	01	067	Beauvoir-en-Lyons	594	7	601
23	Haute-Normandie	76	2	24	068	Bec-de-Mortagne	686	14	700
23	Haute-Normandie	76	3	07	069	Belbeuf	2011	69	2080
23	Haute-Normandie	76	1	04	070	Bellencombre	687	8	695
23	Haute-Normandie	76	1	18	071	Bellengreville	461	7	468
23	Haute-Normandie	76	1	52	072	Belleville-en-Caux	603	4	607
23	Haute-Normandie	76	1	14	073	Belleville-sur-Mer	785	10	795
23	Haute-Normandie	76	1	23	074	La Bellière	54	2	56
23	Haute-Normandie	76	1	35	075	Belmesnil	498	6	504
23	Haute-Normandie	76	2	24	076	Bénarville	241	1	242
23	Haute-Normandie	76	3	15	077	Bénesville	185	0	185
23	Haute-Normandie	76	2	20	078	Bennetot	191	3	194
23	Haute-Normandie	76	2	12	079	Bénouville	151	4	155
23	Haute-Normandie	76	2	20	080	Bermonville	504	5	509
23	Haute-Normandie	76	1	14	081	Berneval-le-Grand	1327	32	1359
23	Haute-Normandie	76	2	06	082	Bernières	661	9	670
23	Haute-Normandie	76	1	09	083	Bertheauville	120	0	120
23	Haute-Normandie	76	1	09	084	Bertreville	100	1	101
23	Haute-Normandie	76	1	35	085	Bertreville-Saint-Ouen	342	11	353
23	Haute-Normandie	76	1	52	086	Bertrimont	238	3	241
23	Haute-Normandie	76	3	15	087	Berville	547	7	554
23	Haute-Normandie	76	3	16	088	Berville-sur-Seine	554	3	557
23	Haute-Normandie	76	3	41	089	Betteville	549	16	565
23	Haute-Normandie	76	2	06	090	Beuzeville-la-Grenier	1056	14	1070
23	Haute-Normandie	76	2	40	091	Beuzeville-la-Guérard	183	5	188
23	Haute-Normandie	76	2	06	092	Beuzevillette	713	4	717
23	Haute-Normandie	76	1	25	093	Bézancourt	335	12	347
23	Haute-Normandie	76	3	08	094	Bierville	273	2	275
23	Haute-Normandie	76	1	52	096	Biville-la-Baignarde	627	13	640
23	Haute-Normandie	76	1	03	097	Biville-la-Rivière	104	5	109
23	Haute-Normandie	76	1	18	098	Biville-sur-Mer	704	8	712
23	Haute-Normandie	76	3	41	099	Blacqueville	599	14	613
23	Haute-Normandie	76	3	08	100	Blainville-Crevon	1156	28	1184
23	Haute-Normandie	76	1	05	101	Blangy-sur-Bresle	2930	41	2971
23	Haute-Normandie	76	1	50	104	Blosseville	302	14	316
23	Haute-Normandie	76	3	11	105	Le Bocasse	732	12	744
23	Haute-Normandie	76	3	13	106	Bois-d;Ennebourg	517	7	524
23	Haute-Normandie	76	3	08	107	Bois-Guilbert	276	3	279
23	Haute-Normandie	76	3	60	108	Bois-Guillaume - Bihorel	21270	606	21876
23	Haute-Normandie	76	3	08	109	Bois-Héroult	174	6	180
23	Haute-Normandie	76	3	55	110	Bois-Himont	441	5	446
23	Haute-Normandie	76	3	13	111	Bois-l;Évêque	483	10	493
23	Haute-Normandie	76	1	35	112	Le Bois-Robert	318	9	327
23	Haute-Normandie	76	3	08	113	Boissay	334	2	336
23	Haute-Normandie	76	2	06	114	Bolbec	11812	129	11941
23	Haute-Normandie	76	2	06	115	Bolleville	542	3	545
23	Haute-Normandie	76	3	07	103	Bonsecours	6567	126	6693
23	Haute-Normandie	76	3	07	116	Boos	3248	41	3289
23	Haute-Normandie	76	2	12	117	Bordeaux-Saint-Clair	623	12	635
23	Haute-Normandie	76	2	24	118	Bornambusc	283	2	285
23	Haute-Normandie	76	1	49	119	Bosc-Bérenger	187	0	187
23	Haute-Normandie	76	3	08	120	Bosc-Bordel	440	9	449
23	Haute-Normandie	76	3	08	121	Bosc-Édeline	324	1	325
23	Haute-Normandie	76	3	11	123	Bosc-Guérard-Saint-Adrien	861	17	878
23	Haute-Normandie	76	1	25	124	Bosc-Hyons	399	7	406
23	Haute-Normandie	76	1	04	125	Bosc-le-Hard	1491	20	1511
23	Haute-Normandie	76	1	49	126	Bosc-Mesnil	287	7	294
23	Haute-Normandie	76	3	08	127	Bosc-Roger-sur-Buchy	736	12	748
23	Haute-Normandie	76	1	09	128	Bosville	539	9	548
23	Haute-Normandie	76	3	15	129	Boudeville	204	3	207
23	Haute-Normandie	76	1	38	130	Bouelles	254	6	260
23	Haute-Normandie	76	3	26	131	La Bouille	780	12	792
23	Haute-Normandie	76	3	54	132	Bourdainville	438	3	441
23	Haute-Normandie	76	1	39	133	Le Bourg-Dun	445	11	456
23	Haute-Normandie	76	1	22	134	Bourville	297	8	305
23	Haute-Normandie	76	3	41	135	Bouville	922	18	940
23	Haute-Normandie	76	1	03	136	Brachy	724	7	731
23	Haute-Normandie	76	1	14	137	Bracquemont	880	27	907
23	Haute-Normandie	76	1	52	138	Bracquetuit	323	5	328
23	Haute-Normandie	76	1	49	139	Bradiancourt	226	0	226
23	Haute-Normandie	76	1	22	140	Brametot	160	4	164
23	Haute-Normandie	76	2	24	141	Bréauté	1315	15	1330
23	Haute-Normandie	76	1	25	142	Brémontier-Merval	499	86	585
23	Haute-Normandie	76	2	24	143	Bretteville-du-Grand-Caux	1278	14	1292
23	Haute-Normandie	76	3	15	144	Bretteville-Saint-Laurent	173	3	176
23	Haute-Normandie	76	1	18	145	Brunville	261	3	264
23	Haute-Normandie	76	3	08	146	Buchy	1415	90	1505
23	Haute-Normandie	76	1	38	147	Bully	885	22	907
23	Haute-Normandie	76	1	34	148	Bures-en-Bray	335	4	339
23	Haute-Normandie	76	3	41	149	Butot	296	6	302
23	Haute-Normandie	76	1	09	732	Butot-Vénesville	248	10	258
23	Haute-Normandie	76	1	50	151	Cailleville	259	5	264
23	Haute-Normandie	76	3	11	152	Cailly	713	10	723
23	Haute-Normandie	76	1	38	122	Callengeville	494	8	502
23	Haute-Normandie	76	1	52	153	Calleville-les-Deux-Églises	326	2	328
23	Haute-Normandie	76	1	05	154	Campneuseville	505	8	513
23	Haute-Normandie	76	1	19	155	Canehan	324	6	330
23	Haute-Normandie	76	1	09	156	Canouville	321	3	324
23	Haute-Normandie	76	3	36	157	Canteleu	14825	456	15281
23	Haute-Normandie	76	3	15	158	Canville-les-Deux-Églises	326	8	334
23	Haute-Normandie	76	1	09	159	Cany-Barville	3056	69	3125
23	Haute-Normandie	76	3	41	160	Carville-la-Folletière	396	1	397
23	Haute-Normandie	76	2	40	161	Carville-Pot-de-Fer	99	3	102
23	Haute-Normandie	76	1	35	162	Le Catelier	216	8	224
23	Haute-Normandie	76	3	08	163	Catenay	709	15	724
23	Haute-Normandie	76	3	10	164	Caudebec-en-Caux	2279	33	2312
23	Haute-Normandie	76	3	61	165	Caudebec-lès-Elbeuf	9788	119	9907
23	Haute-Normandie	76	1	02	166	Le Caule-Sainte-Beuve	454	8	462
23	Haute-Normandie	76	2	37	167	Cauville-sur-Mer	1435	28	1463
23	Haute-Normandie	76	1	35	168	Les Cent-Acres	36	4	40
23	Haute-Normandie	76	2	48	169	La Cerlangue	1290	81	1371
23	Haute-Normandie	76	1	35	170	La Chapelle-du-Bourgay	129	1	130
23	Haute-Normandie	76	1	01	171	La Chapelle-Saint-Ouen	99	3	102
23	Haute-Normandie	76	1	22	172	La Chapelle-sur-Dun	187	6	193
23	Haute-Normandie	76	1	35	173	La Chaussée	489	3	492
23	Haute-Normandie	76	3	54	174	Cideville	296	4	300
23	Haute-Normandie	76	1	34	175	Clais	227	4	231
23	Haute-Normandie	76	1	09	176	Clasville	263	8	271
23	Haute-Normandie	76	3	11	177	Claville-Motteville	268	1	269
23	Haute-Normandie	76	3	61	178	Cléon	5606	71	5677
23	Haute-Normandie	76	3	11	179	Clères	1347	18	1365
23	Haute-Normandie	76	2	40	180	Cleuville	170	2	172
23	Haute-Normandie	76	2	20	181	Cléville	162	3	165
23	Haute-Normandie	76	2	20	182	Cliponville	259	8	267
23	Haute-Normandie	76	2	53	183	Colleville	749	14	763
23	Haute-Normandie	76	1	39	184	Colmesnil-Manneville	110	9	119
23	Haute-Normandie	76	1	23	185	Compainville	149	3	152
23	Haute-Normandie	76	1	02	186	Conteville	526	6	532
23	Haute-Normandie	76	2	53	187	Contremoulins	196	10	206
23	Haute-Normandie	76	1	04	188	Cottévrard	393	4	397
23	Haute-Normandie	76	1	09	189	Crasville-la-Mallet	164	4	168
23	Haute-Normandie	76	1	22	190	Crasville-la-Rocquefort	220	4	224
23	Haute-Normandie	76	1	04	191	Cressy	281	1	282
23	Haute-Normandie	76	1	19	192	Criel-sur-Mer	2789	60	2849
23	Haute-Normandie	76	1	04	193	La Crique	367	6	373
23	Haute-Normandie	76	2	21	194	Criquebeuf-en-Caux	373	16	389
23	Haute-Normandie	76	2	12	196	Criquetot-l;Esneval	2337	101	2438
23	Haute-Normandie	76	2	53	195	Criquetot-le-Mauconduit	171	4	175
23	Haute-Normandie	76	1	35	197	Criquetot-sur-Longueville	194	2	196
23	Haute-Normandie	76	3	54	198	Criquetot-sur-Ouville	739	8	747
23	Haute-Normandie	76	1	02	199	Criquiers	676	6	682
23	Haute-Normandie	76	1	49	200	Critot	509	19	528
23	Haute-Normandie	76	1	01	201	Croisy-sur-Andelle	522	1	523
23	Haute-Normandie	76	3	41	203	Croix-Mare	700	6	706
23	Haute-Normandie	76	1	34	202	Croixdalle	218	7	225
23	Haute-Normandie	76	1	04	204	Cropus	236	0	236
23	Haute-Normandie	76	1	35	205	Crosville-sur-Scie	242	6	248
23	Haute-Normandie	76	2	12	206	Cuverville	348	4	352
23	Haute-Normandie	76	1	19	207	Cuverville-sur-Yères	216	6	222
23	Haute-Normandie	76	1	25	208	Cuy-Saint-Fiacre	644	20	664
23	Haute-Normandie	76	1	25	209	Dampierre-en-Bray	449	16	465
23	Haute-Normandie	76	1	18	210	Dampierre-Saint-Nicolas	518	8	526
23	Haute-Normandie	76	1	05	211	Dancourt	233	4	237
23	Haute-Normandie	76	3	13	212	Darnétal	9567	122	9689
23	Haute-Normandie	76	2	24	213	Daubeuf-Serville	381	9	390
23	Haute-Normandie	76	1	35	214	Dénestanville	221	6	227
23	Haute-Normandie	76	1	14	215	Derchigny	562	11	573
23	Haute-Normandie	76	3	65	216	Déville-lès-Rouen	10188	98	10286
23	Haute-Normandie	76	1	95	217	Dieppe	31963	1003	32966
23	Haute-Normandie	76	1	25	218	Doudeauville	93	2	95
23	Haute-Normandie	76	3	15	219	Doudeville	2568	85	2653
23	Haute-Normandie	76	1	18	220	Douvrend	489	2	491
23	Haute-Normandie	76	1	50	221	Drosay	189	7	196
23	Haute-Normandie	76	3	16	222	Duclair	4134	62	4196
23	Haute-Normandie	76	3	41	223	Écalles-Alix	488	15	503
23	Haute-Normandie	76	2	24	224	Écrainville	1026	16	1042
23	Haute-Normandie	76	3	55	225	Écretteville-lès-Baons	407	8	415
23	Haute-Normandie	76	2	53	226	Écretteville-sur-Mer	135	1	136
23	Haute-Normandie	76	3	54	227	Ectot-l;Auber	582	13	595
23	Haute-Normandie	76	3	54	228	Ectot-lès-Baons	406	6	412
23	Haute-Normandie	76	3	17	231	Elbeuf	17178	274	17452
23	Haute-Normandie	76	1	25	229	Elbeuf-en-Bray	398	9	407
23	Haute-Normandie	76	3	13	230	Elbeuf-sur-Andelle	411	3	414
23	Haute-Normandie	76	2	53	232	Életot	614	14	628
23	Haute-Normandie	76	1	02	233	Ellecourt	131	8	139
23	Haute-Normandie	76	3	41	234	Émanville	577	5	582
23	Haute-Normandie	76	1	18	235	Envermeu	2082	151	2233
23	Haute-Normandie	76	2	20	236	Envronville	314	10	324
23	Haute-Normandie	76	3	16	237	Épinay-sur-Duclair	509	3	512
23	Haute-Normandie	76	2	37	238	Épouville	2788	50	2838
23	Haute-Normandie	76	2	48	239	Épretot	743	6	749
23	Haute-Normandie	76	2	21	240	Épreville	1015	17	1032
23	Haute-Normandie	76	1	22	241	Ermenouville	160	9	169
23	Haute-Normandie	76	1	25	242	Ernemont-la-Villette	195	3	198
23	Haute-Normandie	76	3	08	243	Ernemont-sur-Buchy	243	4	247
23	Haute-Normandie	76	1	38	244	Esclavelles	387	6	393
23	Haute-Normandie	76	3	11	245	Eslettes	1508	20	1528
23	Haute-Normandie	76	3	11	247	Esteville	523	2	525
23	Haute-Normandie	76	3	08	248	Estouteville-Écalles	469	4	473
23	Haute-Normandie	76	1	52	249	Étaimpuis	711	7	718
23	Haute-Normandie	76	2	48	250	Étainhus	1065	14	1079
23	Haute-Normandie	76	3	15	251	Étalleville	435	6	441
23	Haute-Normandie	76	1	19	252	Étalondes	1154	37	1191
23	Haute-Normandie	76	3	54	253	Étoutteville	711	9	720
23	Haute-Normandie	76	2	12	254	Étretat	1499	31	1530
23	Haute-Normandie	76	1	19	255	Eu	7436	213	7649
23	Haute-Normandie	76	1	05	257	Fallencourt	192	0	192
23	Haute-Normandie	76	2	20	258	Fauville-en-Caux	2159	58	2217
23	Haute-Normandie	76	2	21	259	Fécamp	19207	374	19581
23	Haute-Normandie	76	1	25	260	Ferrières-en-Bray	1628	29	1657
23	Haute-Normandie	76	1	23	261	La Ferté-Saint-Samson	455	5	460
23	Haute-Normandie	76	1	38	262	Fesques	130	2	132
23	Haute-Normandie	76	1	01	263	La Feuillie	1262	24	1286
23	Haute-Normandie	76	3	54	264	Flamanville	431	6	437
23	Haute-Normandie	76	1	38	265	Flamets-Frétils	168	8	176
23	Haute-Normandie	76	1	19	266	Flocques	701	9	710
23	Haute-Normandie	76	3	41	267	La Folletière	66	6	72
23	Haute-Normandie	76	2	12	268	Fongueusemare	182	2	184
23	Haute-Normandie	76	1	49	269	Fontaine-en-Bray	159	3	162
23	Haute-Normandie	76	2	37	270	Fontaine-la-Mallet	2692	94	2786
23	Haute-Normandie	76	3	11	271	Fontaine-le-Bourg	1426	23	1449
23	Haute-Normandie	76	1	22	272	Fontaine-le-Dun	882	29	911
23	Haute-Normandie	76	3	13	273	Fontaine-sous-Préaux	510	17	527
23	Haute-Normandie	76	1	52	274	La Fontelaye	34	0	34
23	Haute-Normandie	76	2	37	275	Fontenay	1032	24	1056
23	Haute-Normandie	76	1	23	276	Forges-les-Eaux	3504	252	3756
23	Haute-Normandie	76	1	23	277	Le Fossé	478	5	483
23	Haute-Normandie	76	1	05	278	Foucarmont	984	15	999
23	Haute-Normandie	76	2	20	279	Foucart	358	13	371
23	Haute-Normandie	76	3	07	475	Franqueville-Saint-Pierre	5734	209	5943
23	Haute-Normandie	76	1	34	280	Fréauville	133	3	136
23	Haute-Normandie	76	2	33	281	La Frénaye	1974	51	2025
23	Haute-Normandie	76	3	61	282	Freneuse	931	12	943
23	Haute-Normandie	76	1	38	283	Fresles	236	4	240
23	Haute-Normandie	76	1	52	284	Fresnay-le-Long	304	8	312
23	Haute-Normandie	76	3	07	285	Fresne-le-Plan	613	14	627
23	Haute-Normandie	76	1	34	286	Fresnoy-Folny	708	5	713
23	Haute-Normandie	76	3	41	287	Fresquiennes	1066	8	1074
23	Haute-Normandie	76	1	18	288	Freulleville	355	6	361
23	Haute-Normandie	76	3	41	289	Fréville	864	9	873
23	Haute-Normandie	76	3	11	290	Frichemesnil	424	8	432
23	Haute-Normandie	76	2	21	291	Froberville	1008	20	1028
23	Haute-Normandie	76	1	01	292	Fry	152	2	154
23	Haute-Normandie	76	3	15	293	Fultot	205	4	209
23	Haute-Normandie	76	1	22	294	La Gaillarde	417	14	431
23	Haute-Normandie	76	1	23	295	Gaillefontaine	1311	23	1334
23	Haute-Normandie	76	2	63	296	Gainneville	2688	24	2712
23	Haute-Normandie	76	1	25	297	Gancourt-Saint-Étienne	234	4	238
23	Haute-Normandie	76	2	21	298	Ganzeville	455	9	464
23	Haute-Normandie	76	2	53	299	Gerponville	382	7	389
23	Haute-Normandie	76	2	21	300	Gerville	401	8	409
23	Haute-Normandie	76	1	18	301	Glicourt	213	2	215
23	Haute-Normandie	76	2	24	302	Goderville	2891	33	2924
23	Haute-Normandie	76	2	48	303	Gommerville	719	15	734
23	Haute-Normandie	76	2	24	304	Gonfreville-Caillot	324	6	330
23	Haute-Normandie	76	2	63	305	Gonfreville-l;Orcher	9084	73	9157
23	Haute-Normandie	76	1	03	306	Gonnetot	155	3	158
23	Haute-Normandie	76	2	12	307	Gonneville-la-Mallet	1318	18	1336
23	Haute-Normandie	76	1	52	308	Gonneville-sur-Scie	436	8	444
23	Haute-Normandie	76	3	15	309	Gonzeville	106	3	109
23	Haute-Normandie	76	1	18	310	Gouchaupre	173	6	179
23	Haute-Normandie	76	3	41	311	Goupillières	425	6	431
23	Haute-Normandie	76	1	25	312	Gournay-en-Bray	6396	137	6533
23	Haute-Normandie	76	3	07	313	Gouy	810	15	825
23	Haute-Normandie	76	2	48	314	Graimbouville	590	8	598
23	Haute-Normandie	76	1	09	315	Grainville-la-Teinturière	1045	71	1116
23	Haute-Normandie	76	3	13	316	Grainville-sur-Ry	450	6	456
23	Haute-Normandie	76	2	24	317	Grainville-Ymauville	406	7	413
23	Haute-Normandie	76	2	33	318	Grand-Camp	668	24	692
23	Haute-Normandie	76	3	26	319	Grand-Couronne	9713	195	9908
23	Haute-Normandie	76	3	94	322	Le Grand-Quevilly	24930	259	25189
23	Haute-Normandie	76	1	34	320	Grandcourt	358	4	362
23	Haute-Normandie	76	1	04	321	Les Grandes-Ventes	1766	30	1796
23	Haute-Normandie	76	1	38	323	Graval	138	2	140
23	Haute-Normandie	76	1	14	324	Grèges	801	11	812
23	Haute-Normandie	76	3	54	325	Grémonville	392	3	395
23	Haute-Normandie	76	1	18	326	Greny	144	2	146
23	Haute-Normandie	76	1	03	327	Greuville	370	5	375
23	Haute-Normandie	76	1	04	328	Grigneuseville	317	0	317
23	Haute-Normandie	76	2	06	329	Gruchet-le-Valasse	2811	57	2868
23	Haute-Normandie	76	1	03	330	Gruchet-Saint-Siméon	700	17	717
23	Haute-Normandie	76	3	11	331	Grugny	920	9	929
23	Haute-Normandie	76	1	23	332	Grumesnil	479	7	486
23	Haute-Normandie	76	1	05	333	Guerville	457	5	462
23	Haute-Normandie	76	1	03	334	Gueures	519	7	526
23	Haute-Normandie	76	3	41	335	Gueutteville	79	3	82
23	Haute-Normandie	76	1	50	336	Gueutteville-les-Grès	356	9	365
23	Haute-Normandie	76	1	18	337	Guilmécourt	301	3	304
23	Haute-Normandie	76	1	01	338	La Hallotière	174	1	175
23	Haute-Normandie	76	2	40	339	Le Hanouard	241	5	246
23	Haute-Normandie	76	3	15	340	Harcanville	459	10	469
23	Haute-Normandie	76	2	63	341	Harfleur	8158	116	8274
23	Haute-Normandie	76	2	20	342	Hattenville	670	8	678
23	Haute-Normandie	76	1	23	343	Haucourt	256	2	258
23	Haute-Normandie	76	1	02	344	Haudricourt	465	9	474
23	Haute-Normandie	76	1	23	345	Haussez	285	5	290
23	Haute-Normandie	76	2	40	346	Hautot-l;Auvray	328	5	333
23	Haute-Normandie	76	2	20	347	Hautot-le-Vatois	299	7	306
23	Haute-Normandie	76	3	15	348	Hautot-Saint-Sulpice	606	16	622
23	Haute-Normandie	76	1	39	349	Hautot-sur-Mer	1977	74	2051
23	Haute-Normandie	76	3	26	350	Hautot-sur-Seine	365	6	371
23	Haute-Normandie	76	2	98	351	Le Havre	175497	2573	178070
23	Haute-Normandie	76	1	01	352	La Haye	312	4	316
23	Haute-Normandie	76	1	22	353	Héberville	105	2	107
23	Haute-Normandie	76	3	16	354	Hénouville	1241	29	1270
23	Haute-Normandie	76	2	40	355	Héricourt-en-Caux	959	25	984
23	Haute-Normandie	76	1	03	356	Hermanville	104	1	105
23	Haute-Normandie	76	2	12	357	Hermeville	373	2	375
23	Haute-Normandie	76	3	13	358	Le Héron	242	4	246
23	Haute-Normandie	76	3	08	359	Héronchelles	121	2	123
23	Haute-Normandie	76	1	35	360	Heugleville-sur-Scie	596	7	603
23	Haute-Normandie	76	2	12	361	Heuqueville	673	3	676
23	Haute-Normandie	76	3	10	362	Heurteauville	331	7	338
23	Haute-Normandie	76	1	05	363	Hodeng-au-Bosc	585	3	588
23	Haute-Normandie	76	1	01	364	Hodeng-Hodenger	274	9	283
23	Haute-Normandie	76	1	22	365	Houdetot	171	7	178
23	Haute-Normandie	76	3	66	366	Le Houlme	4019	43	4062
23	Haute-Normandie	76	3	66	367	Houppeville	2531	65	2596
23	Haute-Normandie	76	2	24	368	Houquetot	341	1	342
23	Haute-Normandie	76	3	11	369	La Houssaye-Béranger	544	4	548
23	Haute-Normandie	76	3	54	370	Hugleville-en-Caux	398	5	403
23	Haute-Normandie	76	1	18	371	Les Ifs	52	1	53
23	Haute-Normandie	76	1	02	372	Illois	339	2	341
23	Haute-Normandie	76	1	52	373	Imbleville	304	2	306
23	Haute-Normandie	76	1	19	374	Incheville	1334	16	1350
23	Haute-Normandie	76	1	50	375	Ingouville	248	13	261
23	Haute-Normandie	76	1	18	376	Intraville	263	4	267
23	Haute-Normandie	76	3	60	377	Isneauville	2490	71	2561
23	Haute-Normandie	76	3	16	378	Jumièges	1736	11	1747
23	Haute-Normandie	76	1	03	379	Lamberville	169	2	171
23	Haute-Normandie	76	1	03	380	Lammerville	321	8	329
23	Haute-Normandie	76	1	02	381	Landes-Vieilles-et-Neuves	135	5	140
23	Haute-Normandie	76	2	06	382	Lanquetot	1040	8	1048
23	Haute-Normandie	76	1	03	383	Lestanville	97	1	98
23	Haute-Normandie	76	2	33	384	Lillebonne	8944	186	9130
23	Haute-Normandie	76	3	41	385	Limésy	1434	120	1554
23	Haute-Normandie	76	2	53	386	Limpiville	348	7	355
23	Haute-Normandie	76	3	54	387	Lindebeuf	364	5	369
23	Haute-Normandie	76	2	06	388	Lintot	460	8	468
23	Haute-Normandie	76	1	35	389	Lintot-les-Bois	186	4	190
23	Haute-Normandie	76	2	21	390	Les Loges	1153	24	1177
23	Haute-Normandie	76	3	17	391	La Londe	2271	48	2319
23	Haute-Normandie	76	1	34	392	Londinières	1266	20	1286
23	Haute-Normandie	76	1	23	393	Longmesnil	61	1	62
23	Haute-Normandie	76	1	19	394	Longroy	669	11	680
23	Haute-Normandie	76	1	39	395	Longueil	560	8	568
23	Haute-Normandie	76	3	08	396	Longuerue	302	4	306
23	Haute-Normandie	76	1	35	397	Longueville-sur-Scie	996	13	1009
23	Haute-Normandie	76	3	10	398	Louvetot	685	12	697
23	Haute-Normandie	76	1	38	399	Lucy	168	3	171
23	Haute-Normandie	76	1	03	400	Luneray	2137	54	2191
23	Haute-Normandie	76	3	10	401	La Mailleraye-sur-Seine	2063	20	2083
23	Haute-Normandie	76	3	66	402	Malaunay	5925	64	5989
23	Haute-Normandie	76	1	09	403	Malleville-les-Grès	155	6	161
23	Haute-Normandie	76	2	37	404	Manéglise	1141	20	1161
23	Haute-Normandie	76	1	35	405	Manéhouville	217	0	217
23	Haute-Normandie	76	2	21	406	Maniquerville	477	4	481
23	Haute-Normandie	76	1	50	407	Manneville-ès-Plains	265	12	277
23	Haute-Normandie	76	2	24	408	Manneville-la-Goupil	1014	14	1028
23	Haute-Normandie	76	2	37	409	Mannevillette	828	25	853
23	Haute-Normandie	76	3	36	410	Maromme	11363	123	11486
23	Haute-Normandie	76	1	02	411	Marques	205	4	209
23	Haute-Normandie	76	3	13	412	Martainville-Épreville	734	12	746
23	Haute-Normandie	76	1	39	413	Martigny	478	10	488
23	Haute-Normandie	76	1	14	414	Martin-Église	1542	52	1594
23	Haute-Normandie	76	1	38	415	Massy	307	7	314
23	Haute-Normandie	76	1	49	416	Mathonville	259	2	261
23	Haute-Normandie	76	1	49	417	Maucomble	353	6	359
23	Haute-Normandie	76	3	10	418	Maulévrier-Sainte-Gertrude	949	20	969
23	Haute-Normandie	76	3	16	419	Mauny	172	2	174
23	Haute-Normandie	76	1	23	420	Mauquenchy	320	15	335
23	Haute-Normandie	76	2	33	421	Mélamare	772	14	786
23	Haute-Normandie	76	1	19	422	Melleville	272	6	278
23	Haute-Normandie	76	1	25	423	Ménerval	191	6	197
23	Haute-Normandie	76	1	38	424	Ménonval	192	5	197
23	Haute-Normandie	76	2	24	425	Mentheville	256	1	257
23	Haute-Normandie	76	1	01	426	Mésangueville	172	4	176
23	Haute-Normandie	76	1	38	427	Mesnières-en-Bray	979	272	1251
23	Haute-Normandie	76	1	50	428	Le Mesnil-Durdent	24	1	25
23	Haute-Normandie	76	3	07	429	Le Mesnil-Esnard	6986	387	7373
23	Haute-Normandie	76	1	04	430	Mesnil-Follemprise	133	3	136
23	Haute-Normandie	76	1	01	431	Le Mesnil-Lieubray	99	2	101
23	Haute-Normandie	76	1	23	432	Mesnil-Mauger	241	1	242
23	Haute-Normandie	76	3	41	433	Mesnil-Panneville	679	11	690
23	Haute-Normandie	76	3	07	434	Mesnil-Raoul	880	13	893
23	Haute-Normandie	76	1	19	435	Le Mesnil-Réaume	596	9	605
23	Haute-Normandie	76	3	16	436	Le Mesnil-sous-Jumièges	607	11	618
23	Haute-Normandie	76	1	18	437	Meulers	588	5	593
23	Haute-Normandie	76	1	19	438	Millebosc	275	4	279
23	Haute-Normandie	76	2	06	439	Mirville	337	1	338
23	Haute-Normandie	76	1	25	440	Molagnies	176	3	179
23	Haute-Normandie	76	1	05	441	Monchaux-Soreng	644	10	654
23	Haute-Normandie	76	1	19	442	Monchy-sur-Eu	565	8	573
23	Haute-Normandie	76	3	11	443	Mont-Cauvaire	619	8	627
23	Haute-Normandie	76	3	41	444	Mont-de-l;If	97	2	99
23	Haute-Normandie	76	3	65	451	Mont-Saint-Aignan	19341	539	19880
23	Haute-Normandie	76	1	49	445	Montérolier	535	8	543
23	Haute-Normandie	76	3	66	446	Montigny	1143	28	1171
23	Haute-Normandie	76	2	37	447	Montivilliers	16611	241	16852
23	Haute-Normandie	76	3	07	448	Montmain	1375	23	1398
23	Haute-Normandie	76	1	52	449	Montreuil-en-Caux	486	5	491
23	Haute-Normandie	76	1	25	450	Montroty	257	33	290
23	Haute-Normandie	76	3	11	452	Montville	4736	25	4761
23	Haute-Normandie	76	3	08	453	Morgny-la-Pommeraye	1036	11	1047
23	Haute-Normandie	76	1	02	606	Morienne	173	37	210
23	Haute-Normandie	76	1	38	454	Mortemer	108	1	109
23	Haute-Normandie	76	1	01	455	Morville-sur-Andelle	285	8	293
23	Haute-Normandie	76	3	54	456	Motteville	775	11	786
23	Haute-Normandie	76	3	26	457	Moulineaux	894	32	926
23	Haute-Normandie	76	1	35	458	Muchedent	140	3	143
23	Haute-Normandie	76	1	38	459	Nesle-Hodeng	320	2	322
23	Haute-Normandie	76	1	05	460	Nesle-Normandeuse	591	9	600
23	Haute-Normandie	76	1	25	463	Neuf-Marché	692	20	712
23	Haute-Normandie	76	1	49	461	Neufbosc	366	5	371
23	Haute-Normandie	76	1	38	462	Neufchâtel-en-Bray	4827	200	5027
23	Haute-Normandie	76	3	07	464	La Neuville-Chant-d;Oisel	2093	32	2125
23	Haute-Normandie	76	1	38	465	Neuville-Ferrières	594	6	600
23	Haute-Normandie	76	1	50	467	Néville	1106	19	1125
23	Haute-Normandie	76	2	06	468	Nointot	1367	34	1401
23	Haute-Normandie	76	1	01	469	Nolléval	433	5	438
23	Haute-Normandie	76	2	20	470	Normanville	578	14	592
23	Haute-Normandie	76	2	33	471	Norville	895	17	912
23	Haute-Normandie	76	1	18	472	Notre-Dame-d;Aliermont	677	21	698
23	Haute-Normandie	76	3	10	473	Notre-Dame-de-Bliquetuit	693	11	704
23	Haute-Normandie	76	3	66	474	Notre-Dame-de-Bondeville	6987	97	7084
23	Haute-Normandie	76	2	33	476	Notre-Dame-de-Gravenchon	8101	239	8340
23	Haute-Normandie	76	2	37	477	Notre-Dame-du-Bec	427	5	432
23	Haute-Normandie	76	1	35	478	Notre-Dame-du-Parc	169	1	170
23	Haute-Normandie	76	1	02	479	Nullemont	132	1	133
23	Haute-Normandie	76	1	09	480	Ocqueville	463	7	470
23	Haute-Normandie	76	2	37	481	Octeville-sur-Mer	5788	102	5890
23	Haute-Normandie	76	1	39	482	Offranville	3321	253	3574
23	Haute-Normandie	76	2	40	483	Oherville	205	8	213
23	Haute-Normandie	76	3	69	484	Oissel	11516	97	11613
23	Haute-Normandie	76	1	03	485	Omonville	259	43	302
23	Haute-Normandie	76	3	17	486	Orival	941	15	956
23	Haute-Normandie	76	1	34	487	Osmoy-Saint-Valery	329	6	335
23	Haute-Normandie	76	1	09	488	Ouainville	516	18	534
23	Haute-Normandie	76	2	48	489	Oudalle	382	8	390
23	Haute-Normandie	76	2	40	490	Ourville-en-Caux	1096	22	1118
23	Haute-Normandie	76	3	54	491	Ouville-l;Abbaye	631	13	644
23	Haute-Normandie	76	1	39	492	Ouville-la-Rivière	549	14	563
23	Haute-Normandie	76	1	09	493	Paluel	464	2	466
23	Haute-Normandie	76	2	06	494	Parc-d;Anxtot	579	10	589
23	Haute-Normandie	76	3	41	495	Pavilly	6226	177	6403
23	Haute-Normandie	76	1	18	496	Penly	332	3	335
23	Haute-Normandie	76	3	26	497	Petit-Couronne	9209	91	9300
23	Haute-Normandie	76	3	67	498	Le Petit-Quevilly	21898	317	22215
23	Haute-Normandie	76	2	33	499	Petiville	1057	26	1083
23	Haute-Normandie	76	1	05	500	Pierrecourt	484	7	491
23	Haute-Normandie	76	2	12	501	Pierrefiques	133	3	136
23	Haute-Normandie	76	3	08	502	Pierreval	426	9	435
23	Haute-Normandie	76	3	66	503	Pissy-Pôville	1277	23	1300
23	Haute-Normandie	76	1	50	504	Pleine-Sève	120	3	123
23	Haute-Normandie	76	1	23	505	Pommereux	105	3	108
23	Haute-Normandie	76	1	04	506	Pommeréval	394	4	398
23	Haute-Normandie	76	1	19	507	Ponts-et-Marais	828	10	838
23	Haute-Normandie	76	2	12	508	La Poterie-Cap-d;Antifer	422	6	428
23	Haute-Normandie	76	3	13	509	Préaux	1642	30	1672
23	Haute-Normandie	76	3	15	510	Prétot-Vicquemare	161	1	162
23	Haute-Normandie	76	1	34	511	Preuseville	127	3	130
23	Haute-Normandie	76	1	34	512	Puisenval	27	0	27
23	Haute-Normandie	76	3	16	513	Quevillon	594	15	609
23	Haute-Normandie	76	3	07	514	Quévreville-la-Poterie	932	15	947
23	Haute-Normandie	76	1	39	515	Quiberville	549	7	556
23	Haute-Normandie	76	1	38	516	Quièvrecourt	459	9	468
23	Haute-Normandie	76	3	11	517	Quincampoix	3081	82	3163
23	Haute-Normandie	76	2	06	518	Raffetot	497	15	512
23	Haute-Normandie	76	1	03	519	Rainfreville	88	1	89
23	Haute-Normandie	76	1	05	520	Réalcamp	662	6	668
23	Haute-Normandie	76	3	08	521	Rebets	142	3	145
23	Haute-Normandie	76	2	48	522	La Remuée	1326	25	1351
23	Haute-Normandie	76	1	05	523	Rétonval	192	3	195
23	Haute-Normandie	76	3	15	524	Reuville	131	4	135
23	Haute-Normandie	76	2	20	525	Ricarville	319	11	330
23	Haute-Normandie	76	1	18	526	Ricarville-du-Val	158	2	160
23	Haute-Normandie	76	1	02	527	Richemont	483	10	493
23	Haute-Normandie	76	1	05	528	Rieux	632	41	673
23	Haute-Normandie	76	2	53	529	Riville	316	5	321
23	Haute-Normandie	76	2	40	530	Robertot	189	1	190
23	Haute-Normandie	76	2	20	531	Rocquefort	337	3	340
23	Haute-Normandie	76	1	49	532	Rocquemont	827	8	835
23	Haute-Normandie	76	2	48	533	Rogerville	1259	10	1269
23	Haute-Normandie	76	2	37	534	Rolleville	1136	20	1156
23	Haute-Normandie	76	1	23	535	Roncherolles-en-Bray	459	9	468
23	Haute-Normandie	76	3	13	536	Roncherolles-sur-le-Vivier	1091	16	1107
23	Haute-Normandie	76	1	02	537	Ronchois	187	1	188
23	Haute-Normandie	76	1	04	538	Rosay	274	5	279
23	Haute-Normandie	76	3	99	540	Rouen	110933	2528	113461
23	Haute-Normandie	76	3	66	541	Roumare	1375	28	1403
23	Haute-Normandie	76	2	40	542	Routes	232	4	236
23	Haute-Normandie	76	2	06	543	Rouville	575	13	588
23	Haute-Normandie	76	1	23	544	Rouvray-Catillon	219	2	221
23	Haute-Normandie	76	1	39	545	Rouxmesnil-Bouteilles	2028	44	2072
23	Haute-Normandie	76	1	03	546	Royville	269	3	272
23	Haute-Normandie	76	3	11	547	La Rue-Saint-Pierre	695	2	697
23	Haute-Normandie	76	3	13	548	Ry	799	7	806
23	Haute-Normandie	76	1	03	549	Saâne-Saint-Just	147	2	149
23	Haute-Normandie	76	3	26	550	Sahurs	1285	20	1305
23	Haute-Normandie	76	2	48	551	Sainneville	810	15	825
23	Haute-Normandie	76	3	08	554	Saint-Aignan-sur-Ry	308	3	311
23	Haute-Normandie	76	3	11	555	Saint-André-sur-Cailly	891	14	905
23	Haute-Normandie	76	2	33	556	Saint-Antoine-la-Forêt	1011	27	1038
23	Haute-Normandie	76	3	10	557	Saint-Arnoult	1334	38	1372
23	Haute-Normandie	76	3	07	558	Saint-Aubin-Celloville	970	15	985
23	Haute-Normandie	76	3	10	559	Saint-Aubin-de-Crétot	539	10	549
23	Haute-Normandie	76	3	13	560	Saint-Aubin-Épinay	962	11	973
23	Haute-Normandie	76	1	18	562	Saint-Aubin-le-Cauf	899	21	920
23	Haute-Normandie	76	3	17	561	Saint-Aubin-lès-Elbeuf	8122	72	8194
23	Haute-Normandie	76	2	48	563	Saint-Aubin-Routot	1570	29	1599
23	Haute-Normandie	76	1	22	564	Saint-Aubin-sur-Mer	251	9	260
23	Haute-Normandie	76	1	39	565	Saint-Aubin-sur-Scie	1129	92	1221
23	Haute-Normandie	76	3	55	568	Saint-Clair-sur-les-Monts	628	15	643
23	Haute-Normandie	76	1	35	570	Saint-Crespin	284	7	291
23	Haute-Normandie	76	1	39	572	Saint-Denis-d;Aclon	162	3	165
23	Haute-Normandie	76	3	13	573	Saint-Denis-le-Thiboult	506	17	523
23	Haute-Normandie	76	1	52	574	Saint-Denis-sur-Scie	505	9	514
23	Haute-Normandie	76	3	93	575	Saint-Étienne-du-Rouvray	28102	499	28601
23	Haute-Normandie	76	2	06	576	Saint-Eustache-la-Forêt	1072	16	1088
23	Haute-Normandie	76	3	11	580	Saint-Georges-sur-Fontaine	881	15	896
23	Haute-Normandie	76	1	35	582	Saint-Germain-d;Étables	269	10	279
23	Haute-Normandie	76	3	08	581	Saint-Germain-des-Essourts	404	5	409
23	Haute-Normandie	76	3	11	583	Saint-Germain-sous-Cailly	322	6	328
23	Haute-Normandie	76	1	38	584	Saint-Germain-sur-Eaulne	204	10	214
23	Haute-Normandie	76	3	10	585	Saint-Gilles-de-Crétot	399	6	405
23	Haute-Normandie	76	2	48	586	Saint-Gilles-de-la-Neuville	652	10	662
23	Haute-Normandie	76	1	04	588	Saint-Hellier	435	7	442
23	Haute-Normandie	76	1	35	589	Saint-Honoré	170	5	175
23	Haute-Normandie	76	1	18	590	Saint-Jacques-d;Aliermont	365	2	367
23	Haute-Normandie	76	3	13	591	Saint-Jacques-sur-Darnétal	2607	75	2682
23	Haute-Normandie	76	2	33	592	Saint-Jean-de-Folleville	836	13	849
23	Haute-Normandie	76	2	06	593	Saint-Jean-de-la-Neuville	562	9	571
23	Haute-Normandie	76	3	66	594	Saint-Jean-du-Cardonnay	1345	17	1362
23	Haute-Normandie	76	2	12	595	Saint-Jouin-Bruneval	1836	31	1867
23	Haute-Normandie	76	2	48	596	Saint-Laurent-de-Brèvedent	1397	27	1424
23	Haute-Normandie	76	3	15	597	Saint-Laurent-en-Caux	796	11	807
23	Haute-Normandie	76	1	05	598	Saint-Léger-aux-Bois	506	17	523
23	Haute-Normandie	76	3	13	599	Saint-Léger-du-Bourg-Denis	3421	54	3475
23	Haute-Normandie	76	2	21	600	Saint-Léonard	1837	28	1865
23	Haute-Normandie	76	1	52	602	Saint-Maclou-de-Folleville	591	9	600
23	Haute-Normandie	76	2	24	603	Saint-Maclou-la-Brière	503	6	509
23	Haute-Normandie	76	1	03	604	Saint-Mards	187	2	189
23	Haute-Normandie	76	1	05	612	Saint-Martin-au-Bosc	188	3	191
23	Haute-Normandie	76	3	54	611	Saint-Martin-aux-Arbres	300	14	314
23	Haute-Normandie	76	1	09	613	Saint-Martin-aux-Buneaux	671	11	682
23	Haute-Normandie	76	3	16	614	Saint-Martin-de-Boscherville	1421	44	1465
23	Haute-Normandie	76	2	12	615	Saint-Martin-du-Bec	568	31	599
23	Haute-Normandie	76	2	37	616	Saint-Martin-du-Manoir	1549	31	1580
23	Haute-Normandie	76	3	13	617	Saint-Martin-du-Vivier	1740	49	1789
23	Haute-Normandie	76	1	18	618	Saint-Martin-en-Campagne	1298	29	1327
23	Haute-Normandie	76	1	38	620	Saint-Martin-l;Hortier	253	8	261
23	Haute-Normandie	76	1	19	619	Saint-Martin-le-Gaillard	296	11	307
23	Haute-Normandie	76	1	49	621	Saint-Martin-Osmonville	1155	9	1164
23	Haute-Normandie	76	2	33	622	Saint-Maurice-d;Ételan	316	11	327
23	Haute-Normandie	76	1	23	623	Saint-Michel-d;Halescourt	102	4	106
23	Haute-Normandie	76	1	18	624	Saint-Nicolas-d;Aliermont	3715	102	3817
23	Haute-Normandie	76	3	10	625	Saint-Nicolas-de-Bliquetuit	564	9	573
23	Haute-Normandie	76	3	10	626	Saint-Nicolas-de-la-Haie	396	12	408
23	Haute-Normandie	76	2	33	627	Saint-Nicolas-de-la-Taille	1387	29	1416
23	Haute-Normandie	76	3	41	628	Saint-Ouen-du-Breuil	760	8	768
23	Haute-Normandie	76	1	03	629	Saint-Ouen-le-Mauger	222	2	224
23	Haute-Normandie	76	1	18	630	Saint-Ouen-sous-Bailly	226	0	226
23	Haute-Normandie	76	3	16	631	Saint-Paër	1188	12	1200
23	Haute-Normandie	76	1	52	632	Saint-Pierre-Bénouville	341	3	344
23	Haute-Normandie	76	3	26	634	Saint-Pierre-de-Manneville	745	11	756
23	Haute-Normandie	76	3	16	636	Saint-Pierre-de-Varengeville	2233	45	2278
23	Haute-Normandie	76	1	34	635	Saint-Pierre-des-Jonquières	105	2	107
23	Haute-Normandie	76	2	53	637	Saint-Pierre-en-Port	835	8	843
23	Haute-Normandie	76	1	19	638	Saint-Pierre-en-Val	1118	29	1147
23	Haute-Normandie	76	2	20	639	Saint-Pierre-Lavis	197	2	199
23	Haute-Normandie	76	1	22	641	Saint-Pierre-le-Vieux	224	3	227
23	Haute-Normandie	76	1	22	642	Saint-Pierre-le-Viger	283	8	291
23	Haute-Normandie	76	3	61	640	Saint-Pierre-lès-Elbeuf	8445	101	8546
23	Haute-Normandie	76	1	18	643	Saint-Quentin-au-Bosc	101	1	102
23	Haute-Normandie	76	1	19	644	Saint-Rémy-Boscrocourt	770	20	790
23	Haute-Normandie	76	1	05	645	Saint-Riquier-en-Rivière	163	0	163
23	Haute-Normandie	76	1	50	646	Saint-Riquier-ès-Plains	590	17	607
23	Haute-Normandie	76	2	48	647	Saint-Romain-de-Colbosc	3791	60	3851
23	Haute-Normandie	76	1	49	648	Saint-Saëns	2510	35	2545
23	Haute-Normandie	76	1	38	649	Saint-Saire	630	9	639
23	Haute-Normandie	76	2	24	650	Saint-Sauveur-d;Émalleville	1191	6	1197
23	Haute-Normandie	76	1	50	651	Saint-Sylvain	185	11	196
23	Haute-Normandie	76	1	18	652	Saint-Vaast-d;Équiqueville	643	7	650
23	Haute-Normandie	76	2	40	653	Saint-Vaast-Dieppedalle	343	9	352
23	Haute-Normandie	76	1	52	654	Saint-Vaast-du-Val	446	6	452
23	Haute-Normandie	76	1	50	655	Saint-Valery-en-Caux	4434	191	4625
23	Haute-Normandie	76	1	52	656	Saint-Victor-l;Abbaye	695	12	707
23	Haute-Normandie	76	2	48	657	Saint-Vigor-d;Ymonville	1024	8	1032
23	Haute-Normandie	76	2	48	658	Saint-Vincent-Cramesnil	605	6	611
23	Haute-Normandie	76	3	10	659	Saint-Wandrille-Rançon	1176	16	1192
23	Haute-Normandie	76	2	56	552	Sainte-Adresse	7548	280	7828
23	Haute-Normandie	76	1	34	553	Sainte-Agathe-d;Aliermont	327	2	329
23	Haute-Normandie	76	3	41	566	Sainte-Austreberthe	605	7	612
23	Haute-Normandie	76	1	38	567	Sainte-Beuve-en-Rivière	191	7	198
23	Haute-Normandie	76	1	50	569	Sainte-Colombe	200	4	204
23	Haute-Normandie	76	3	08	571	Sainte-Croix-sur-Buchy	676	8	684
23	Haute-Normandie	76	1	35	577	Sainte-Foy	544	8	552
23	Haute-Normandie	76	1	49	578	Sainte-Geneviève	284	5	289
23	Haute-Normandie	76	2	53	587	Sainte-Hélène-Bondeville	727	15	742
23	Haute-Normandie	76	3	16	608	Sainte-Marguerite-sur-Duclair	1890	27	1917
23	Haute-Normandie	76	2	20	607	Sainte-Marguerite-sur-Fauville	262	8	270
23	Haute-Normandie	76	1	39	605	Sainte-Marguerite-sur-Mer	511	9	520
23	Haute-Normandie	76	2	12	609	Sainte-Marie-au-Bosc	337	3	340
23	Haute-Normandie	76	3	55	610	Sainte-Marie-des-Champs	1476	27	1503
23	Haute-Normandie	76	2	48	660	Sandouville	761	13	774
23	Haute-Normandie	76	1	03	662	Sassetot-le-Malgardé	97	0	97
23	Haute-Normandie	76	2	53	663	Sassetot-le-Mauconduit	1013	13	1026
23	Haute-Normandie	76	1	09	664	Sasseville	292	15	307
23	Haute-Normandie	76	1	18	665	Sauchay	410	10	420
23	Haute-Normandie	76	1	23	666	Saumont-la-Poterie	405	7	412
23	Haute-Normandie	76	1	39	667	Sauqueville	359	13	372
23	Haute-Normandie	76	3	54	668	Saussay	324	5	329
23	Haute-Normandie	76	2	24	669	Sausseuzemare-en-Caux	408	6	414
23	Haute-Normandie	76	2	21	670	Senneville-sur-Fécamp	801	17	818
23	Haute-Normandie	76	1	19	671	Sept-Meules	154	0	154
23	Haute-Normandie	76	1	23	672	Serqueux	1014	16	1030
23	Haute-Normandie	76	3	13	673	Servaville-Salmonville	1059	21	1080
23	Haute-Normandie	76	1	04	674	Sévis	344	6	350
23	Haute-Normandie	76	3	11	675	Sierville	956	14	970
23	Haute-Normandie	76	1	01	676	Sigy-en-Bray	692	4	696
23	Haute-Normandie	76	1	34	677	Smermesnil	412	63	475
23	Haute-Normandie	76	1	49	678	Sommery	828	20	848
23	Haute-Normandie	76	2	40	679	Sommesnil	89	1	90
23	Haute-Normandie	76	2	53	680	Sorquainville	170	3	173
23	Haute-Normandie	76	3	92	681	Sotteville-lès-Rouen	28835	683	29518
23	Haute-Normandie	76	3	61	682	Sotteville-sous-le-Val	772	35	807
23	Haute-Normandie	76	1	22	683	Sotteville-sur-Mer	357	14	371
23	Haute-Normandie	76	2	48	684	Tancarville	1346	18	1364
23	Haute-Normandie	76	2	53	685	Thérouldeville	587	3	590
23	Haute-Normandie	76	2	53	686	Theuville-aux-Maillots	492	9	501
23	Haute-Normandie	76	2	53	688	Thiergeville	377	8	385
23	Haute-Normandie	76	2	53	689	Thiétreville	365	47	412
23	Haute-Normandie	76	1	03	690	Thil-Manneville	535	8	543
23	Haute-Normandie	76	1	23	691	Le Thil-Riberpré	228	5	233
23	Haute-Normandie	76	2	40	692	Thiouville	277	8	285
23	Haute-Normandie	76	2	12	693	Le Tilleul	691	12	703
23	Haute-Normandie	76	1	03	694	Tocqueville-en-Caux	142	7	149
23	Haute-Normandie	76	2	24	695	Tocqueville-les-Murs	308	3	311
23	Haute-Normandie	76	1	19	696	Tocqueville-sur-Eu	211	2	213
23	Haute-Normandie	76	1	35	697	Torcy-le-Grand	710	24	734
23	Haute-Normandie	76	1	35	698	Torcy-le-Petit	489	10	499
23	Haute-Normandie	76	3	15	699	Le Torp-Mesnil	343	5	348
23	Haute-Normandie	76	1	52	700	Tôtes	1440	11	1451
23	Haute-Normandie	76	3	10	701	Touffreville-la-Cable	386	10	396
23	Haute-Normandie	76	3	55	702	Touffreville-la-Corbeline	769	17	786
23	Haute-Normandie	76	1	19	703	Touffreville-sur-Eu	197	2	199
23	Haute-Normandie	76	1	18	704	Tourville-la-Chapelle	536	9	545
23	Haute-Normandie	76	3	61	705	Tourville-la-Rivière	2428	55	2483
23	Haute-Normandie	76	2	21	706	Tourville-les-Ifs	562	17	579
23	Haute-Normandie	76	1	39	707	Tourville-sur-Arques	1241	22	1263
23	Haute-Normandie	76	2	53	708	Toussaint	748	14	762
23	Haute-Normandie	76	3	16	709	Le Trait	5270	66	5336
23	Haute-Normandie	76	2	20	710	Trémauville	101	1	102
23	Haute-Normandie	76	1	19	711	Le Tréport	5255	90	5345
23	Haute-Normandie	76	2	33	712	La Trinité-du-Mont	749	17	766
23	Haute-Normandie	76	2	33	713	Triquerville	377	14	391
23	Haute-Normandie	76	2	48	714	Les Trois-Pierres	726	15	741
23	Haute-Normandie	76	2	06	715	Trouville	628	12	640
23	Haute-Normandie	76	2	12	716	Turretot	1498	7	1505
23	Haute-Normandie	76	3	26	717	Val-de-la-Haye	720	9	729
23	Haute-Normandie	76	1	52	018	Val-de-Saâne	1445	25	1470
23	Haute-Normandie	76	3	55	718	Valliquerville	1271	40	1311
23	Haute-Normandie	76	2	53	719	Valmont	1019	17	1036
23	Haute-Normandie	76	1	39	720	Varengeville-sur-Mer	1028	44	1072
23	Haute-Normandie	76	1	52	721	Varneville-Bretteville	289	5	294
23	Haute-Normandie	76	1	52	723	Vassonville	401	2	403
23	Haute-Normandie	76	1	38	724	Vatierville	118	4	122
23	Haute-Normandie	76	2	24	725	Vattetot-sous-Beaumont	558	8	566
23	Haute-Normandie	76	2	21	726	Vattetot-sur-Mer	318	4	322
23	Haute-Normandie	76	3	10	727	Vatteville-la-Rue	1072	15	1087
23	Haute-Normandie	76	3	66	728	La Vaupalière	983	14	997
23	Haute-Normandie	76	3	55	729	Veauville-lès-Baons	720	9	729
23	Haute-Normandie	76	2	40	730	Veauville-lès-Quelles	108	6	114
23	Haute-Normandie	76	1	03	731	Vénestanville	178	6	184
23	Haute-Normandie	76	1	49	733	Ventes-Saint-Rémy	228	5	233
23	Haute-Normandie	76	2	12	734	Vergetot	423	5	428
23	Haute-Normandie	76	1	50	735	Veules-les-Roses	551	13	564
23	Haute-Normandie	76	1	09	736	Veulettes-sur-Mer	322	9	331
23	Haute-Normandie	76	3	54	737	Vibeuf	646	17	663
23	Haute-Normandie	76	3	08	738	Vieux-Manoir	683	13	696
23	Haute-Normandie	76	1	02	739	Vieux-Rouen-sur-Bresle	649	8	657
23	Haute-Normandie	76	3	13	740	La Vieux-Rue	463	4	467
23	Haute-Normandie	76	2	12	741	Villainville	299	10	309
23	Haute-Normandie	76	3	10	742	Villequier	754	22	776
23	Haute-Normandie	76	3	41	743	Villers-Écalles	1788	21	1809
23	Haute-Normandie	76	1	05	744	Villers-sous-Foucarmont	193	5	198
23	Haute-Normandie	76	1	19	745	Villy-sur-Yères	196	4	200
23	Haute-Normandie	76	2	53	746	Vinnemerville	210	5	215
23	Haute-Normandie	76	2	24	747	Virville	333	6	339
23	Haute-Normandie	76	1	09	748	Vittefleur	635	12	647
23	Haute-Normandie	76	1	34	749	Wanchy-Capval	340	6	346
23	Haute-Normandie	76	3	16	750	Yainville	1111	16	1127
23	Haute-Normandie	76	2	20	751	Yébleron	1375	19	1394
23	Haute-Normandie	76	3	54	752	Yerville	2329	38	2367
23	Haute-Normandie	76	3	07	753	Ymare	1134	19	1153
23	Haute-Normandie	76	2	21	754	Yport	949	13	962
23	Haute-Normandie	76	2	53	755	Ypreville-Biville	541	6	547
23	Haute-Normandie	76	3	11	756	Yquebeuf	250	9	259
23	Haute-Normandie	76	3	15	757	Yvecrique	657	7	664
23	Haute-Normandie	76	3	55	758	Yvetot	11816	512	12328
23	Haute-Normandie	76	3	16	759	Yville-sur-Seine	464	7	471
11	Île-de-France	77	4	03	001	Achères-la-Forêt	1242	22	1264
11	Île-de-France	77	3	11	002	Amillis	774	7	781
11	Île-de-France	77	4	03	003	Amponville	385	12	397
11	Île-de-France	77	2	22	004	Andrezel	303	7	310
11	Île-de-France	77	5	06	005	Annet-sur-Marne	3239	69	3308
11	Île-de-France	77	2	32	006	Arbonne-la-Forêt	1024	19	1043
11	Île-de-France	77	2	22	007	Argentières	388	1	389
11	Île-de-France	77	1	15	008	Armentières-en-Brie	1405	14	1419
11	Île-de-France	77	4	04	009	Arville	132	6	138
11	Île-de-France	77	2	22	010	Aubepierre-Ozouer-le-Repos	904	8	912
11	Île-de-France	77	4	04	011	Aufferville	551	12	563
11	Île-de-France	77	3	29	012	Augers-en-Brie	304	4	308
11	Île-de-France	77	1	07	013	Aulnoy	386	28	414
11	Île-de-France	77	4	13	014	Avon	13984	303	14287
11	Île-de-France	77	3	01	015	Baby	85	1	86
11	Île-de-France	77	4	24	016	Bagneaux-sur-Loing	1704	13	1717
11	Île-de-France	77	5	43	018	Bailly-Romainvilliers	6516	39	6555
11	Île-de-France	77	3	01	019	Balloy	331	4	335
11	Île-de-France	77	3	23	020	Bannost-Villegagnon	636	6	642
11	Île-de-France	77	3	20	021	Barbey	193	3	196
11	Île-de-France	77	2	32	022	Barbizon	1346	39	1385
11	Île-de-France	77	1	17	023	Barcy	236	5	241
11	Île-de-France	77	1	12	024	Bassevelle	352	9	361
11	Île-de-France	77	3	01	025	Bazoches-lès-Bray	827	14	841
11	Île-de-France	77	3	29	026	Beauchery-Saint-Martin	410	10	420
11	Île-de-France	77	4	04	027	Beaumont-du-Gâtinais	1164	17	1181
11	Île-de-France	77	1	07	028	Beautheil	712	17	729
11	Île-de-France	77	2	22	029	Beauvoir	189	1	190
11	Île-de-France	77	3	26	030	Bellot	809	6	815
11	Île-de-France	77	3	27	031	Bernay-Vilbert	837	24	861
11	Île-de-France	77	3	29	032	Beton-Bazoches	781	16	797
11	Île-de-France	77	3	23	033	Bezalles	229	0	229
11	Île-de-France	77	2	05	034	Blandy	760	21	781
11	Île-de-France	77	4	16	035	Blennes	562	14	576
11	Île-de-France	77	4	13	037	Bois-le-Roi	5650	209	5859
11	Île-de-France	77	3	23	036	Boisdon	92	3	95
11	Île-de-France	77	2	42	038	Boissettes	464	10	474
11	Île-de-France	77	2	42	039	Boissise-la-Bertrand	1006	11	1017
11	Île-de-France	77	2	32	040	Boissise-le-Roi	3572	52	3624
11	Île-de-France	77	4	03	041	Boissy-aux-Cailles	315	3	318
11	Île-de-France	77	1	07	042	Boissy-le-Châtel	3110	62	3172
11	Île-de-France	77	3	26	043	Boitron	393	6	399
11	Île-de-France	77	2	22	044	Bombon	908	19	927
11	Île-de-France	77	4	04	045	Bougligny	721	9	730
11	Île-de-France	77	4	03	046	Boulancourt	366	1	367
11	Île-de-France	77	1	08	047	Bouleurs	1441	28	1469
11	Île-de-France	77	4	24	048	Bourron-Marlotte	2712	90	2802
11	Île-de-France	77	1	08	049	Boutigny	875	22	897
11	Île-de-France	77	4	04	050	Bransles	505	8	513
11	Île-de-France	77	3	01	051	Bray-sur-Seine	2397	38	2435
11	Île-de-France	77	2	22	052	Bréau	351	2	353
11	Île-de-France	77	2	02	053	Brie-Comte-Robert	16251	353	16604
11	Île-de-France	77	3	20	054	La Brosse-Montceaux	725	9	734
11	Île-de-France	77	5	36	055	Brou-sur-Chantereine	4254	52	4306
11	Île-de-France	77	4	03	056	Burcy	148	4	152
11	Île-de-France	77	1	12	057	Bussières	461	5	466
11	Île-de-France	77	5	35	058	Bussy-Saint-Georges	23341	322	23663
11	Île-de-France	77	5	35	059	Bussy-Saint-Martin	724	10	734
11	Île-de-France	77	4	03	060	Buthiers	755	22	777
11	Île-de-France	77	3	20	061	Cannes-Écluse	2566	36	2602
11	Île-de-France	77	5	43	062	Carnetin	473	9	482
11	Île-de-France	77	1	07	063	La Celle-sur-Morin	1267	18	1285
11	Île-de-France	77	2	32	065	Cély	1198	19	1217
11	Île-de-France	77	3	29	066	Cerneux	305	9	314
11	Île-de-France	77	2	42	067	Cesson	8572	190	8762
11	Île-de-France	77	3	10	068	Cessoy-en-Montois	216	1	217
11	Île-de-France	77	2	32	069	Chailly-en-Bière	1997	36	2033
11	Île-de-France	77	1	07	070	Chailly-en-Brie	1449	201	1650
11	Île-de-France	77	4	04	071	Chaintreaux	902	16	918
11	Île-de-France	77	3	29	072	Chalautre-la-Grande	689	7	696
11	Île-de-France	77	3	25	073	Chalautre-la-Petite	563	20	583
11	Île-de-France	77	5	43	075	Chalifert	1212	16	1228
11	Île-de-France	77	3	01	076	Chalmaison	736	60	796
11	Île-de-France	77	1	17	077	Chambry	906	3	909
11	Île-de-France	77	1	12	078	Chamigny	1264	60	1324
11	Île-de-France	77	4	21	079	Champagne-sur-Seine	6485	121	6606
11	Île-de-France	77	3	29	080	Champcenest	138	1	139
11	Île-de-France	77	2	22	081	Champdeuil	638	8	646
11	Île-de-France	77	2	22	082	Champeaux	768	11	779
11	Île-de-France	77	5	38	083	Champs-sur-Marne	24418	218	24636
11	Île-de-France	77	1	12	084	Changis-sur-Marne	1062	12	1074
11	Île-de-France	77	5	43	085	Chanteloup-en-Brie	2121	17	2138
11	Île-de-France	77	2	22	086	La Chapelle-Gauthier	1449	11	1460
11	Île-de-France	77	3	27	087	La Chapelle-Iger	159	2	161
11	Île-de-France	77	4	03	088	La Chapelle-la-Reine	2596	29	2625
11	Île-de-France	77	3	11	093	La Chapelle-Moutils	390	11	401
11	Île-de-France	77	3	23	089	La Chapelle-Rablais	951	16	967
11	Île-de-France	77	3	25	090	La Chapelle-Saint-Sulpice	213	2	215
11	Île-de-France	77	3	27	091	Les Chapelles-Bourbon	421	10	431
11	Île-de-France	77	1	37	094	Charmentray	261	3	264
11	Île-de-France	77	1	37	095	Charny	1220	12	1232
11	Île-de-France	77	2	05	096	Chartrettes	2556	66	2622
11	Île-de-France	77	3	11	097	Chartronges	279	4	283
11	Île-de-France	77	4	04	099	Château-Landon	3112	74	3186
11	Île-de-France	77	3	23	098	Châteaubleau	330	3	333
11	Île-de-France	77	2	05	100	Le Châtelet-en-Brie	4416	71	4487
11	Île-de-France	77	3	10	101	Châtenay-sur-Seine	933	29	962
11	Île-de-France	77	4	24	102	Châtenoy	149	1	150
11	Île-de-France	77	2	05	103	Châtillon-la-Borde	218	9	227
11	Île-de-France	77	2	28	104	Châtres	579	7	586
11	Île-de-France	77	1	17	335	Chauconin-Neufmontiers	2720	32	2752
11	Île-de-France	77	3	26	106	Chauffry	992	9	1001
11	Île-de-France	77	2	28	107	Chaumes-en-Brie	3046	59	3105
11	Île-de-France	77	5	97	108	Chelles	52779	459	53238
11	Île-de-France	77	3	25	109	Chenoise	1290	20	1310
11	Île-de-France	77	4	04	110	Chenou	302	4	306
11	Île-de-France	77	5	43	111	Chessy	4298	36	4334
11	Île-de-France	77	4	24	112	Chevrainvilliers	224	3	227
11	Île-de-France	77	3	11	113	Chevru	1088	6	1094
11	Île-de-France	77	2	02	114	Chevry-Cossigny	3706	35	3741
11	Île-de-France	77	4	16	115	Chevry-en-Sereine	508	7	515
11	Île-de-France	77	3	11	116	Choisy-en-Brie	1347	18	1365
11	Île-de-France	77	1	12	117	Citry	797	5	802
11	Île-de-France	77	5	06	118	Claye-Souilly	11026	164	11190
11	Île-de-France	77	2	22	119	Clos-Fontaine	257	9	266
11	Île-de-France	77	1	15	120	Cocherel	592	4	596
11	Île-de-France	77	5	35	121	Collégien	3145	29	3174
11	Île-de-France	77	2	41	122	Combs-la-Ville	21554	291	21845
11	Île-de-France	77	1	37	123	Compans	711	14	725
11	Île-de-France	77	5	43	124	Conches-sur-Gondoire	1740	25	1765
11	Île-de-France	77	1	08	125	Condé-Sainte-Libiaire	1409	19	1428
11	Île-de-France	77	1	15	126	Congis-sur-Thérouanne	1759	216	1975
11	Île-de-France	77	2	02	127	Coubert	1821	37	1858
11	Île-de-France	77	1	08	128	Couilly-Pont-aux-Dames	2132	34	2166
11	Île-de-France	77	1	15	129	Coulombs-en-Valois	611	12	623
11	Île-de-France	77	1	08	130	Coulommes	402	6	408
11	Île-de-France	77	1	07	131	Coulommiers	14544	376	14920
11	Île-de-France	77	5	43	132	Coupvray	2705	47	2752
11	Île-de-France	77	3	20	133	Courcelles-en-Bassée	228	5	233
11	Île-de-France	77	3	29	134	Courchamp	152	2	154
11	Île-de-France	77	3	27	135	Courpalay	1402	12	1414
11	Île-de-France	77	2	28	136	Courquetaine	200	4	204
11	Île-de-France	77	3	29	137	Courtacon	198	1	199
11	Île-de-France	77	2	22	138	Courtomer	542	10	552
11	Île-de-France	77	5	06	139	Courtry	6156	59	6215
11	Île-de-France	77	3	10	140	Coutençon	285	4	289
11	Île-de-France	77	1	08	141	Coutevroult	974	10	984
11	Île-de-France	77	1	08	142	Crécy-la-Chapelle	4225	66	4291
11	Île-de-France	77	1	17	143	Crégy-lès-Meaux	4292	72	4364
11	Île-de-France	77	3	27	144	Crèvecoeur-en-Brie	301	3	304
11	Île-de-France	77	2	22	145	Crisenoy	628	8	636
11	Île-de-France	77	5	35	146	Croissy-Beaubourg	2010	24	2034
11	Île-de-France	77	3	23	147	La Croix-en-Brie	667	13	680
11	Île-de-France	77	1	15	148	Crouy-sur-Ourcq	1747	28	1775
11	Île-de-France	77	3	25	149	Cucharmoy	242	3	245
11	Île-de-France	77	1	09	150	Cuisy	442	2	444
11	Île-de-France	77	3	11	151	Dagny	340	10	350
11	Île-de-France	77	2	32	152	Dammarie-les-Lys	20722	201	20923
11	Île-de-France	77	1	09	153	Dammartin-en-Goële	8052	97	8149
11	Île-de-France	77	3	27	154	Dammartin-sur-Tigeaux	889	12	901
11	Île-de-France	77	5	43	155	Dampmart	3158	32	3190
11	Île-de-France	77	4	24	156	Darvault	805	10	815
11	Île-de-France	77	1	15	157	Dhuisy	276	3	279
11	Île-de-France	77	4	16	158	Diant	205	2	207
11	Île-de-France	77	3	10	159	Donnemarie-Dontilly	2801	32	2833
11	Île-de-France	77	4	21	161	Dormelles	882	9	891
11	Île-de-France	77	3	26	162	Doue	1014	24	1038
11	Île-de-France	77	1	15	163	Douy-la-Ramée	290	3	293
11	Île-de-France	77	2	05	164	Échouboulains	512	7	519
11	Île-de-France	77	2	05	165	Les Écrennes	612	10	622
11	Île-de-France	77	4	21	166	Écuelles	2479	92	2571
11	Île-de-France	77	3	10	167	Égligny	317	3	320
11	Île-de-France	77	4	16	168	Égreville	2200	40	2240
11	Île-de-France	77	5	38	169	Émerainville	7349	74	7423
11	Île-de-France	77	4	21	170	Épisy	514	11	525
11	Île-de-France	77	1	08	171	Esbly	5759	58	5817
11	Île-de-France	77	3	20	172	Esmans	886	13	899
11	Île-de-France	77	1	15	173	Étrépilly	850	5	855
11	Île-de-France	77	3	01	174	Everly	591	9	600
11	Île-de-France	77	2	02	175	Évry-Grégy-sur-Yerre	2399	32	2431
11	Île-de-France	77	1	07	176	Faremoutiers	2434	57	2491
11	Île-de-France	77	2	28	177	Favières	1106	14	1120
11	Île-de-France	77	4	24	178	Faÿ-lès-Nemours	478	12	490
11	Île-de-France	77	2	05	179	Féricy	593	28	621
11	Île-de-France	77	2	02	180	Férolles-Attilly	1123	25	1148
11	Île-de-France	77	5	35	181	Ferrières-en-Brie	2198	23	2221
11	Île-de-France	77	3	11	182	La Ferté-Gaucher	4424	47	4471
11	Île-de-France	77	1	12	183	La Ferté-sous-Jouarre	9061	130	9191
11	Île-de-France	77	4	16	184	Flagy	636	12	648
11	Île-de-France	77	2	32	185	Fleury-en-Bière	640	11	651
11	Île-de-France	77	3	01	187	Fontaine-Fourches	596	29	625
11	Île-de-France	77	2	05	188	Fontaine-le-Port	938	20	958
11	Île-de-France	77	4	13	186	Fontainebleau	15107	558	15665
11	Île-de-France	77	3	23	190	Fontains	263	3	266
11	Île-de-France	77	2	22	191	Fontenailles	1060	9	1069
11	Île-de-France	77	3	27	192	Fontenay-Trésigny	5135	49	5184
11	Île-de-France	77	1	09	193	Forfry	270	1	271
11	Île-de-France	77	3	20	194	Forges	414	150	564
11	Île-de-France	77	2	22	195	Fouju	545	4	549
11	Île-de-France	77	1	37	196	Fresnes-sur-Marne	654	4	658
11	Île-de-France	77	3	23	197	Frétoy	155	1	156
11	Île-de-France	77	4	03	198	Fromont	218	3	221
11	Île-de-France	77	1	31	199	Fublaines	1186	11	1197
11	Île-de-France	77	4	24	200	Garentreville	101	0	101
11	Île-de-France	77	3	23	201	Gastins	667	9	676
11	Île-de-France	77	4	24	202	La Genevraye	619	18	637
11	Île-de-France	77	1	17	203	Germigny-l;Évêque	1358	33	1391
11	Île-de-France	77	1	15	204	Germigny-sous-Coulombs	199	3	202
11	Île-de-France	77	1	09	205	Gesvres-le-Chapitre	169	0	169
11	Île-de-France	77	1	07	206	Giremoutiers	146	1	147
11	Île-de-France	77	4	04	207	Gironville	179	6	185
11	Île-de-France	77	3	01	208	Gouaix	1452	71	1523
11	Île-de-France	77	5	14	209	Gouvernes	1113	20	1133
11	Île-de-France	77	3	20	210	La Grande-Paroisse	2591	49	2640
11	Île-de-France	77	2	22	211	Grandpuits-Bailly-Carrois	992	11	1003
11	Île-de-France	77	3	01	212	Gravon	142	3	145
11	Île-de-France	77	1	37	214	Gressy	912	4	916
11	Île-de-France	77	2	28	215	Gretz-Armainvilliers	7984	74	8058
11	Île-de-France	77	4	24	216	Grez-sur-Loing	1409	27	1436
11	Île-de-France	77	2	02	217	Grisy-Suisnes	2428	45	2473
11	Île-de-France	77	3	01	218	Grisy-sur-Seine	98	10	108
11	Île-de-France	77	1	07	219	Guérard	2251	42	2293
11	Île-de-France	77	4	03	220	Guercheville	285	6	291
11	Île-de-France	77	5	43	221	Guermantes	1243	27	1270
11	Île-de-France	77	2	22	222	Guignes	3365	30	3395
11	Île-de-France	77	3	10	223	Gurcy-le-Châtel	566	6	572
11	Île-de-France	77	1	08	225	La Haute-Maison	355	7	362
11	Île-de-France	77	3	27	224	Hautefeuille	318	2	320
11	Île-de-France	77	4	13	226	Héricy	2548	87	2635
11	Île-de-France	77	3	01	227	Hermé	604	28	632
11	Île-de-France	77	3	26	228	Hondevilliers	240	4	244
11	Île-de-France	77	3	27	229	La Houssaye-en-Brie	1609	14	1623
11	Île-de-France	77	4	04	230	Ichy	164	2	166
11	Île-de-France	77	1	15	231	Isles-les-Meldeuses	771	13	784
11	Île-de-France	77	1	31	232	Isles-lès-Villenoy	910	5	915
11	Île-de-France	77	1	37	233	Iverny	588	7	595
11	Île-de-France	77	5	43	234	Jablines	639	7	646
11	Île-de-France	77	1	15	235	Jaignes	306	12	318
11	Île-de-France	77	3	01	236	Jaulnes	355	6	361
11	Île-de-France	77	5	43	237	Jossigny	629	6	635
11	Île-de-France	77	1	12	238	Jouarre	4188	75	4263
11	Île-de-France	77	3	23	239	Jouy-le-Châtel	1436	15	1451
11	Île-de-France	77	3	11	240	Jouy-sur-Morin	2144	27	2171
11	Île-de-France	77	1	09	241	Juilly	2156	304	2460
11	Île-de-France	77	3	10	242	Jutigny	576	4	580
11	Île-de-France	77	5	14	243	Lagny-sur-Marne	20236	302	20538
11	Île-de-France	77	4	03	244	Larchant	742	19	761
11	Île-de-France	77	3	20	245	Laval-en-Brie	455	11	466
11	Île-de-France	77	3	29	246	Léchelle	558	8	566
11	Île-de-France	77	3	11	247	Lescherolles	481	16	497
11	Île-de-France	77	5	43	248	Lesches	708	8	716
11	Île-de-France	77	2	02	249	Lésigny	7442	118	7560
11	Île-de-France	77	3	11	250	Leudon-en-Brie	149	0	149
11	Île-de-France	77	2	41	251	Lieusaint	10577	134	10711
11	Île-de-France	77	2	02	252	Limoges-Fourches	475	5	480
11	Île-de-France	77	2	02	253	Lissy	190	2	192
11	Île-de-France	77	2	28	254	Liverdy-en-Brie	1278	13	1291
11	Île-de-France	77	2	19	255	Livry-sur-Seine	1919	46	1965
11	Île-de-France	77	3	10	256	Lizines	168	6	174
11	Île-de-France	77	1	15	257	Lizy-sur-Ourcq	3633	147	3780
11	Île-de-France	77	5	39	258	Lognes	14560	137	14697
11	Île-de-France	77	1	09	259	Longperrier	2454	18	2472
11	Île-de-France	77	3	25	260	Longueville	1684	32	1716
11	Île-de-France	77	4	16	261	Lorrez-le-Bocage-Préaux	1236	18	1254
11	Île-de-France	77	3	29	262	Louan-Villegruis-Fontaine	514	12	526
11	Île-de-France	77	3	10	263	Luisetaines	233	2	235
11	Île-de-France	77	3	27	264	Lumigny-Nesles-Ormeaux	1515	19	1534
11	Île-de-France	77	1	12	265	Luzancy	1052	44	1096
11	Île-de-France	77	2	05	266	Machault	722	6	728
11	Île-de-France	77	4	04	267	La Madeleine-sur-Loing	337	5	342
11	Île-de-France	77	5	43	268	Magny-le-Hongre	5918	56	5974
11	Île-de-France	77	2	18	269	Maincy	1702	64	1766
11	Île-de-France	77	3	23	272	Maison-Rouge	877	13	890
11	Île-de-France	77	1	07	270	Maisoncelles-en-Brie	852	12	864
11	Île-de-France	77	4	04	271	Maisoncelles-en-Gâtinais	138	1	139
11	Île-de-France	77	1	09	273	Marchémoret	554	8	562
11	Île-de-France	77	1	15	274	Marcilly	435	0	435
11	Île-de-France	77	3	29	275	Les Marêts	153	3	156
11	Île-de-France	77	1	31	276	Mareuil-lès-Meaux	2194	55	2249
11	Île-de-France	77	3	27	277	Marles-en-Brie	1433	23	1456
11	Île-de-France	77	3	11	278	Marolles-en-Brie	401	11	412
11	Île-de-France	77	3	20	279	Marolles-sur-Seine	1600	43	1643
11	Île-de-France	77	1	15	280	Mary-sur-Marne	1203	8	1211
11	Île-de-France	77	1	07	281	Mauperthuis	486	7	493
11	Île-de-France	77	1	09	282	Mauregard	314	4	318
11	Île-de-France	77	1	15	283	May-en-Multien	883	6	889
11	Île-de-France	77	1	98	284	Meaux	50755	1785	52540
11	Île-de-France	77	2	42	285	Le Mée-sur-Seine	20609	221	20830
11	Île-de-France	77	3	10	286	Meigneux	229	6	235
11	Île-de-France	77	3	11	287	Meilleray	501	11	512
11	Île-de-France	77	2	99	288	Melun	39589	1020	40609
11	Île-de-France	77	3	29	289	Melz-sur-Seine	375	3	378
11	Île-de-France	77	1	12	290	Méry-sur-Marne	625	58	683
11	Île-de-France	77	1	09	291	Le Mesnil-Amelot	861	5	866
11	Île-de-France	77	1	37	292	Messy	1089	11	1100
11	Île-de-France	77	3	20	293	Misy-sur-Yonne	974	9	983
11	Île-de-France	77	1	37	294	Mitry-Mory	18499	172	18671
11	Île-de-France	77	2	05	295	Moisenay	1194	19	1213
11	Île-de-France	77	2	41	296	Moissy-Cramayel	17272	143	17415
11	Île-de-France	77	4	04	297	Mondreville	364	6	370
11	Île-de-France	77	3	10	298	Mons-en-Montois	482	12	494
11	Île-de-France	77	4	21	299	Montarlot	216	5	221
11	Île-de-France	77	1	31	300	Montceaux-lès-Meaux	608	8	616
11	Île-de-France	77	3	29	301	Montceaux-lès-Provins	328	4	332
11	Île-de-France	77	4	24	302	Montcourt-Fromonville	2090	77	2167
11	Île-de-France	77	3	26	303	Montdauphin	231	7	238
11	Île-de-France	77	3	26	304	Montenils	36	1	37
11	Île-de-France	77	3	20	305	Montereau-Fault-Yonne	16681	245	16926
11	Île-de-France	77	2	18	306	Montereau-sur-le-Jard	563	7	570
11	Île-de-France	77	5	43	307	Montévrain	8675	100	8775
11	Île-de-France	77	1	09	308	Montgé-en-Goële	688	8	696
11	Île-de-France	77	1	09	309	Monthyon	1642	10	1652
11	Île-de-France	77	3	01	310	Montigny-le-Guesdier	301	9	310
11	Île-de-France	77	3	10	311	Montigny-Lencoup	1275	32	1307
11	Île-de-France	77	4	21	312	Montigny-sur-Loing	2791	83	2874
11	Île-de-France	77	4	16	313	Montmachoux	231	2	233
11	Île-de-France	77	3	11	314	Montolivet	245	8	253
11	Île-de-France	77	1	08	315	Montry	3287	30	3317
11	Île-de-France	77	4	21	316	Moret-sur-Loing	4330	145	4475
11	Île-de-France	77	2	22	317	Mormant	4387	35	4422
11	Île-de-France	77	3	27	318	Mortcerf	1467	17	1484
11	Île-de-France	77	3	25	319	Mortery	177	0	177
11	Île-de-France	77	1	07	320	Mouroux	4889	50	4939
11	Île-de-France	77	3	01	321	Mousseaux-lès-Bray	692	9	701
11	Île-de-France	77	1	09	322	Moussy-le-Neuf	2913	36	2949
11	Île-de-France	77	1	09	323	Moussy-le-Vieux	1014	11	1025
11	Île-de-France	77	3	01	325	Mouy-sur-Seine	364	5	369
11	Île-de-France	77	2	34	326	Nandy	5814	82	5896
11	Île-de-France	77	3	23	327	Nangis	7979	104	8083
11	Île-de-France	77	4	03	328	Nanteau-sur-Essonne	427	4	431
11	Île-de-France	77	4	24	329	Nanteau-sur-Lunain	671	8	679
11	Île-de-France	77	1	31	330	Nanteuil-lès-Meaux	5433	96	5529
11	Île-de-France	77	1	12	331	Nanteuil-sur-Marne	474	2	476
11	Île-de-France	77	1	37	332	Nantouillet	267	6	273
11	Île-de-France	77	4	24	333	Nemours	12745	162	12907
11	Île-de-France	77	3	27	336	Neufmoutiers-en-Brie	999	83	1082
11	Île-de-France	77	5	39	337	Noisiel	15660	122	15782
11	Île-de-France	77	4	16	338	Noisy-Rudignon	586	8	594
11	Île-de-France	77	4	03	339	Noisy-sur-École	2012	58	2070
11	Île-de-France	77	4	24	340	Nonville	622	8	630
11	Île-de-France	77	3	01	341	Noyen-sur-Seine	378	17	395
11	Île-de-France	77	4	04	342	Obsonville	103	1	104
11	Île-de-France	77	1	15	343	Ocquerre	419	24	443
11	Île-de-France	77	1	09	344	Oissery	2133	42	2175
11	Île-de-France	77	3	26	345	Orly-sur-Morin	671	5	676
11	Île-de-France	77	3	01	347	Les Ormes-sur-Voulzie	830	15	845
11	Île-de-France	77	4	24	348	Ormesson	273	3	276
11	Île-de-France	77	1	09	349	Othis	6471	64	6535
11	Île-de-France	77	5	33	350	Ozoir-la-Ferrière	20268	330	20598
11	Île-de-France	77	2	28	352	Ozouer-le-Voulgis	1809	17	1826
11	Île-de-France	77	4	16	353	Paley	437	5	442
11	Île-de-France	77	2	05	354	Pamfou	930	9	939
11	Île-de-France	77	3	10	355	Paroy	177	6	183
11	Île-de-France	77	3	01	356	Passy-sur-Seine	44	0	44
11	Île-de-France	77	3	23	357	Pécy	821	24	845
11	Île-de-France	77	1	17	358	Penchard	1037	25	1062
11	Île-de-France	77	2	32	359	Perthes	2114	28	2142
11	Île-de-France	77	3	27	360	Pézarches	386	6	392
11	Île-de-France	77	1	12	361	Pierre-Levée	466	7	473
11	Île-de-France	77	5	06	363	Le Pin	1183	13	1196
11	Île-de-France	77	1	37	364	Le Plessis-aux-Bois	240	2	242
11	Île-de-France	77	3	27	365	Le Plessis-Feu-Aussoux	545	5	550
11	Île-de-France	77	1	09	366	Le Plessis-l;Évêque	251	3	254
11	Île-de-France	77	1	15	367	Le Plessis-Placy	269	4	273
11	Île-de-France	77	3	25	368	Poigny	499	4	503
11	Île-de-France	77	1	17	369	Poincy	709	29	738
11	Île-de-France	77	4	24	370	Poligny	821	22	843
11	Île-de-France	77	1	07	371	Pommeuse	2800	58	2858
11	Île-de-France	77	5	14	372	Pomponne	3364	43	3407
11	Île-de-France	77	5	40	373	Pontault-Combault	35561	312	35873
11	Île-de-France	77	5	33	374	Pontcarré	2001	13	2014
11	Île-de-France	77	1	37	376	Précy-sur-Marne	767	7	774
11	Île-de-France	77	2	28	377	Presles-en-Brie	2249	35	2284
11	Île-de-France	77	2	32	378	Pringy	2498	66	2564
11	Île-de-France	77	3	25	379	Provins	12301	383	12684
11	Île-de-France	77	1	15	380	Puisieux	313	5	318
11	Île-de-France	77	2	22	381	Quiers	678	7	685
11	Île-de-France	77	1	08	382	Quincy-Voisins	5072	84	5156
11	Île-de-France	77	3	23	383	Rampillon	795	8	803
11	Île-de-France	77	2	41	384	Réau	1096	9	1105
11	Île-de-France	77	3	26	385	Rebais	2151	17	2168
11	Île-de-France	77	4	03	386	Recloses	699	23	722
11	Île-de-France	77	4	16	387	Remauville	470	7	477
11	Île-de-France	77	1	12	388	Reuil-en-Brie	842	14	856
11	Île-de-France	77	2	19	389	La Rochette	3095	92	3187
11	Île-de-France	77	5	33	390	Roissy-en-Brie	22321	193	22514
11	Île-de-France	77	3	25	391	Rouilly	486	3	489
11	Île-de-France	77	1	09	392	Rouvres	623	11	634
11	Île-de-France	77	3	27	393	Rozay-en-Brie	2741	47	2788
11	Île-de-France	77	2	18	394	Rubelles	1885	41	1926
11	Île-de-France	77	4	03	395	Rumont	125	3	128
11	Île-de-France	77	3	29	396	Rupéreux	103	0	103
11	Île-de-France	77	1	12	397	Saâcy-sur-Marne	1747	65	1812
11	Île-de-France	77	3	26	398	Sablonnières	696	12	708
11	Île-de-France	77	4	16	399	Saint-Ange-le-Viel	228	1	229
11	Île-de-France	77	1	07	400	Saint-Augustin	1703	36	1739
11	Île-de-France	77	3	11	402	Saint-Barthélemy	386	4	390
11	Île-de-France	77	3	25	403	Saint-Brice	693	29	722
11	Île-de-France	77	3	26	405	Saint-Cyr-sur-Morin	1902	26	1928
11	Île-de-France	77	3	26	406	Saint-Denis-lès-Rebais	951	23	974
11	Île-de-France	77	2	32	407	Saint-Fargeau-Ponthierry	12462	140	12602
11	Île-de-France	77	1	08	408	Saint-Fiacre	384	8	392
11	Île-de-France	77	3	20	409	Saint-Germain-Laval	2773	68	2841
11	Île-de-France	77	2	18	410	Saint-Germain-Laxis	497	10	507
11	Île-de-France	77	3	26	411	Saint-Germain-sous-Doue	482	10	492
11	Île-de-France	77	2	32	412	Saint-Germain-sur-École	359	16	375
11	Île-de-France	77	1	08	413	Saint-Germain-sur-Morin	3565	55	3620
11	Île-de-France	77	3	25	414	Saint-Hilliers	448	15	463
11	Île-de-France	77	1	12	415	Saint-Jean-les-Deux-Jumeaux	1107	18	1125
11	Île-de-France	77	3	23	416	Saint-Just-en-Brie	244	8	252
11	Île-de-France	77	3	26	417	Saint-Léger	205	4	209
11	Île-de-France	77	3	25	418	Saint-Loup-de-Naud	894	10	904
11	Île-de-France	77	4	21	419	Saint-Mammès	3179	119	3298
11	Île-de-France	77	1	09	420	Saint-Mard	3798	39	3837
11	Île-de-France	77	3	11	421	Saint-Mars-Vieux-Maisons	268	9	277
11	Île-de-France	77	3	11	423	Saint-Martin-des-Champs	715	7	722
11	Île-de-France	77	3	29	424	Saint-Martin-du-Boschet	302	3	305
11	Île-de-France	77	2	32	425	Saint-Martin-en-Bière	807	20	827
11	Île-de-France	77	2	22	426	Saint-Méry	389	5	394
11	Île-de-France	77	1	37	427	Saint-Mesmes	561	5	566
11	Île-de-France	77	2	22	428	Saint-Ouen-en-Brie	853	9	862
11	Île-de-France	77	3	26	429	Saint-Ouen-sur-Morin	559	2	561
11	Île-de-France	77	1	09	430	Saint-Pathus	5723	72	5795
11	Île-de-France	77	4	24	431	Saint-Pierre-lès-Nemours	5617	153	5770
11	Île-de-France	77	3	11	432	Saint-Rémy-la-Vanne	994	15	1009
11	Île-de-France	77	3	01	434	Saint-Sauveur-lès-Bray	330	6	336
11	Île-de-France	77	2	32	435	Saint-Sauveur-sur-École	1088	19	1107
11	Île-de-France	77	3	11	436	Saint-Siméon	866	13	879
11	Île-de-France	77	1	09	437	Saint-Soupplets	3249	23	3272
11	Île-de-France	77	5	14	438	Saint-Thibault-des-Vignes	6300	90	6390
11	Île-de-France	77	1	12	401	Sainte-Aulde	650	4	654
11	Île-de-France	77	3	25	404	Sainte-Colombe	1769	37	1806
11	Île-de-France	77	1	07	433	Saints	1281	27	1308
11	Île-de-France	77	3	20	439	Salins	1022	10	1032
11	Île-de-France	77	1	12	440	Sammeron	1030	12	1042
11	Île-de-France	77	4	13	441	Samois-sur-Seine	2097	79	2176
11	Île-de-France	77	4	13	442	Samoreau	2317	54	2371
11	Île-de-France	77	1	08	443	Sancy	384	6	390
11	Île-de-France	77	3	29	444	Sancy-lès-Provins	330	4	334
11	Île-de-France	77	2	34	445	Savigny-le-Temple	28599	239	28838
11	Île-de-France	77	3	10	446	Savins	630	14	644
11	Île-de-France	77	2	34	447	Seine-Port	1962	42	2004
11	Île-de-France	77	1	12	448	Sept-Sorts	433	6	439
11	Île-de-France	77	5	43	449	Serris	7595	43	7638
11	Île-de-France	77	2	02	450	Servon	2974	52	3026
11	Île-de-France	77	1	12	451	Signy-Signets	602	11	613
11	Île-de-France	77	3	10	452	Sigy	47	1	48
11	Île-de-France	77	2	05	453	Sivry-Courtry	1016	28	1044
11	Île-de-France	77	3	10	454	Sognolles-en-Montois	427	6	433
11	Île-de-France	77	2	02	455	Soignolles-en-Brie	2073	25	2098
11	Île-de-France	77	3	25	456	Soisy-Bouy	805	15	820
11	Île-de-France	77	2	02	457	Solers	1253	11	1264
11	Île-de-France	77	4	04	458	Souppes-sur-Loing	5561	100	5661
11	Île-de-France	77	3	29	459	Sourdun	1430	18	1448
11	Île-de-France	77	1	15	460	Tancrou	367	8	375
11	Île-de-France	77	3	10	461	Thénisy	277	7	284
11	Île-de-France	77	1	09	462	Thieux	804	9	813
11	Île-de-France	77	4	21	463	Thomery	3436	88	3524
11	Île-de-France	77	5	43	464	Thorigny-sur-Marne	9220	129	9349
11	Île-de-France	77	4	16	465	Thoury-Férottes	668	9	677
11	Île-de-France	77	3	27	466	Tigeaux	373	3	376
11	Île-de-France	77	3	01	467	La Tombe	214	0	214
11	Île-de-France	77	5	35	468	Torcy	22425	214	22639
11	Île-de-France	77	3	27	469	Touquin	1095	21	1116
11	Île-de-France	77	2	28	470	Tournan-en-Brie	8054	124	8178
11	Île-de-France	77	4	03	471	Tousson	367	12	379
11	Île-de-France	77	3	26	472	La Trétoire	417	5	422
11	Île-de-France	77	4	24	473	Treuzy-Levelay	460	9	469
11	Île-de-France	77	1	31	474	Trilbardou	639	7	646
11	Île-de-France	77	1	31	475	Trilport	4844	78	4922
11	Île-de-France	77	1	15	476	Trocy-en-Multien	274	5	279
11	Île-de-France	77	4	03	477	Ury	797	24	821
11	Île-de-France	77	1	12	478	Ussy-sur-Marne	979	14	993
11	Île-de-France	77	5	36	479	Vaires-sur-Marne	12293	166	12459
11	Île-de-France	77	2	05	480	Valence-en-Brie	911	9	920
11	Île-de-France	77	3	23	481	Vanvillé	169	5	174
11	Île-de-France	77	3	20	482	Varennes-sur-Seine	3355	62	3417
11	Île-de-France	77	1	17	483	Varreddes	1858	31	1889
11	Île-de-France	77	1	08	484	Vaucourtois	209	2	211
11	Île-de-France	77	4	03	485	Le Vaudoué	748	20	768
11	Île-de-France	77	3	27	486	Vaudoy-en-Brie	837	10	847
11	Île-de-France	77	2	18	487	Vaux-le-Pénil	10866	212	11078
11	Île-de-France	77	4	16	489	Vaux-sur-Lunain	200	4	204
11	Île-de-France	77	1	15	490	Vendrest	730	4	734
11	Île-de-France	77	4	21	491	Veneux-les-Sablons	4799	101	4900
11	Île-de-France	77	3	26	492	Verdelot	726	14	740
11	Île-de-France	77	2	22	493	Verneuil-l;Étang	3167	19	3186
11	Île-de-France	77	4	21	494	Vernou-la-Celle-sur-Seine	2652	42	2694
11	Île-de-France	77	2	42	495	Vert-Saint-Denis	6966	103	7069
11	Île-de-France	77	3	23	496	Vieux-Champagne	180	5	185
11	Île-de-France	77	1	31	498	Vignely	256	3	259
11	Île-de-France	77	4	21	516	Ville-Saint-Jacques	720	17	737
11	Île-de-France	77	4	16	500	Villebéon	457	6	463
11	Île-de-France	77	4	21	501	Villecerf	738	19	757
11	Île-de-France	77	4	16	504	Villemaréchal	833	17	850
11	Île-de-France	77	1	08	505	Villemareuil	396	4	400
11	Île-de-France	77	4	21	506	Villemer	676	13	689
11	Île-de-France	77	3	01	507	Villenauxe-la-Petite	487	8	495
11	Île-de-France	77	3	27	508	Villeneuve-le-Comte	1778	29	1807
11	Île-de-France	77	3	10	509	Villeneuve-les-Bordes	612	9	621
11	Île-de-France	77	3	27	510	Villeneuve-Saint-Denis	714	6	720
11	Île-de-France	77	1	09	511	Villeneuve-sous-Dammartin	625	16	641
11	Île-de-France	77	3	26	512	Villeneuve-sur-Bellot	1141	20	1161
11	Île-de-France	77	1	31	513	Villenoy	4153	56	4209
11	Île-de-France	77	5	06	514	Villeparisis	24122	174	24296
11	Île-de-France	77	1	37	515	Villeroy	694	7	701
11	Île-de-France	77	5	06	517	Villevaudé	1731	36	1767
11	Île-de-France	77	2	32	518	Villiers-en-Bière	215	7	222
11	Île-de-France	77	3	29	519	Villiers-Saint-Georges	1213	18	1231
11	Île-de-France	77	4	03	520	Villiers-sous-Grez	750	21	771
11	Île-de-France	77	1	08	521	Villiers-sur-Morin	1849	25	1874
11	Île-de-France	77	3	01	522	Villiers-sur-Seine	308	12	320
11	Île-de-France	77	3	01	523	Villuis	256	2	258
11	Île-de-France	77	3	10	524	Vimpelles	503	8	511
11	Île-de-France	77	1	09	525	Vinantes	348	3	351
11	Île-de-France	77	1	15	526	Vincy-Manoeuvre	212	7	219
11	Île-de-France	77	3	27	527	Voinsles	576	12	588
11	Île-de-France	77	2	18	528	Voisenon	1046	39	1085
11	Île-de-France	77	1	08	529	Voulangis	1537	16	1553
11	Île-de-France	77	3	29	530	Voulton	304	6	310
11	Île-de-France	77	4	16	531	Voulx	1750	82	1832
11	Île-de-France	77	3	25	532	Vulaines-lès-Provins	65	2	67
11	Île-de-France	77	4	13	533	Vulaines-sur-Seine	2594	66	2660
11	Île-de-France	77	2	22	534	Yèbles	659	8	667
11	Île-de-France	78	2	19	003	Ablis	3287	50	3337
11	Île-de-France	78	3	20	005	Achères	19626	128	19754
11	Île-de-France	78	1	08	006	Adainville	759	16	775
11	Île-de-France	78	3	21	007	Aigremont	1099	33	1132
11	Île-de-France	78	2	19	009	Allainville	302	4	306
11	Île-de-France	78	3	17	010	Les Alluets-le-Roi	1203	36	1239
11	Île-de-France	78	1	07	013	Andelu	493	8	501
11	Île-de-France	78	3	39	015	Andrésy	12174	153	12327
11	Île-de-France	78	1	07	020	Arnouville-lès-Mantes	852	10	862
11	Île-de-France	78	1	01	029	Aubergenville	12020	72	12092
11	Île-de-France	78	2	18	030	Auffargis	2005	63	2068
11	Île-de-France	78	1	07	031	Auffreville-Brasseuil	586	19	605
11	Île-de-France	78	1	01	033	Aulnay-sur-Mauldre	1158	20	1178
11	Île-de-France	78	2	15	034	Auteuil	858	22	880
11	Île-de-France	78	2	15	036	Autouillet	474	9	483
11	Île-de-France	78	3	22	043	Bailly	3914	168	4082
11	Île-de-France	78	1	08	048	Bazainville	1425	30	1455
11	Île-de-France	78	1	01	049	Bazemont	1521	52	1573
11	Île-de-France	78	2	15	050	Bazoches-sur-Guyonne	591	28	619
11	Île-de-France	78	2	15	053	Béhoust	476	12	488
11	Île-de-France	78	1	02	057	Bennecourt	1810	27	1837
11	Île-de-France	78	2	15	062	Beynes	7678	110	7788
11	Île-de-France	78	1	02	068	Blaru	929	33	962
11	Île-de-France	78	1	07	070	Boinville-en-Mantois	312	7	319
11	Île-de-France	78	2	19	071	Boinville-le-Gaillard	617	6	623
11	Île-de-France	78	1	07	072	Boinvilliers	268	7	275
11	Île-de-France	78	4	36	073	Bois-d;Arcy	13693	187	13880
11	Île-de-France	78	1	08	076	Boissets	272	8	280
11	Île-de-France	78	2	18	077	La Boissière-École	769	108	877
11	Île-de-France	78	1	02	082	Boissy-Mauvoisin	624	8	632
11	Île-de-France	78	2	15	084	Boissy-sans-Avoir	586	17	603
11	Île-de-France	78	2	19	087	Bonnelles	1913	58	1971
11	Île-de-France	78	1	02	089	Bonnières-sur-Seine	4344	53	4397
11	Île-de-France	78	1	01	090	Bouafle	2132	24	2156
11	Île-de-France	78	3	03	092	Bougival	8447	139	8586
11	Île-de-France	78	1	08	096	Bourdonné	490	5	495
11	Île-de-France	78	1	07	104	Breuil-Bois-Robert	709	12	721
11	Île-de-France	78	1	02	107	Bréval	1979	41	2020
11	Île-de-France	78	2	18	108	Les Bréviaires	1261	31	1292
11	Île-de-France	78	1	10	113	Brueil-en-Vexin	687	25	712
11	Île-de-France	78	4	29	117	Buc	5312	180	5492
11	Île-de-France	78	1	33	118	Buchelay	2346	31	2377
11	Île-de-France	78	2	19	120	Bullion	1951	61	2012
11	Île-de-France	78	3	16	123	Carrières-sous-Poissy	15234	155	15389
11	Île-de-France	78	3	09	124	Carrières-sur-Seine	15473	141	15614
11	Île-de-France	78	2	19	125	La Celle-les-Bordes	934	24	958
11	Île-de-France	78	3	03	126	La Celle-Saint-Cloud	20971	403	21374
11	Île-de-France	78	2	05	128	Cernay-la-Ville	1643	44	1687
11	Île-de-France	78	3	21	133	Chambourcy	5872	181	6053
11	Île-de-France	78	3	39	138	Chanteloup-les-Vignes	9626	96	9722
11	Île-de-France	78	1	14	140	Chapet	1180	12	1192
11	Île-de-France	78	4	29	143	Châteaufort	1429	54	1483
11	Île-de-France	78	3	04	146	Chatou	30173	494	30667
11	Île-de-France	78	1	02	147	Chaufour-lès-Bonnières	422	6	428
11	Île-de-France	78	3	22	152	Chavenay	1863	71	1934
11	Île-de-France	78	4	32	158	Le Chesnay	28975	707	29682
11	Île-de-France	78	2	05	160	Chevreuse	5768	123	5891
11	Île-de-France	78	2	05	162	Choisel	525	19	544
11	Île-de-France	78	1	08	163	Civry-la-Forêt	357	12	369
11	Île-de-France	78	2	19	164	Clairefontaine-en-Yvelines	790	111	901
11	Île-de-France	78	4	38	165	Les Clayes-sous-Bois	17553	220	17773
11	Île-de-France	78	2	34	168	Coignières	4527	34	4561
11	Île-de-France	78	1	08	171	Condé-sur-Vesgre	1139	16	1155
11	Île-de-France	78	3	06	172	Conflans-Sainte-Honorine	35380	460	35840
11	Île-de-France	78	1	08	185	Courgent	378	9	387
11	Île-de-France	78	1	02	188	Cravent	414	3	417
11	Île-de-France	78	3	17	189	Crespières	1574	62	1636
11	Île-de-France	78	3	04	190	Croissy-sur-Seine	10048	313	10361
11	Île-de-France	78	1	08	192	Dammartin-en-Serve	1028	11	1039
11	Île-de-France	78	2	05	193	Dampierre-en-Yvelines	1113	22	1135
11	Île-de-France	78	1	08	194	Dannemarie	242	2	244
11	Île-de-France	78	3	17	196	Davron	340	10	350
11	Île-de-France	78	1	10	202	Drocourt	505	5	510
11	Île-de-France	78	1	01	206	Ecquevilly	3931	44	3975
11	Île-de-France	78	2	34	208	Élancourt	26829	433	27262
11	Île-de-France	78	2	18	209	Émancé	850	27	877
11	Île-de-France	78	1	07	217	Épône	6503	115	6618
11	Île-de-France	78	2	18	220	Les Essarts-le-Roi	6318	142	6460
11	Île-de-France	78	3	22	224	L; Étang-la-Ville	4769	203	4972
11	Île-de-France	78	1	14	227	Évecquemont	786	22	808
11	Île-de-France	78	1	07	230	La Falaise	618	21	639
11	Île-de-France	78	1	02	231	Favrieux	148	2	150
11	Île-de-France	78	3	22	233	Feucherolles	2908	150	3058
11	Île-de-France	78	1	07	234	Flacourt	140	2	142
11	Île-de-France	78	2	15	236	Flexanville	574	7	581
11	Île-de-France	78	1	08	237	Flins-Neuve-Église	164	3	167
11	Île-de-France	78	1	01	238	Flins-sur-Seine	2426	24	2450
11	Île-de-France	78	1	10	239	Follainville-Dennemont	1846	30	1876
11	Île-de-France	78	4	36	242	Fontenay-le-Fleury	12732	133	12865
11	Île-de-France	78	1	02	245	Fontenay-Mauvoisin	418	5	423
11	Île-de-France	78	1	10	246	Fontenay-Saint-Père	995	26	1021
11	Île-de-France	78	3	35	251	Fourqueux	4085	252	4337
11	Île-de-France	78	1	02	255	Freneuse	3930	58	3988
11	Île-de-France	78	1	14	261	Gaillon-sur-Montcient	665	14	679
11	Île-de-France	78	2	15	262	Galluis	1142	15	1157
11	Île-de-France	78	1	08	263	Gambais	2466	38	2504
11	Île-de-France	78	2	18	264	Gambaiseuil	69	0	69
11	Île-de-France	78	2	15	265	Garancières	2382	59	2441
11	Île-de-France	78	1	10	267	Gargenville	6770	92	6862
11	Île-de-France	78	2	18	269	Gazeran	1238	31	1269
11	Île-de-France	78	1	02	276	Gommecourt	659	8	667
11	Île-de-France	78	2	15	278	Goupillières	460	7	467
11	Île-de-France	78	1	07	281	Goussonville	617	11	628
11	Île-de-France	78	1	08	283	Grandchamp	309	3	312
11	Île-de-France	78	1	08	285	Gressey	541	13	554
11	Île-de-France	78	2	15	289	Grosrouvre	933	25	958
11	Île-de-France	78	1	10	290	Guernes	1011	13	1024
11	Île-de-France	78	1	07	291	Guerville	2079	27	2106
11	Île-de-France	78	1	10	296	Guitrancourt	645	12	657
11	Île-de-France	78	4	28	297	Guyancourt	27966	552	28518
11	Île-de-France	78	1	14	299	Hardricourt	2083	37	2120
11	Île-de-France	78	1	07	300	Hargeville	397	5	402
11	Île-de-France	78	1	08	302	La Hauteville	176	3	179
11	Île-de-France	78	1	01	305	Herbeville	287	10	297
11	Île-de-France	78	2	18	307	Hermeray	948	16	964
11	Île-de-France	78	1	08	310	Houdan	3289	48	3337
11	Île-de-France	78	3	09	311	Houilles	31557	292	31849
11	Île-de-France	78	1	10	314	Issou	4539	49	4588
11	Île-de-France	78	1	10	317	Jambville	809	12	821
11	Île-de-France	78	1	02	320	Jeufosse	427	5	432
11	Île-de-France	78	2	15	321	Jouars-Pontchartrain	5267	89	5356
11	Île-de-France	78	4	29	322	Jouy-en-Josas	8187	129	8316
11	Île-de-France	78	1	02	324	Jouy-Mauvoisin	553	4	557
11	Île-de-France	78	1	07	325	Jumeauville	592	1	593
11	Île-de-France	78	1	10	327	Juziers	3773	61	3834
11	Île-de-France	78	1	10	329	Lainville-en-Vexin	812	9	821
11	Île-de-France	78	2	05	334	Lévis-Saint-Nom	1705	63	1768
11	Île-de-France	78	1	10	335	Limay	16302	232	16534
11	Île-de-France	78	1	02	337	Limetz-Villez	1891	18	1909
11	Île-de-France	78	4	29	343	Les Loges-en-Josas	1548	48	1596
11	Île-de-France	78	1	02	344	Lommoye	644	12	656
11	Île-de-France	78	1	08	346	Longnes	1467	30	1497
11	Île-de-France	78	2	19	349	Longvilliers	516	12	528
11	Île-de-France	78	3	13	350	Louveciennes	7245	168	7413
11	Île-de-France	78	1	33	354	Magnanville	5846	165	6011
11	Île-de-France	78	2	05	356	Magny-les-Hameaux	9027	173	9200
11	Île-de-France	78	3	11	358	Maisons-Laffitte	22817	470	23287
11	Île-de-France	78	1	12	361	Mantes-la-Jolie	42969	299	43268
11	Île-de-France	78	1	33	362	Mantes-la-Ville	19234	184	19418
11	Île-de-France	78	2	15	364	Marcq	707	14	721
11	Île-de-France	78	2	15	366	Mareil-le-Guyon	401	10	411
11	Île-de-France	78	3	35	367	Mareil-Marly	3517	169	3686
11	Île-de-France	78	1	01	368	Mareil-sur-Mauldre	1731	50	1781
11	Île-de-France	78	3	13	372	Marly-le-Roi	16614	405	17019
11	Île-de-France	78	1	01	380	Maule	5801	175	5976
11	Île-de-France	78	1	08	381	Maulette	756	21	777
11	Île-de-France	78	3	39	382	Maurecourt	4302	47	4349
11	Île-de-France	78	2	34	383	Maurepas	18679	335	19014
11	Île-de-France	78	3	16	384	Médan	1456	42	1498
11	Île-de-France	78	1	02	385	Ménerville	202	2	204
11	Île-de-France	78	2	15	389	Méré	1700	89	1789
11	Île-de-France	78	1	02	391	Méricourt	391	10	401
11	Île-de-France	78	3	11	396	Le Mesnil-le-Roi	6415	128	6543
11	Île-de-France	78	2	05	397	Le Mesnil-Saint-Denis	6629	120	6749
11	Île-de-France	78	2	15	398	Les Mesnuls	874	19	893
11	Île-de-France	78	1	14	401	Meulan-en-Yvelines	8855	132	8987
11	Île-de-France	78	1	07	402	Mézières-sur-Seine	3526	42	3568
11	Île-de-France	78	1	14	403	Mézy-sur-Seine	1949	25	1974
11	Île-de-France	78	2	15	404	Millemont	251	3	254
11	Île-de-France	78	2	05	406	Milon-la-Chapelle	311	7	318
11	Île-de-France	78	2	18	407	Mittainville	613	22	635
11	Île-de-France	78	1	02	410	Moisson	924	31	955
11	Île-de-France	78	1	08	413	Mondreville	369	2	371
11	Île-de-France	78	1	01	415	Montainville	561	24	585
11	Île-de-France	78	1	10	416	Montalet-le-Bois	327	3	330
11	Île-de-France	78	1	08	417	Montchauvet	288	11	299
11	Île-de-France	78	3	30	418	Montesson	15193	219	15412
11	Île-de-France	78	2	15	420	Montfort-l;Amaury	3138	75	3213
11	Île-de-France	78	4	28	423	Montigny-le-Bretonneux	33337	562	33899
11	Île-de-France	78	3	17	431	Morainvilliers	2399	55	2454
11	Île-de-France	78	1	02	437	Mousseaux-sur-Seine	613	7	620
11	Île-de-France	78	1	08	439	Mulcent	113	0	113
11	Île-de-France	78	1	14	440	Les Mureaux	30859	257	31116
11	Île-de-France	78	2	15	442	Neauphle-le-Château	3011	64	3075
11	Île-de-France	78	2	15	443	Neauphle-le-Vieux	751	10	761
11	Île-de-France	78	1	02	444	Neauphlette	890	12	902
11	Île-de-France	78	1	01	451	Nézel	1042	18	1060
11	Île-de-France	78	3	22	455	Noisy-le-Roi	7811	296	8107
11	Île-de-France	78	1	10	460	Oinville-sur-Montcient	1115	23	1138
11	Île-de-France	78	2	18	464	Orcemont	847	14	861
11	Île-de-France	78	1	08	465	Orgerus	2358	46	2404
11	Île-de-France	78	3	17	466	Orgeval	5855	130	5985
11	Île-de-France	78	2	18	470	Orphin	913	24	937
11	Île-de-France	78	2	19	472	Orsonville	332	5	337
11	Île-de-France	78	1	08	474	Orvilliers	683	7	690
11	Île-de-France	78	1	08	475	Osmoy	382	8	390
11	Île-de-France	78	2	19	478	Paray-Douaville	242	4	246
11	Île-de-France	78	3	35	481	Le Pecq	16496	325	16821
11	Île-de-France	78	1	02	484	Perdreauville	622	4	626
11	Île-de-France	78	2	18	486	Le Perray-en-Yvelines	6600	121	6721
11	Île-de-France	78	4	38	490	Plaisir	30958	402	31360
11	Île-de-France	78	2	18	497	Poigny-la-Forêt	1034	46	1080
11	Île-de-France	78	3	97	498	Poissy	37680	369	38049
11	Île-de-France	78	2	19	499	Ponthévrard	601	6	607
11	Île-de-France	78	1	10	501	Porcheville	2832	37	2869
11	Île-de-France	78	3	13	502	Le Port-Marly	4803	90	4893
11	Île-de-France	78	1	02	503	Port-Villez	246	2	248
11	Île-de-France	78	2	19	506	Prunay-en-Yvelines	813	15	828
11	Île-de-France	78	1	08	505	Prunay-le-Temple	394	12	406
11	Île-de-France	78	2	15	513	La Queue-les-Yvelines	2161	40	2201
11	Île-de-France	78	2	18	516	Raizeux	847	18	865
11	Île-de-France	78	2	18	517	Rambouillet	26159	842	27001
11	Île-de-France	78	3	22	518	Rennemoulin	111	5	116
11	Île-de-France	78	1	08	520	Richebourg	1510	83	1593
11	Île-de-France	78	2	19	522	Rochefort-en-Yvelines	960	25	985
11	Île-de-France	78	4	32	524	Rocquencourt	3215	75	3290
11	Île-de-France	78	1	02	528	Rolleboise	412	6	418
11	Île-de-France	78	1	07	530	Rosay	385	3	388
11	Île-de-France	78	1	33	531	Rosny-sur-Seine	5521	72	5593
11	Île-de-France	78	1	10	536	Sailly	379	3	382
11	Île-de-France	78	2	19	537	Saint-Arnoult-en-Yvelines	6150	121	6271
11	Île-de-France	78	4	36	545	Saint-Cyr-l;École	17401	575	17976
11	Île-de-France	78	2	05	548	Saint-Forget	474	9	483
11	Île-de-France	78	2	15	550	Saint-Germain-de-la-Grange	1824	49	1873
11	Île-de-France	78	3	98	551	Saint-Germain-en-Laye	40481	1528	42009
11	Île-de-France	78	2	18	557	Saint-Hilarion	901	22	923
11	Île-de-France	78	1	02	558	Saint-Illiers-la-Ville	321	4	325
11	Île-de-France	78	1	02	559	Saint-Illiers-le-Bois	453	6	459
11	Île-de-France	78	2	05	561	Saint-Lambert	418	20	438
11	Île-de-France	78	2	18	562	Saint-Léger-en-Yvelines	1484	29	1513
11	Île-de-France	78	2	19	564	Saint-Martin-de-Bréthencourt	635	13	648
11	Île-de-France	78	1	08	565	Saint-Martin-des-Champs	321	10	331
11	Île-de-France	78	1	10	567	Saint-Martin-la-Garenne	920	14	934
11	Île-de-France	78	3	22	571	Saint-Nom-la-Bretèche	5147	230	5377
11	Île-de-France	78	2	15	576	Saint-Rémy-l;Honoré	1384	29	1413
11	Île-de-France	78	2	05	575	Saint-Rémy-lès-Chevreuse	7922	245	8167
11	Île-de-France	78	2	19	569	Sainte-Mesme	942	23	965
11	Île-de-France	78	3	23	586	Sartrouville	51150	354	51504
11	Île-de-France	78	2	15	588	Saulx-Marchais	895	13	908
11	Île-de-France	78	2	05	590	Senlisse	541	15	556
11	Île-de-France	78	1	08	591	Septeuil	2201	62	2263
11	Île-de-France	78	1	07	597	Soindres	597	7	604
11	Île-de-France	78	2	19	601	Sonchamp	1577	63	1640
11	Île-de-France	78	1	08	605	Tacoignières	1049	23	1072
11	Île-de-France	78	1	08	606	Le Tartre-Gaudran	31	0	31
11	Île-de-France	78	1	02	608	Le Tertre-Saint-Denis	114	2	116
11	Île-de-France	78	1	14	609	Tessancourt-sur-Aubette	947	22	969
11	Île-de-France	78	4	38	615	Thiverval-Grignon	1006	17	1023
11	Île-de-France	78	2	15	616	Thoiry	1139	22	1161
11	Île-de-France	78	1	08	618	Tilly	542	13	555
11	Île-de-France	78	4	29	620	Toussus-le-Noble	958	32	990
11	Île-de-France	78	4	24	621	Trappes	29380	325	29705
11	Île-de-France	78	2	15	623	Le Tremblay-sur-Mauldre	969	98	1067
11	Île-de-France	78	3	25	624	Triel-sur-Seine	11598	179	11777
11	Île-de-France	78	1	14	638	Vaux-sur-Seine	4813	93	4906
11	Île-de-France	78	4	37	640	Vélizy-Villacoublay	20089	259	20348
11	Île-de-France	78	3	25	642	Verneuil-sur-Seine	15178	403	15581
11	Île-de-France	78	3	25	643	Vernouillet	9399	183	9582
11	Île-de-France	78	2	34	644	La Verrière	5993	107	6100
11	Île-de-France	78	4	99	646	Versailles	86110	2143	88253
11	Île-de-France	78	1	07	647	Vert	788	15	803
11	Île-de-France	78	3	30	650	Le Vésinet	16249	504	16753
11	Île-de-France	78	2	15	653	Vicq	333	2	335
11	Île-de-France	78	2	18	655	Vieille-Église-en-Yvelines	811	33	844
11	Île-de-France	78	1	02	668	La Villeneuve-en-Chevrie	568	12	580
11	Île-de-France	78	3	16	672	Villennes-sur-Seine	5085	132	5217
11	Île-de-France	78	3	22	674	Villepreux	9871	235	10106
11	Île-de-France	78	1	07	677	Villette	511	10	521
11	Île-de-France	78	2	15	681	Villiers-le-Mahieu	704	11	715
11	Île-de-France	78	2	15	683	Villiers-Saint-Frédéric	2727	87	2814
11	Île-de-France	78	4	31	686	Viroflay	15905	319	16224
11	Île-de-France	78	2	05	688	Voisins-le-Bretonneux	11730	392	12122
54	Poitou-Charentes	79	3	18	001	L; Absie	1041	22	1063
54	Poitou-Charentes	79	3	22	002	Adilly	309	14	323
54	Poitou-Charentes	79	2	23	003	Aiffres	5229	189	5418
54	Poitou-Charentes	79	2	06	004	Aigonnay	610	11	621
54	Poitou-Charentes	79	3	01	005	Airvault	3074	75	3149
54	Poitou-Charentes	79	2	28	006	Les Alleuds	296	7	303
54	Poitou-Charentes	79	3	29	007	Allonne	648	11	659
54	Poitou-Charentes	79	3	22	008	Amailloux	857	15	872
54	Poitou-Charentes	79	2	12	009	Amuré	460	5	465
54	Poitou-Charentes	79	2	10	011	Ardilleux	165	1	166
54	Poitou-Charentes	79	2	11	012	Ardin	1218	29	1247
54	Poitou-Charentes	79	1	97	014	Argenton-l;Église	1632	27	1659
54	Poitou-Charentes	79	1	02	013	Argenton-les-Vallées	1602	64	1666
54	Poitou-Charentes	79	2	12	010	Arçais	608	22	630
54	Poitou-Charentes	79	2	05	015	Asnières-en-Poitou	193	1	194
54	Poitou-Charentes	79	3	24	016	Assais-les-Jumeaux	771	12	783
54	Poitou-Charentes	79	2	10	018	Aubigné	210	1	211
54	Poitou-Charentes	79	3	30	019	Aubigny	178	4	182
54	Poitou-Charentes	79	2	25	020	Augé	926	21	947
54	Poitou-Charentes	79	3	01	022	Availles-Thouarsais	211	4	215
54	Poitou-Charentes	79	2	19	023	Avon	79	0	79
54	Poitou-Charentes	79	2	25	024	Azay-le-Brûlé	1806	133	1939
54	Poitou-Charentes	79	3	29	025	Azay-sur-Thouet	1098	15	1113
54	Poitou-Charentes	79	2	10	027	La Bataille	77	6	83
54	Poitou-Charentes	79	3	15	029	Beaulieu-sous-Parthenay	664	16	680
54	Poitou-Charentes	79	2	06	030	Beaussais	423	6	429
54	Poitou-Charentes	79	2	03	031	Beauvoir-sur-Niort	1738	30	1768
54	Poitou-Charentes	79	2	11	032	Béceleuf	698	7	705
54	Poitou-Charentes	79	2	03	033	Belleville	120	2	122
54	Poitou-Charentes	79	2	12	034	Bessines	1589	70	1659
54	Poitou-Charentes	79	2	11	035	Le Beugnon	316	3	319
54	Poitou-Charentes	79	1	04	038	Boismé	1154	23	1177
54	Poitou-Charentes	79	2	03	039	Boisserolles	62	1	63
54	Poitou-Charentes	79	3	15	040	La Boissière-en-Gâtine	229	8	237
54	Poitou-Charentes	79	2	19	042	Bougon	184	3	187
54	Poitou-Charentes	79	1	02	043	Bouillé-Loretz	1045	21	1066
54	Poitou-Charentes	79	1	02	044	Bouillé-Saint-Paul	422	70	492
54	Poitou-Charentes	79	2	10	045	Bouin	151	5	156
54	Poitou-Charentes	79	2	14	046	Le Bourdet	530	14	544
54	Poitou-Charentes	79	3	01	047	Boussais	416	8	424
54	Poitou-Charentes	79	1	04	049	Bressuire	18615	1061	19676
54	Poitou-Charentes	79	1	07	050	Bretignolles	634	18	652
54	Poitou-Charentes	79	3	18	051	Le Breuil-Bernard	472	12	484
54	Poitou-Charentes	79	1	02	053	Le Breuil-sous-Argenton	439	12	451
54	Poitou-Charentes	79	1	31	054	Brie	199	1	200
54	Poitou-Charentes	79	2	05	055	Brieuil-sur-Chizé	117	3	120
54	Poitou-Charentes	79	1	32	056	Brion-près-Thouet	757	14	771
54	Poitou-Charentes	79	2	05	057	Brioux-sur-Boutonne	1514	39	1553
54	Poitou-Charentes	79	2	23	058	Brûlain	683	11	694
54	Poitou-Charentes	79	2	11	059	Le Busseau	744	10	754
54	Poitou-Charentes	79	2	28	060	Caunay	167	1	168
54	Poitou-Charentes	79	2	06	061	Celles-sur-Belle	3753	88	3841
54	Poitou-Charentes	79	1	07	062	Cerizay	4660	77	4737
54	Poitou-Charentes	79	1	02	063	Cersay	999	20	1019
54	Poitou-Charentes	79	2	16	064	Chail	541	10	551
54	Poitou-Charentes	79	2	08	066	Champdeniers-Saint-Denis	1675	30	1705
54	Poitou-Charentes	79	3	17	068	Chantecorps	331	6	337
54	Poitou-Charentes	79	3	18	069	Chanteloup	986	22	1008
54	Poitou-Charentes	79	2	08	070	La Chapelle-Bâton	381	7	388
54	Poitou-Charentes	79	3	22	071	La Chapelle-Bertrand	512	6	518
54	Poitou-Charentes	79	1	27	072	La Chapelle-Gaudin	213	6	219
54	Poitou-Charentes	79	2	28	074	La Chapelle-Pouilloux	192	6	198
54	Poitou-Charentes	79	3	18	075	La Chapelle-Saint-Étienne	321	12	333
54	Poitou-Charentes	79	3	18	076	La Chapelle-Saint-Laurent	1854	48	1902
54	Poitou-Charentes	79	2	11	077	La Chapelle-Thireuil	434	12	446
54	Poitou-Charentes	79	3	22	080	Châtillon-sur-Thouet	2801	52	2853
54	Poitou-Charentes	79	2	20	081	Chauray	5985	211	6196
54	Poitou-Charentes	79	2	10	083	Chef-Boutonne	2126	117	2243
54	Poitou-Charentes	79	2	13	084	Chenay	485	14	499
54	Poitou-Charentes	79	2	05	085	Chérigné	131	7	138
54	Poitou-Charentes	79	2	25	086	Cherveux	1651	43	1694
54	Poitou-Charentes	79	2	13	087	Chey	617	14	631
54	Poitou-Charentes	79	1	04	088	Chiché	1633	36	1669
54	Poitou-Charentes	79	3	24	089	Le Chillou	182	2	184
54	Poitou-Charentes	79	2	05	090	Chizé	913	20	933
54	Poitou-Charentes	79	1	07	091	Cirières	963	18	981
54	Poitou-Charentes	79	3	15	092	Clavé	338	2	340
54	Poitou-Charentes	79	3	18	094	Clessé	934	16	950
54	Poitou-Charentes	79	2	28	095	Clussais-la-Pommeraie	600	12	612
54	Poitou-Charentes	79	1	07	096	Combrand	1141	41	1182
54	Poitou-Charentes	79	2	19	098	La Couarde	262	11	273
54	Poitou-Charentes	79	1	02	099	La Coudre	248	2	250
54	Poitou-Charentes	79	2	21	100	Coulon	2224	121	2345
54	Poitou-Charentes	79	2	11	101	Coulonges-sur-l;Autize	2373	51	2424
54	Poitou-Charentes	79	1	27	102	Coulonges-Thouarsais	439	4	443
54	Poitou-Charentes	79	1	07	103	Courlay	2415	58	2473
54	Poitou-Charentes	79	2	08	104	Cours	541	11	552
54	Poitou-Charentes	79	3	17	105	Coutières	156	4	160
54	Poitou-Charentes	79	2	10	106	Couture-d;Argenson	413	12	425
54	Poitou-Charentes	79	2	25	048	La Crèche	5449	170	5619
54	Poitou-Charentes	79	2	10	107	Crézières	55	2	57
54	Poitou-Charentes	79	3	30	108	Doux	238	7	245
54	Poitou-Charentes	79	2	20	109	Échiré	3336	81	3417
54	Poitou-Charentes	79	2	05	111	Ensigné	283	3	286
54	Poitou-Charentes	79	2	12	112	Épannes	775	19	794
54	Poitou-Charentes	79	1	02	113	Étusson	341	4	345
54	Poitou-Charentes	79	2	26	114	Exireuil	1563	35	1598
54	Poitou-Charentes	79	2	19	115	Exoudun	589	19	608
54	Poitou-Charentes	79	1	04	116	Faye-l;Abbesse	1044	19	1063
54	Poitou-Charentes	79	2	11	117	Faye-sur-Ardin	632	11	643
54	Poitou-Charentes	79	3	22	118	Fénery	304	4	308
54	Poitou-Charentes	79	2	11	119	Fenioux	688	12	700
54	Poitou-Charentes	79	3	30	120	La Ferrière-en-Parthenay	805	19	824
54	Poitou-Charentes	79	3	17	121	Fomperron	431	8	439
54	Poitou-Charentes	79	2	10	122	Fontenille-Saint-Martin-d;Entraigues	591	5	596
54	Poitou-Charentes	79	1	07	123	La Forêt-sur-Sèvre	2294	45	2339
54	Poitou-Charentes	79	3	17	124	Les Forges	126	5	131
54	Poitou-Charentes	79	2	23	125	Fors	1684	33	1717
54	Poitou-Charentes	79	2	05	126	Les Fosses	445	8	453
54	Poitou-Charentes	79	2	03	127	La Foye-Monjault	765	17	782
54	Poitou-Charentes	79	2	25	128	François	925	25	950
54	Poitou-Charentes	79	2	06	129	Fressines	1357	42	1399
54	Poitou-Charentes	79	2	12	130	Frontenay-Rohan-Rohan	2982	97	3079
54	Poitou-Charentes	79	1	27	131	Geay	342	7	349
54	Poitou-Charentes	79	1	02	132	Genneton	340	5	345
54	Poitou-Charentes	79	2	08	133	Germond-Rouvre	1152	25	1177
54	Poitou-Charentes	79	1	27	134	Glénay	545	14	559
54	Poitou-Charentes	79	3	24	135	Gourgé	935	32	967
54	Poitou-Charentes	79	2	10	136	Gournay-Loizé	614	9	623
54	Poitou-Charentes	79	2	03	137	Granzay-Gript	902	17	919
54	Poitou-Charentes	79	3	15	139	Les Groseillers	67	4	71
54	Poitou-Charentes	79	2	10	140	Hanc	257	3	260
54	Poitou-Charentes	79	3	01	141	Irais	199	2	201
54	Poitou-Charentes	79	2	05	142	Juillé	106	1	107
54	Poitou-Charentes	79	2	23	144	Juscorps	372	5	377
54	Poitou-Charentes	79	3	22	145	Lageon	368	10	378
54	Poitou-Charentes	79	3	18	147	Largeasse	726	11	737
54	Poitou-Charentes	79	2	13	148	Lezay	2066	41	2107
54	Poitou-Charentes	79	3	30	149	Lhoumois	140	3	143
54	Poitou-Charentes	79	2	28	150	Limalonges	873	8	881
54	Poitou-Charentes	79	2	28	152	Lorigné	279	5	284
54	Poitou-Charentes	79	2	10	153	Loubigné	162	3	165
54	Poitou-Charentes	79	2	10	154	Loubillé	378	6	384
54	Poitou-Charentes	79	3	24	156	Louin	756	15	771
54	Poitou-Charentes	79	1	32	157	Louzy	1287	29	1316
54	Poitou-Charentes	79	2	05	158	Luché-sur-Brioux	143	2	145
54	Poitou-Charentes	79	1	27	159	Luché-Thouarsais	421	4	425
54	Poitou-Charentes	79	2	05	160	Lusseray	166	8	174
54	Poitou-Charentes	79	1	27	161	Luzay	567	15	582
54	Poitou-Charentes	79	2	21	162	Magné	2820	87	2907
54	Poitou-Charentes	79	2	28	163	Mairé-Levescault	569	7	576
54	Poitou-Charentes	79	2	16	164	Maisonnay	258	4	262
54	Poitou-Charentes	79	3	24	165	Maisontiers	185	1	186
54	Poitou-Charentes	79	2	03	166	Marigny	891	18	909
54	Poitou-Charentes	79	3	01	167	Marnes	241	2	243
54	Poitou-Charentes	79	1	02	168	Massais	572	8	580
54	Poitou-Charentes	79	1	09	079	Mauléon	8172	222	8394
54	Poitou-Charentes	79	2	14	170	Mauzé-sur-le-Mignon	2800	63	2863
54	Poitou-Charentes	79	1	32	171	Mauzé-Thouarsais	2059	49	2108
54	Poitou-Charentes	79	3	15	172	Mazières-en-Gâtine	969	26	995
54	Poitou-Charentes	79	2	16	173	Mazières-sur-Béronne	404	6	410
54	Poitou-Charentes	79	2	16	174	Melle	3657	267	3924
54	Poitou-Charentes	79	2	28	175	Melleran	516	11	527
54	Poitou-Charentes	79	3	17	176	Ménigoute	878	20	898
54	Poitou-Charentes	79	2	13	177	Messé	178	8	186
54	Poitou-Charentes	79	1	31	178	Missé	863	26	889
54	Poitou-Charentes	79	3	18	179	Moncoutant	3170	130	3300
54	Poitou-Charentes	79	2	28	180	Montalembert	274	6	280
54	Poitou-Charentes	79	1	07	183	Montravers	379	12	391
54	Poitou-Charentes	79	2	19	184	La Mothe-Saint-Héray	1801	44	1845
54	Poitou-Charentes	79	2	06	185	Mougon	2044	55	2099
54	Poitou-Charentes	79	1	02	187	Moutiers-sous-Argenton	588	12	600
54	Poitou-Charentes	79	3	18	188	Moutiers-sous-Chantemerle	609	18	627
54	Poitou-Charentes	79	2	26	189	Nanteuil	1670	30	1700
54	Poitou-Charentes	79	3	29	190	Neuvy-Bouin	486	4	490
54	Poitou-Charentes	79	2	98	191	Niort	57325	2179	59504
54	Poitou-Charentes	79	1	09	195	Nueil-les-Aubiers	5444	86	5530
54	Poitou-Charentes	79	1	31	196	Oiron	961	14	975
54	Poitou-Charentes	79	3	30	197	Oroux	105	1	106
54	Poitou-Charentes	79	2	05	198	Paizay-le-Chapt	265	3	268
54	Poitou-Charentes	79	2	16	199	Paizay-le-Tort	476	5	481
54	Poitou-Charentes	79	2	08	200	Pamplie	273	0	273
54	Poitou-Charentes	79	2	19	201	Pamproux	1678	27	1705
54	Poitou-Charentes	79	3	22	202	Parthenay	10478	588	11066
54	Poitou-Charentes	79	1	31	203	Pas-de-Jeu	395	4	399
54	Poitou-Charentes	79	2	05	204	Périgné	1020	34	1054
54	Poitou-Charentes	79	2	28	205	Pers	75	1	76
54	Poitou-Charentes	79	1	09	207	La Petite-Boissière	645	20	665
54	Poitou-Charentes	79	3	30	208	La Peyratte	1145	80	1225
54	Poitou-Charentes	79	1	27	209	Pierrefitte	333	5	338
54	Poitou-Charentes	79	1	07	210	Le Pin	1069	27	1096
54	Poitou-Charentes	79	2	10	211	Pioussay	325	6	331
54	Poitou-Charentes	79	2	28	212	Pliboux	201	1	202
54	Poitou-Charentes	79	3	22	213	Pompaire	1958	57	2015
54	Poitou-Charentes	79	2	16	214	Pouffonds	374	1	375
54	Poitou-Charentes	79	3	29	215	Pougne-Hérisson	372	4	376
54	Poitou-Charentes	79	2	23	216	Prahecq	2069	54	2123
54	Poitou-Charentes	79	2	06	217	Prailles	658	15	673
54	Poitou-Charentes	79	3	30	218	Pressigny	204	1	205
54	Poitou-Charentes	79	2	14	219	Priaires	120	4	124
54	Poitou-Charentes	79	2	14	220	Prin-Deyrançon	605	12	617
54	Poitou-Charentes	79	2	03	078	Prissé-la-Charrière	620	7	627
54	Poitou-Charentes	79	3	18	222	Pugny	243	3	246
54	Poitou-Charentes	79	2	11	223	Puihardy	67	1	68
54	Poitou-Charentes	79	3	17	225	Reffannes	374	5	379
54	Poitou-Charentes	79	3	29	226	Le Retail	263	9	272
54	Poitou-Charentes	79	2	14	229	La Rochénard	561	6	567
54	Poitou-Charentes	79	2	13	230	Rom	842	19	861
54	Poitou-Charentes	79	2	26	231	Romans	740	11	751
54	Poitou-Charentes	79	1	09	235	Saint-Amand-sur-Sèvre	1287	47	1334
54	Poitou-Charentes	79	1	07	236	Saint-André-sur-Sèvre	646	16	662
54	Poitou-Charentes	79	1	02	238	Saint-Aubin-du-Plain	550	17	567
54	Poitou-Charentes	79	3	29	239	Saint-Aubin-le-Cloud	1760	148	1908
54	Poitou-Charentes	79	2	08	241	Saint-Christophe-sur-Roc	593	15	608
54	Poitou-Charentes	79	1	02	242	Saint-Clémentin	516	17	533
54	Poitou-Charentes	79	2	13	243	Saint-Coutant	261	0	261
54	Poitou-Charentes	79	1	31	244	Saint-Cyr-la-Lande	351	10	361
54	Poitou-Charentes	79	2	03	247	Saint-Étienne-la-Cigogne	135	2	137
54	Poitou-Charentes	79	2	20	249	Saint-Gelais	1743	56	1799
54	Poitou-Charentes	79	2	16	251	Saint-Génard	366	6	372
54	Poitou-Charentes	79	3	01	252	Saint-Généroux	372	8	380
54	Poitou-Charentes	79	3	15	253	Saint-Georges-de-Noisné	706	12	718
54	Poitou-Charentes	79	2	14	254	Saint-Georges-de-Rex	408	7	415
54	Poitou-Charentes	79	3	22	255	Saint-Germain-de-Longue-Chaume	407	10	417
54	Poitou-Charentes	79	3	17	256	Saint-Germier	201	2	203
54	Poitou-Charentes	79	2	14	257	Saint-Hilaire-la-Palud	1597	26	1623
54	Poitou-Charentes	79	1	31	258	Saint-Jacques-de-Thouars	464	10	474
54	Poitou-Charentes	79	1	31	259	Saint-Jean-de-Thouars	1344	38	1382
54	Poitou-Charentes	79	3	01	260	Saint-Jouin-de-Marnes	585	8	593
54	Poitou-Charentes	79	1	07	261	Saint-Jouin-de-Milly	209	9	218
54	Poitou-Charentes	79	2	11	263	Saint-Laurs	533	14	547
54	Poitou-Charentes	79	2	16	264	Saint-Léger-de-la-Martinière	986	57	1043
54	Poitou-Charentes	79	1	31	265	Saint-Léger-de-Montbrun	1214	30	1244
54	Poitou-Charentes	79	3	15	267	Saint-Lin	365	5	370
54	Poitou-Charentes	79	3	24	268	Saint-Loup-Lamairé	942	50	992
54	Poitou-Charentes	79	2	11	269	Saint-Maixent-de-Beugné	356	15	371
54	Poitou-Charentes	79	2	99	270	Saint-Maixent-l;École	7483	181	7664
54	Poitou-Charentes	79	3	15	271	Saint-Marc-la-Lande	359	4	363
54	Poitou-Charentes	79	2	23	273	Saint-Martin-de-Bernegoue	793	16	809
54	Poitou-Charentes	79	1	31	274	Saint-Martin-de-Mâcon	328	6	334
54	Poitou-Charentes	79	2	26	276	Saint-Martin-de-Saint-Maixent	1113	28	1141
54	Poitou-Charentes	79	1	32	277	Saint-Martin-de-Sanzay	977	12	989
54	Poitou-Charentes	79	3	17	278	Saint-Martin-du-Fouilloux	216	8	224
54	Poitou-Charentes	79	2	16	279	Saint-Martin-lès-Melle	871	23	894
54	Poitou-Charentes	79	1	02	280	Saint-Maurice-la-Fougereuse	541	13	554
54	Poitou-Charentes	79	2	20	281	Saint-Maxire	1131	30	1161
54	Poitou-Charentes	79	2	06	282	Saint-Médard	109	4	113
54	Poitou-Charentes	79	3	15	285	Saint-Pardoux	1578	37	1615
54	Poitou-Charentes	79	3	18	286	Saint-Paul-en-Gâtine	451	3	454
54	Poitou-Charentes	79	1	09	289	Saint-Pierre-des-Échaubrognes	1371	28	1399
54	Poitou-Charentes	79	2	11	290	Saint-Pompain	937	20	957
54	Poitou-Charentes	79	2	20	293	Saint-Rémy	1027	24	1051
54	Poitou-Charentes	79	2	23	294	Saint-Romans-des-Champs	177	6	183
54	Poitou-Charentes	79	2	16	295	Saint-Romans-lès-Melle	682	29	711
54	Poitou-Charentes	79	2	12	298	Saint-Symphorien	1800	42	1842
54	Poitou-Charentes	79	1	27	299	Saint-Varent	2496	39	2535
54	Poitou-Charentes	79	2	16	301	Saint-Vincent-la-Châtre	608	6	614
54	Poitou-Charentes	79	2	06	240	Sainte-Blandine	697	16	713
54	Poitou-Charentes	79	2	26	246	Sainte-Eanne	671	16	687
54	Poitou-Charentes	79	1	27	250	Sainte-Gemme	380	3	383
54	Poitou-Charentes	79	2	26	283	Sainte-Néomaye	1339	36	1375
54	Poitou-Charentes	79	2	08	284	Sainte-Ouenne	788	12	800
54	Poitou-Charentes	79	1	32	292	Sainte-Radegonde	1955	62	2017
54	Poitou-Charentes	79	2	13	297	Sainte-Soline	348	10	358
54	Poitou-Charentes	79	1	32	300	Sainte-Verge	1438	39	1477
54	Poitou-Charentes	79	2	25	302	Saivres	1393	29	1422
54	Poitou-Charentes	79	2	19	303	Salles	343	10	353
54	Poitou-Charentes	79	2	12	304	Sansais	776	22	798
54	Poitou-Charentes	79	3	30	306	Saurais	188	5	193
54	Poitou-Charentes	79	2	28	307	Sauzé-Vaussais	1616	41	1657
54	Poitou-Charentes	79	2	20	308	Sciecq	582	24	606
54	Poitou-Charentes	79	2	11	309	Scillé	380	5	385
54	Poitou-Charentes	79	2	05	310	Secondigné-sur-Belle	545	13	558
54	Poitou-Charentes	79	3	29	311	Secondigny	1798	51	1849
54	Poitou-Charentes	79	2	05	312	Séligné	119	1	120
54	Poitou-Charentes	79	2	13	313	Sepvret	583	18	601
54	Poitou-Charentes	79	2	16	314	Sompt	311	7	318
54	Poitou-Charentes	79	2	19	316	Soudan	452	6	458
54	Poitou-Charentes	79	3	15	318	Soutiers	265	17	282
54	Poitou-Charentes	79	2	26	319	Souvigné	869	20	889
54	Poitou-Charentes	79	2	08	320	Surin	610	11	621
54	Poitou-Charentes	79	1	31	321	Taizé	777	24	801
54	Poitou-Charentes	79	3	22	322	Le Tallud	2030	55	2085
54	Poitou-Charentes	79	3	24	325	Tessonnière	313	5	318
54	Poitou-Charentes	79	3	30	326	Thénezay	1476	30	1506
54	Poitou-Charentes	79	2	06	327	Thorigné	1267	33	1300
54	Poitou-Charentes	79	2	03	328	Thorigny-sur-le-Mignon	85	4	89
54	Poitou-Charentes	79	1	95	329	Thouars	9822	239	10061
54	Poitou-Charentes	79	2	10	330	Tillou	301	7	308
54	Poitou-Charentes	79	1	31	331	Tourtenay	142	3	145
54	Poitou-Charentes	79	3	18	332	Trayes	133	2	135
54	Poitou-Charentes	79	1	02	333	Ulcot	58	1	59
54	Poitou-Charentes	79	2	14	334	Usseau	913	19	932
54	Poitou-Charentes	79	2	12	335	Vallans	762	17	779
54	Poitou-Charentes	79	2	12	337	Le Vanneau-Irleau	919	15	934
54	Poitou-Charentes	79	2	13	338	Vanzay	204	8	212
54	Poitou-Charentes	79	2	13	336	Vançais	266	3	269
54	Poitou-Charentes	79	3	17	339	Vasles	1706	26	1732
54	Poitou-Charentes	79	3	17	340	Vausseroux	350	9	359
54	Poitou-Charentes	79	3	17	341	Vautebis	122	1	123
54	Poitou-Charentes	79	3	29	342	Vernoux-en-Gâtine	602	14	616
54	Poitou-Charentes	79	2	05	343	Vernoux-sur-Boutonne	170	0	170
54	Poitou-Charentes	79	3	15	345	Verruyes	911	22	933
54	Poitou-Charentes	79	2	05	346	Le Vert	128	2	130
54	Poitou-Charentes	79	3	22	347	Viennay	1103	34	1137
54	Poitou-Charentes	79	2	05	348	Villefollet	199	3	202
54	Poitou-Charentes	79	2	10	349	Villemain	167	2	169
54	Poitou-Charentes	79	2	05	350	Villiers-en-Bois	144	2	146
54	Poitou-Charentes	79	2	11	351	Villiers-en-Plaine	1694	54	1748
54	Poitou-Charentes	79	2	05	352	Villiers-sur-Chizé	165	9	174
54	Poitou-Charentes	79	2	06	353	Vitré	532	50	582
54	Poitou-Charentes	79	3	15	354	Vouhé	368	3	371
54	Poitou-Charentes	79	2	23	355	Vouillé	3248	131	3379
54	Poitou-Charentes	79	1	02	356	Voultegon	558	14	572
54	Poitou-Charentes	79	2	08	357	Xaintray	240	3	243
22	Picardie	80	1	98	001	Abbeville	24155	798	24953
22	Picardie	80	4	15	002	Ablaincourt-Pressoir	265	11	276
22	Picardie	80	2	03	003	Acheux-en-Amiénois	569	19	588
22	Picardie	80	1	29	004	Acheux-en-Vimeu	528	5	533
22	Picardie	80	2	12	005	Agenville	114	2	116
22	Picardie	80	1	31	006	Agenvillers	193	2	195
22	Picardie	80	1	22	008	Aigneville	845	5	850
22	Picardie	80	1	04	009	Ailly-le-Haut-Clocher	895	21	916
22	Picardie	80	3	05	010	Ailly-sur-Noye	2805	32	2837
22	Picardie	80	2	34	011	Ailly-sur-Somme	3157	32	3189
22	Picardie	80	2	26	013	Airaines	2304	22	2326
22	Picardie	80	4	36	014	Aizecourt-le-Bas	58	0	58
22	Picardie	80	4	33	015	Aizecourt-le-Haut	81	1	82
22	Picardie	80	4	06	016	Albert	9774	234	10008
22	Picardie	80	4	33	017	Allaines	424	15	439
22	Picardie	80	1	11	018	Allenay	247	4	251
22	Picardie	80	1	23	019	Allery	802	23	825
22	Picardie	80	2	45	020	Allonville	760	18	778
22	Picardie	80	2	99	021	Amiens	133448	3064	136512
22	Picardie	80	1	32	022	Andainville	228	0	228
22	Picardie	80	3	27	023	Andechy	265	1	266
22	Picardie	80	2	08	024	Argoeuves	530	12	542
22	Picardie	80	1	39	025	Argoules	335	6	341
22	Picardie	80	2	25	026	Arguel	30	0	30
22	Picardie	80	3	38	027	Armancourt	19	0	19
22	Picardie	80	2	03	028	Arquèves	152	1	153
22	Picardie	80	1	40	029	Arrest	869	13	882
22	Picardie	80	1	39	030	Arry	193	9	202
22	Picardie	80	3	28	031	Arvillers	748	18	766
22	Picardie	80	3	27	032	Assainvillers	144	3	147
22	Picardie	80	4	15	033	Assevillers	287	6	293
22	Picardie	80	4	24	034	Athies	623	23	646
22	Picardie	80	3	28	035	Aubercourt	73	1	74
22	Picardie	80	2	18	036	Aubigny	496	14	510
22	Picardie	80	3	05	037	Aubvillers	131	1	132
22	Picardie	80	4	06	038	Auchonvillers	129	6	135
22	Picardie	80	1	11	039	Ault	1697	21	1718
22	Picardie	80	1	32	040	Aumâtre	202	9	211
22	Picardie	80	2	25	041	Aumont	140	2	142
22	Picardie	80	2	12	042	Autheux	112	0	112
22	Picardie	80	2	03	043	Authie	300	6	306
22	Picardie	80	2	21	044	Authieule	364	5	369
22	Picardie	80	4	06	045	Authuille	170	6	176
22	Picardie	80	2	26	046	Avelesges	48	0	48
22	Picardie	80	4	06	047	Aveluy	501	17	518
22	Picardie	80	1	32	048	Avesnes-Chaussoy	69	2	71
22	Picardie	80	3	27	049	Ayencourt	173	15	188
22	Picardie	80	2	17	050	Bacouel-sur-Selle	474	10	484
22	Picardie	80	1	23	051	Bailleul	278	2	280
22	Picardie	80	2	18	052	Baizieux	213	2	215
22	Picardie	80	3	38	053	Balâtre	84	1	85
22	Picardie	80	4	33	054	Barleux	264	13	277
22	Picardie	80	2	12	055	Barly	167	1	168
22	Picardie	80	2	41	056	Bavelincourt	125	2	127
22	Picardie	80	2	03	057	Bayencourt	83	2	85
22	Picardie	80	3	37	058	Bayonvillers	355	9	364
22	Picardie	80	4	06	059	Bazentin	76	1	77
22	Picardie	80	2	12	060	Béalcourt	103	1	104
22	Picardie	80	2	25	061	Beaucamps-le-Jeune	191	4	195
22	Picardie	80	2	25	062	Beaucamps-le-Vieux	1437	25	1462
22	Picardie	80	1	22	063	Beauchamps	1056	25	1081
22	Picardie	80	3	28	064	Beaucourt-en-Santerre	175	4	179
22	Picardie	80	4	06	065	Beaucourt-sur-l;Ancre	98	0	98
22	Picardie	80	2	41	066	Beaucourt-sur-l;Hallue	254	4	258
22	Picardie	80	3	37	067	Beaufort-en-Santerre	188	2	190
22	Picardie	80	2	12	068	Beaumetz	217	2	219
22	Picardie	80	4	06	069	Beaumont-Hamel	188	3	191
22	Picardie	80	2	21	070	Beauquesne	1344	72	1416
22	Picardie	80	2	21	071	Beauval	2145	30	2175
22	Picardie	80	4	06	073	Bécordel-Bécourt	164	2	166
22	Picardie	80	3	27	074	Becquigny	104	2	106
22	Picardie	80	1	29	076	Béhen	456	11	467
22	Picardie	80	2	41	077	Béhencourt	355	3	358
22	Picardie	80	1	01	078	Bellancourt	480	13	493
22	Picardie	80	2	17	079	Belleuse	347	1	348
22	Picardie	80	4	15	080	Belloy-en-Santerre	166	7	173
22	Picardie	80	2	25	081	Belloy-Saint-Léonard	86	1	87
22	Picardie	80	2	34	082	Belloy-sur-Somme	757	13	770
22	Picardie	80	2	35	083	Bergicourt	159	2	161
22	Picardie	80	1	32	084	Bermesnil	237	5	242
22	Picardie	80	2	12	085	Bernâtre	34	1	35
22	Picardie	80	2	12	086	Bernaville	1094	20	1114
22	Picardie	80	1	39	087	Bernay-en-Ponthieu	250	5	255
22	Picardie	80	4	36	088	Bernes	299	11	310
22	Picardie	80	2	20	089	Berneuil	264	3	267
22	Picardie	80	4	15	090	Berny-en-Santerre	152	1	153
22	Picardie	80	2	41	092	Bertangles	585	12	597
22	Picardie	80	2	20	093	Berteaucourt-les-Dames	1165	9	1174
22	Picardie	80	3	28	094	Berteaucourt-lès-Thennes	419	5	424
22	Picardie	80	2	03	095	Bertrancourt	211	5	216
22	Picardie	80	1	11	096	Béthencourt-sur-Mer	1042	5	1047
22	Picardie	80	4	30	097	Béthencourt-sur-Somme	133	0	133
22	Picardie	80	2	35	098	Bettembos	98	0	98
22	Picardie	80	2	26	099	Bettencourt-Rivière	213	7	220
22	Picardie	80	2	34	100	Bettencourt-Saint-Ouen	623	6	629
22	Picardie	80	3	38	101	Beuvraignes	826	6	832
22	Picardie	80	4	33	102	Biaches	380	13	393
22	Picardie	80	3	38	103	Biarre	64	3	67
22	Picardie	80	1	22	104	Biencourt	124	1	125
22	Picardie	80	3	38	105	Billancourt	183	4	187
22	Picardie	80	2	35	106	Blangy-sous-Poix	193	5	198
22	Picardie	80	2	13	107	Blangy-Tronville	549	7	556
22	Picardie	80	2	12	108	Boisbergues	83	1	84
22	Picardie	80	1	19	109	Le Boisle	392	4	396
22	Picardie	80	1	40	110	Boismont	462	3	465
22	Picardie	80	2	18	112	Bonnay	250	2	252
22	Picardie	80	2	20	113	Bonneville	346	5	351
22	Picardie	80	2	17	114	Bosquel	295	2	297
22	Picardie	80	4	33	115	Bouchavesnes-Bergen	334	13	347
22	Picardie	80	3	37	116	Bouchoir	285	4	289
22	Picardie	80	2	34	117	Bouchon	153	2	155
22	Picardie	80	1	19	118	Boufflers	113	0	113
22	Picardie	80	2	26	119	Bougainville	451	2	453
22	Picardie	80	1	22	120	Bouillancourt-en-Séry	559	8	567
22	Picardie	80	3	27	121	Bouillancourt-la-Bataille	135	1	136
22	Picardie	80	2	21	122	Bouquemaison	519	12	531
22	Picardie	80	2	34	123	Bourdon	383	6	389
22	Picardie	80	1	46	124	Bourseville	737	20	757
22	Picardie	80	3	27	125	Boussicourt	78	2	80
22	Picardie	80	1	22	126	Bouttencourt	1017	27	1044
22	Picardie	80	1	22	127	Bouvaincourt-sur-Bresle	848	19	867
22	Picardie	80	4	33	128	Bouvincourt-en-Vermandois	154	6	160
22	Picardie	80	4	06	129	Bouzincourt	541	11	552
22	Picardie	80	2	26	130	Bovelles	391	2	393
22	Picardie	80	2	13	131	Boves	2976	25	3001
22	Picardie	80	3	28	132	Braches	223	3	226
22	Picardie	80	1	19	133	Brailly-Cornehotte	239	5	244
22	Picardie	80	2	17	134	Brassy	66	3	69
22	Picardie	80	1	02	135	Bray-lès-Mareuil	250	10	260
22	Picardie	80	4	14	136	Bray-sur-Somme	1238	23	1261
22	Picardie	80	2	34	137	Breilly	469	4	473
22	Picardie	80	2	18	138	Bresle	119	0	119
22	Picardie	80	3	38	139	Breuil	54	2	56
22	Picardie	80	2	21	140	Brévillers	105	1	106
22	Picardie	80	4	33	141	Brie	349	4	353
22	Picardie	80	2	26	142	Briquemesnil-Floxicourt	158	4	162
22	Picardie	80	2	25	143	Brocourt	96	4	100
22	Picardie	80	4	24	144	Brouchy	567	22	589
22	Picardie	80	1	04	145	Brucamps	142	0	142
22	Picardie	80	1	40	146	Brutelles	186	8	194
22	Picardie	80	1	04	147	Buigny-l;Abbé	338	6	344
22	Picardie	80	1	22	148	Buigny-lès-Gamaches	386	6	392
22	Picardie	80	1	31	149	Buigny-Saint-Maclou	517	8	525
22	Picardie	80	4	33	150	Buire-Courcelles	245	11	256
22	Picardie	80	4	06	151	Buire-sur-l;Ancre	324	5	329
22	Picardie	80	3	27	152	Bus-la-Mésière	145	2	147
22	Picardie	80	2	03	153	Bus-lès-Artois	147	3	150
22	Picardie	80	4	33	154	Bussu	222	6	228
22	Picardie	80	1	04	155	Bussus-Bussuel	300	6	306
22	Picardie	80	2	18	156	Bussy-lès-Daours	337	3	340
22	Picardie	80	2	35	157	Bussy-lès-Poix	94	0	94
22	Picardie	80	4	30	158	Buverchy	40	0	40
22	Picardie	80	2	13	159	Cachy	251	3	254
22	Picardie	80	2	42	160	Cagny	1252	21	1273
22	Picardie	80	1	29	161	Cahon	216	9	225
22	Picardie	80	3	37	162	Caix	732	4	736
22	Picardie	80	1	02	163	Cambron	720	5	725
22	Picardie	80	2	10	164	Camon	4590	72	4662
22	Picardie	80	2	26	165	Camps-en-Amiénois	174	2	176
22	Picardie	80	2	20	166	Canaples	618	11	629
22	Picardie	80	1	31	167	Canchy	316	6	322
22	Picardie	80	2	12	168	Candas	1047	26	1073
22	Picardie	80	1	32	169	Cannessières	85	7	92
22	Picardie	80	3	27	170	Cantigny	108	6	114
22	Picardie	80	1	01	171	Caours	604	9	613
22	Picardie	80	4	14	172	Cappy	540	4	544
22	Picardie	80	2	41	173	Cardonnette	447	6	453
22	Picardie	80	3	27	174	Le Cardonnois	99	0	99
22	Picardie	80	4	16	175	Carnoy	111	2	113
22	Picardie	80	3	38	176	Carrépuis	288	5	293
22	Picardie	80	4	33	177	Cartigny	737	15	752
22	Picardie	80	2	35	179	Caulières	216	1	217
22	Picardie	80	2	34	180	Cavillon	107	2	109
22	Picardie	80	3	28	181	Cayeux-en-Santerre	120	3	123
22	Picardie	80	1	40	182	Cayeux-sur-Mer	2736	39	2775
22	Picardie	80	4	14	184	Cerisy	481	1	482
22	Picardie	80	1	22	183	Cerisy-Buleux	256	4	260
22	Picardie	80	3	38	185	Champien	295	6	301
22	Picardie	80	4	15	186	Chaulnes	1954	40	1994
22	Picardie	80	2	34	187	La Chaussée-Tirancourt	661	8	669
22	Picardie	80	3	05	188	Chaussoy-Epagny	585	6	591
22	Picardie	80	3	37	189	La Chavatte	62	2	64
22	Picardie	80	1	29	190	Chépy	1312	25	1337
22	Picardie	80	3	37	191	Chilly	202	1	203
22	Picardie	80	4	14	192	Chipilly	187	3	190
22	Picardie	80	3	05	193	Chirmont	120	2	122
22	Picardie	80	4	15	194	Chuignes	122	0	122
22	Picardie	80	4	14	195	Chuignolles	158	1	159
22	Picardie	80	1	23	196	Citerne	275	8	283
22	Picardie	80	4	30	197	Cizancourt	45	3	48
22	Picardie	80	2	26	198	Clairy-Saulchoix	388	6	394
22	Picardie	80	4	33	199	Cléry-sur-Somme	534	30	564
22	Picardie	80	1	04	200	Cocquerel	207	2	209
22	Picardie	80	2	03	201	Coigneux	48	3	51
22	Picardie	80	2	41	202	Coisy	286	3	289
22	Picardie	80	2	03	203	Colincamps	92	1	93
22	Picardie	80	4	16	204	Combles	738	13	751
22	Picardie	80	2	34	205	Condé-Folie	893	9	902
22	Picardie	80	4	06	206	Contalmaison	123	0	123
22	Picardie	80	2	41	207	Contay	368	3	371
22	Picardie	80	1	19	208	Conteville	195	3	198
22	Picardie	80	3	28	209	Contoire	408	5	413
22	Picardie	80	2	17	210	Contre	137	3	140
22	Picardie	80	2	17	211	Conty	1752	66	1818
22	Picardie	80	2	18	212	Corbie	6388	99	6487
22	Picardie	80	2	13	213	Cottenchy	441	146	587
22	Picardie	80	3	05	214	Coullemelle	322	4	326
22	Picardie	80	1	04	215	Coulonvillers	240	3	243
22	Picardie	80	4	06	216	Courcelette	147	6	153
22	Picardie	80	2	03	217	Courcelles-au-Bois	86	0	86
22	Picardie	80	2	35	218	Courcelles-sous-Moyencourt	131	5	136
22	Picardie	80	2	17	219	Courcelles-sous-Thoix	53	1	54
22	Picardie	80	3	27	220	Courtemanche	96	0	96
22	Picardie	80	1	04	221	Cramont	300	3	303
22	Picardie	80	1	19	222	Crécy-en-Ponthieu	1550	43	1593
22	Picardie	80	3	38	223	Crémery	155	3	158
22	Picardie	80	3	38	224	Cressy-Omencourt	113	3	116
22	Picardie	80	2	26	225	Creuse	190	4	194
22	Picardie	80	4	24	226	Croix-Moligneaux	314	6	320
22	Picardie	80	2	35	227	Croixrault	436	2	438
22	Picardie	80	1	39	228	Le Crotoy	2219	33	2252
22	Picardie	80	2	34	229	Crouy-Saint-Pierre	328	0	328
22	Picardie	80	3	38	230	Curchy	323	10	333
22	Picardie	80	4	16	231	Curlu	142	6	148
22	Picardie	80	3	38	232	Damery	211	4	215
22	Picardie	80	3	38	233	Dancourt-Popincourt	143	1	144
22	Picardie	80	2	18	234	Daours	773	5	778
22	Picardie	80	1	22	235	Dargnies	1300	22	1322
22	Picardie	80	3	27	236	Davenescourt	507	3	510
22	Picardie	80	3	28	237	Démuin	495	5	500
22	Picardie	80	4	06	238	Dernancourt	443	11	454
22	Picardie	80	4	24	239	Devise	53	7	60
22	Picardie	80	4	33	240	Doingt	1329	58	1387
22	Picardie	80	2	20	241	Domart-en-Ponthieu	1171	9	1180
22	Picardie	80	3	28	242	Domart-sur-la-Luce	422	3	425
22	Picardie	80	2	12	243	Domesmont	40	0	40
22	Picardie	80	1	19	244	Dominois	195	2	197
22	Picardie	80	1	19	245	Domléger-Longvillers	284	4	288
22	Picardie	80	2	13	246	Dommartin	352	3	355
22	Picardie	80	4	15	247	Dompierre-Becquincourt	630	26	656
22	Picardie	80	1	19	248	Dompierre-sur-Authie	417	6	423
22	Picardie	80	1	04	249	Domqueur	290	4	294
22	Picardie	80	1	31	250	Domvast	341	1	342
22	Picardie	80	1	23	251	Doudelainville	321	2	323
22	Picardie	80	4	24	252	Douilly	263	8	271
22	Picardie	80	2	21	253	Doullens	6717	600	7317
22	Picardie	80	2	07	256	Dreuil-lès-Amiens	1273	17	1290
22	Picardie	80	4	36	258	Driencourt	90	2	92
22	Picardie	80	2	25	259	Dromesnil	96	4	100
22	Picardie	80	1	01	260	Drucat	866	30	896
22	Picardie	80	2	13	261	Dury	1267	63	1330
22	Picardie	80	1	02	262	Eaucourt-sur-Somme	412	9	421
22	Picardie	80	3	38	263	L; Échelle-Saint-Aurin	54	0	54
22	Picardie	80	4	14	264	Éclusier-Vaux	88	48	136
22	Picardie	80	1	22	265	Embreville	578	12	590
22	Picardie	80	2	03	266	Englebelmer	262	3	265
22	Picardie	80	4	24	267	Ennemain	219	7	226
22	Picardie	80	1	02	268	Épagne-Épagnette	577	25	602
22	Picardie	80	1	32	269	Épaumesnil	122	1	123
22	Picardie	80	2	12	270	Épécamps	6	0	6
22	Picardie	80	4	36	271	Épehy	1200	15	1215
22	Picardie	80	4	30	272	Épénancourt	116	0	116
22	Picardie	80	2	35	273	Éplessier	382	9	391
22	Picardie	80	4	24	274	Eppeville	1861	57	1918
22	Picardie	80	4	16	275	Équancourt	325	4	329
22	Picardie	80	2	35	276	Équennes-Éramecourt	313	5	318
22	Picardie	80	3	27	278	Erches	169	2	171
22	Picardie	80	3	38	279	Ercheu	805	7	812
22	Picardie	80	1	29	280	Ercourt	136	0	136
22	Picardie	80	1	04	281	Ergnies	211	8	219
22	Picardie	80	1	23	282	Érondelle	507	7	514
22	Picardie	80	3	05	283	Esclainvillers	148	0	148
22	Picardie	80	4	24	284	Esmery-Hallon	788	13	801
22	Picardie	80	2	17	285	Essertaux	239	2	241
22	Picardie	80	1	40	287	Estréboeuf	260	5	265
22	Picardie	80	4	15	288	Estrées-Deniécourt	321	6	327
22	Picardie	80	1	19	290	Estrées-lès-Crécy	382	8	390
22	Picardie	80	4	33	557	Estrées-Mons	569	18	587
22	Picardie	80	2	13	291	Estrées-sur-Noye	281	7	288
22	Picardie	80	3	38	292	Étalon	137	2	139
22	Picardie	80	3	27	293	Ételfay	391	2	393
22	Picardie	80	4	33	294	Éterpigny	176	7	183
22	Picardie	80	4	14	295	Étinehem	347	6	353
22	Picardie	80	2	34	296	L; Étoile	1239	11	1250
22	Picardie	80	1	32	297	Étréjust	45	0	45
22	Picardie	80	4	16	298	Étricourt-Manancourt	528	4	532
22	Picardie	80	3	05	299	La Faloise	231	2	233
22	Picardie	80	4	30	300	Falvy	128	14	142
22	Picardie	80	2	35	301	Famechon	236	0	236
22	Picardie	80	3	27	302	Faverolles	155	3	158
22	Picardie	80	1	39	303	Favières	457	17	474
22	Picardie	80	4	15	304	Fay	118	2	120
22	Picardie	80	2	34	305	Ferrières	460	9	469
22	Picardie	80	3	27	306	Fescamps	145	1	146
22	Picardie	80	4	33	307	Feuillères	146	4	150
22	Picardie	80	1	29	308	Feuquières-en-Vimeu	2509	38	2547
22	Picardie	80	2	20	566	Fieffes-Montrelet	330	6	336
22	Picardie	80	2	12	310	Fienvillers	629	38	667
22	Picardie	80	3	27	311	Fignières	142	0	142
22	Picardie	80	4	36	312	Fins	280	7	287
22	Picardie	80	4	33	313	Flaucourt	319	9	328
22	Picardie	80	4	16	314	Flers	169	3	172
22	Picardie	80	3	05	315	Flers-sur-Noye	403	3	406
22	Picardie	80	2	41	316	Flesselles	2066	25	2091
22	Picardie	80	2	17	317	Fleury	241	8	249
22	Picardie	80	2	34	318	Flixecourt	3255	65	3320
22	Picardie	80	2	26	319	Fluy	307	5	312
22	Picardie	80	3	37	320	Folies	129	2	131
22	Picardie	80	3	05	321	Folleville	148	2	150
22	Picardie	80	3	38	322	Fonches-Fonchette	150	3	153
22	Picardie	80	1	32	324	Fontaine-le-Sec	149	4	153
22	Picardie	80	4	15	325	Fontaine-lès-Cappy	48	0	48
22	Picardie	80	3	27	326	Fontaine-sous-Montdidier	121	6	127
22	Picardie	80	1	19	327	Fontaine-sur-Maye	152	2	154
22	Picardie	80	1	23	328	Fontaine-sur-Somme	539	7	546
22	Picardie	80	2	03	329	Forceville	171	2	173
22	Picardie	80	1	32	330	Forceville-en-Vimeu	268	6	274
22	Picardie	80	1	31	331	Forest-l;Abbaye	324	2	326
22	Picardie	80	1	31	332	Forest-Montiers	430	0	430
22	Picardie	80	1	39	333	Fort-Mahon-Plage	1318	20	1338
22	Picardie	80	2	17	334	Fossemanant	108	1	109
22	Picardie	80	4	15	335	Foucaucourt-en-Santerre	285	6	291
22	Picardie	80	1	32	336	Foucaucourt-Hors-Nesle	72	6	78
22	Picardie	80	2	13	337	Fouencamps	232	3	235
22	Picardie	80	2	18	338	Fouilloy	1866	12	1878
22	Picardie	80	3	37	339	Fouquescourt	162	0	162
22	Picardie	80	2	35	340	Fourcigny	179	6	185
22	Picardie	80	2	34	341	Fourdrinoy	347	12	359
22	Picardie	80	4	15	342	Framerville-Rainecourt	454	3	457
22	Picardie	80	1	22	343	Framicourt	169	3	172
22	Picardie	80	1	04	344	Francières	190	0	190
22	Picardie	80	1	40	345	Franleu	513	4	517
22	Picardie	80	2	20	346	Franqueville	167	0	167
22	Picardie	80	3	37	347	Fransart	150	4	154
22	Picardie	80	2	20	348	Fransu	149	0	149
22	Picardie	80	3	05	349	Fransures	141	1	142
22	Picardie	80	2	18	350	Franvillers	514	8	522
22	Picardie	80	2	41	351	Fréchencourt	233	7	240
22	Picardie	80	2	17	352	Frémontiers	147	1	148
22	Picardie	80	4	15	353	Fresnes-Mazancourt	123	0	123
22	Picardie	80	1	32	354	Fresnes-Tilloloy	172	1	173
22	Picardie	80	1	32	355	Fresneville	110	1	111
22	Picardie	80	1	32	356	Fresnoy-Andainville	97	0	97
22	Picardie	80	2	26	357	Fresnoy-au-Val	248	4	252
22	Picardie	80	3	28	358	Fresnoy-en-Chaussée	108	1	109
22	Picardie	80	3	38	359	Fresnoy-lès-Roye	307	8	315
22	Picardie	80	1	46	360	Fressenneville	2257	31	2288
22	Picardie	80	1	32	361	Frettecuisse	72	4	76
22	Picardie	80	1	22	362	Frettemeule	295	3	298
22	Picardie	80	1	11	364	Friaucourt	716	17	733
22	Picardie	80	2	35	365	Fricamps	142	1	143
22	Picardie	80	4	06	366	Fricourt	502	13	515
22	Picardie	80	4	14	367	Frise	182	6	188
22	Picardie	80	1	46	368	Friville-Escarbotin	4541	99	4640
22	Picardie	80	2	12	369	Frohen-sur-Authie	224	0	224
22	Picardie	80	1	19	371	Froyelles	111	1	112
22	Picardie	80	1	23	372	Frucourt	138	0	138
22	Picardie	80	1	22	373	Gamaches	2817	118	2935
22	Picardie	80	1	31	374	Gapennes	257	3	260
22	Picardie	80	2	35	375	Gauville	385	8	393
22	Picardie	80	2	13	376	Gentelles	525	7	532
22	Picardie	80	2	21	377	Gézaincourt	404	10	414
22	Picardie	80	4	16	378	Ginchy	66	0	66
22	Picardie	80	2	13	379	Glisy	570	8	578
22	Picardie	80	1	04	380	Gorenflos	222	6	228
22	Picardie	80	2	12	381	Gorges	43	1	44
22	Picardie	80	3	38	383	Goyencourt	95	0	95
22	Picardie	80	1	01	385	Grand-Laviers	333	41	374
22	Picardie	80	4	06	384	Grandcourt	188	1	189
22	Picardie	80	3	27	386	Gratibus	169	4	173
22	Picardie	80	2	13	387	Grattepanche	293	5	298
22	Picardie	80	1	29	388	Grébault-Mesnil	228	3	231
22	Picardie	80	4	30	389	Grécourt	23	0	23
22	Picardie	80	3	05	390	Grivesnes	365	2	367
22	Picardie	80	3	27	391	Grivillers	65	0	65
22	Picardie	80	2	21	392	Grouches-Luchuel	598	8	606
22	Picardie	80	3	38	393	Gruny	325	3	328
22	Picardie	80	3	27	395	Guerbigny	263	5	268
22	Picardie	80	1	19	396	Gueschart	328	5	333
22	Picardie	80	4	16	397	Gueudecourt	103	2	105
22	Picardie	80	2	26	399	Guignemicourt	244	3	247
22	Picardie	80	3	37	400	Guillaucourt	387	4	391
22	Picardie	80	4	16	401	Guillemont	131	5	136
22	Picardie	80	2	35	402	Guizancourt	128	1	129
22	Picardie	80	4	36	404	Guyencourt-Saulcourt	133	0	133
22	Picardie	80	2	13	403	Guyencourt-sur-Noye	164	5	169
22	Picardie	80	2	13	405	Hailles	429	2	431
22	Picardie	80	1	23	406	Hallencourt	1416	16	1432
22	Picardie	80	3	05	407	Hallivillers	141	4	145
22	Picardie	80	2	20	408	Halloy-lès-Pernois	367	3	370
22	Picardie	80	3	37	409	Hallu	173	7	180
22	Picardie	80	4	24	410	Ham	4991	157	5148
22	Picardie	80	2	18	411	Le Hamel	523	6	529
22	Picardie	80	2	18	412	Hamelet	473	5	478
22	Picardie	80	4	36	413	Hancourt	103	6	109
22	Picardie	80	3	28	414	Hangard	118	2	120
22	Picardie	80	3	28	415	Hangest-en-Santerre	1025	11	1036
22	Picardie	80	2	34	416	Hangest-sur-Somme	704	6	710
22	Picardie	80	3	37	417	Harbonnières	1470	11	1481
22	Picardie	80	4	16	418	Hardecourt-aux-Bois	72	0	72
22	Picardie	80	3	27	419	Hargicourt	403	2	405
22	Picardie	80	2	03	420	Harponville	168	1	169
22	Picardie	80	3	38	421	Hattencourt	248	8	256
22	Picardie	80	1	31	422	Hautvillers-Ouville	518	10	528
22	Picardie	80	2	20	423	Havernas	420	4	424
22	Picardie	80	2	13	424	Hébécourt	506	4	510
22	Picardie	80	2	03	425	Hédauville	102	2	104
22	Picardie	80	2	18	426	Heilly	381	5	386
22	Picardie	80	2	21	427	Hem-Hardinval	364	5	369
22	Picardie	80	4	16	428	Hem-Monacu	123	4	127
22	Picardie	80	2	18	429	Hénencourt	192	4	196
22	Picardie	80	4	14	430	Herbécourt	194	5	199
22	Picardie	80	2	03	431	Hérissart	546	6	552
22	Picardie	80	4	15	432	Herleville	149	0	149
22	Picardie	80	3	38	433	Herly	49	0	49
22	Picardie	80	4	36	434	Hervilly	175	6	181
22	Picardie	80	4	36	435	Hesbécourt	57	4	61
22	Picardie	80	2	35	436	Hescamps	519	8	527
22	Picardie	80	1	32	437	Heucourt-Croquoison	117	2	119
22	Picardie	80	4	36	438	Heudicourt	520	17	537
22	Picardie	80	2	12	439	Heuzecourt	154	3	157
22	Picardie	80	1	19	440	Hiermont	136	1	137
22	Picardie	80	4	30	442	Hombleux	1058	21	1079
22	Picardie	80	2	25	443	Hornoy-le-Bourg	1664	27	1691
22	Picardie	80	1	29	444	Huchenneville	663	10	673
22	Picardie	80	2	21	445	Humbercourt	255	3	258
22	Picardie	80	1	23	446	Huppy	802	21	823
22	Picardie	80	4	15	447	Hyencourt-le-Grand	86	2	88
22	Picardie	80	3	28	449	Ignaucourt	91	0	91
22	Picardie	80	1	32	450	Inval-Boiron	93	2	95
22	Picardie	80	4	06	451	Irles	116	2	118
22	Picardie	80	3	05	452	Jumel	358	8	366
22	Picardie	80	3	27	453	Laboissière-en-Santerre	145	1	146
22	Picardie	80	2	35	455	Lachapelle	68	0	68
22	Picardie	80	2	25	456	Lafresguimont-Saint-Martin	512	12	524
22	Picardie	80	2	18	458	Lahoussoye	413	7	420
22	Picardie	80	2	26	459	Laleu	98	2	100
22	Picardie	80	2	35	460	Lamaronde	73	0	73
22	Picardie	80	2	18	461	Lamotte-Brebière	216	5	221
22	Picardie	80	1	31	462	Lamotte-Buleux	350	10	360
22	Picardie	80	2	18	463	Lamotte-Warfusée	626	1	627
22	Picardie	80	1	40	464	Lanchères	1041	7	1048
22	Picardie	80	2	20	466	Lanches-Saint-Hilaire	126	2	128
22	Picardie	80	4	30	465	Languevoisin-Quiquery	207	2	209
22	Picardie	80	3	38	467	Laucourt	176	4	180
22	Picardie	80	4	06	468	Laviéville	155	2	157
22	Picardie	80	3	05	469	Lawarde-Mauger-l;Hortoy	182	1	183
22	Picardie	80	2	03	470	Léalvillers	181	6	187
22	Picardie	80	4	16	472	Lesboeufs	157	6	163
22	Picardie	80	3	38	473	Liancourt-Fosse	271	6	277
22	Picardie	80	4	30	474	Licourt	395	0	395
22	Picardie	80	4	36	475	Liéramont	212	3	215
22	Picardie	80	1	23	476	Liercourt	349	3	352
22	Picardie	80	1	19	477	Ligescourt	230	9	239
22	Picardie	80	3	27	478	Lignières	143	0	143
22	Picardie	80	2	35	479	Lignières-Châtelain	339	3	342
22	Picardie	80	1	32	480	Lignières-en-Vimeu	113	0	113
22	Picardie	80	4	15	481	Lihons	384	10	394
22	Picardie	80	1	23	482	Limeux	140	2	142
22	Picardie	80	2	25	484	Liomer	415	8	423
22	Picardie	80	2	17	485	Loeuilly	853	7	860
22	Picardie	80	1	04	486	Long	658	5	663
22	Picardie	80	4	36	487	Longavesnes	85	1	86
22	Picardie	80	1	23	488	Longpré-les-Corps-Saints	1664	31	1695
22	Picardie	80	2	10	489	Longueau	5686	57	5743
22	Picardie	80	4	16	490	Longueval	282	9	291
22	Picardie	80	2	21	491	Longuevillette	77	3	80
22	Picardie	80	2	03	493	Louvencourt	268	0	268
22	Picardie	80	3	05	494	Louvrechy	199	0	199
22	Picardie	80	2	21	495	Lucheux	593	46	639
22	Picardie	80	1	39	496	Machiel	160	2	162
22	Picardie	80	1	39	497	Machy	129	5	134
22	Picardie	80	2	03	498	Mailly-Maillet	616	11	627
22	Picardie	80	3	05	499	Mailly-Raineval	243	2	245
22	Picardie	80	1	22	500	Maisnières	515	7	522
22	Picardie	80	1	19	501	Maison-Ponthieu	280	9	289
22	Picardie	80	1	04	502	Maison-Roland	117	1	118
22	Picardie	80	2	12	503	Maizicourt	191	0	191
22	Picardie	80	3	27	504	Malpart	66	0	66
22	Picardie	80	4	06	505	Mametz	165	9	174
22	Picardie	80	2	18	507	Marcelcave	1089	14	1103
22	Picardie	80	3	38	508	Marché-Allouarde	71	0	71
22	Picardie	80	4	30	509	Marchélepot	468	5	473
22	Picardie	80	3	27	511	Marestmontiers	104	0	104
22	Picardie	80	1	02	512	Mareuil-Caubert	895	118	1013
22	Picardie	80	4	16	513	Maricourt	166	7	173
22	Picardie	80	2	03	514	Marieux	111	1	112
22	Picardie	80	2	35	515	Marlers	146	3	149
22	Picardie	80	4	36	516	Marquaix	219	2	221
22	Picardie	80	3	27	517	Marquivillers	155	2	157
22	Picardie	80	1	22	518	Martainneville	396	7	403
22	Picardie	80	4	24	519	Matigny	520	9	529
22	Picardie	80	3	37	520	Maucourt	158	2	160
22	Picardie	80	4	16	521	Maurepas	203	2	205
22	Picardie	80	1	32	522	Le Mazis	105	3	108
22	Picardie	80	4	06	523	Méaulte	1318	30	1348
22	Picardie	80	3	37	524	Méharicourt	578	10	588
22	Picardie	80	2	35	525	Meigneux	162	1	163
22	Picardie	80	2	12	526	Le Meillard	168	5	173
22	Picardie	80	1	11	527	Méneslies	301	4	305
22	Picardie	80	2	35	528	Méréaucourt	7	2	9
22	Picardie	80	1	23	529	Mérélessart	201	5	206
22	Picardie	80	2	25	531	Méricourt-en-Vimeu	117	0	117
22	Picardie	80	4	14	530	Méricourt-l;Abbé	571	4	575
22	Picardie	80	4	14	532	Méricourt-sur-Somme	191	4	195
22	Picardie	80	1	11	533	Mers-les-Bains	2960	51	3011
22	Picardie	80	2	34	535	Le Mesge	187	1	188
22	Picardie	80	4	33	536	Mesnil-Bruntel	302	13	315
22	Picardie	80	1	04	537	Mesnil-Domqueur	95	0	95
22	Picardie	80	4	16	538	Mesnil-en-Arrouaise	141	3	144
22	Picardie	80	4	06	540	Mesnil-Martinsart	241	7	248
22	Picardie	80	3	27	541	Mesnil-Saint-Georges	178	5	183
22	Picardie	80	4	30	542	Mesnil-Saint-Nicaise	571	4	575
22	Picardie	80	2	26	543	Métigny	109	1	110
22	Picardie	80	2	12	544	Mézerolles	199	1	200
22	Picardie	80	3	28	545	Mézières-en-Santerre	554	11	565
22	Picardie	80	1	29	546	Miannay	553	45	598
22	Picardie	80	4	06	547	Millencourt	236	5	241
22	Picardie	80	1	31	548	Millencourt-en-Ponthieu	375	7	382
22	Picardie	80	4	06	549	Miraumont	707	16	723
22	Picardie	80	2	41	550	Mirvaux	143	2	145
22	Picardie	80	4	30	551	Misery	130	0	130
22	Picardie	80	4	33	552	Moislains	1257	56	1313
22	Picardie	80	2	41	553	Molliens-au-Bois	334	9	343
22	Picardie	80	2	26	554	Molliens-Dreuil	844	9	853
22	Picardie	80	4	24	555	Monchy-Lagache	681	33	714
22	Picardie	80	1	40	556	Mons-Boubert	531	14	545
22	Picardie	80	2	17	558	Monsures	239	8	247
22	Picardie	80	2	26	559	Montagne-Fayel	169	9	178
22	Picardie	80	4	16	560	Montauban-de-Picardie	219	2	221
22	Picardie	80	3	27	561	Montdidier	6119	124	6243
22	Picardie	80	2	12	563	Montigny-les-Jongleurs	84	3	87
22	Picardie	80	2	41	562	Montigny-sur-l;Hallue	215	3	218
22	Picardie	80	2	41	565	Montonvillers	95	2	97
22	Picardie	80	4	30	568	Morchain	314	4	318
22	Picardie	80	4	14	569	Morcourt	274	3	277
22	Picardie	80	3	28	570	Moreuil	4025	39	4064
22	Picardie	80	3	28	571	Morisel	524	9	533
22	Picardie	80	4	14	572	Morlancourt	365	12	377
22	Picardie	80	2	35	573	Morvillers-Saint-Saturnin	394	11	405
22	Picardie	80	1	04	574	Mouflers	87	0	87
22	Picardie	80	1	32	575	Mouflières	94	0	94
22	Picardie	80	3	38	576	Moyencourt	304	0	304
22	Picardie	80	2	35	577	Moyencourt-lès-Poix	164	3	167
22	Picardie	80	1	29	578	Moyenneville	679	9	688
22	Picardie	80	4	24	579	Muille-Villette	829	18	847
22	Picardie	80	1	39	580	Nampont	251	4	255
22	Picardie	80	2	17	582	Namps-Maisnil	1010	12	1022
22	Picardie	80	2	17	583	Nampty	244	4	248
22	Picardie	80	2	20	584	Naours	1147	16	1163
22	Picardie	80	4	30	585	Nesle	2501	67	2568
22	Picardie	80	1	32	586	Nesle-l;Hôpital	171	0	171
22	Picardie	80	1	32	587	Neslette	90	0	90
22	Picardie	80	1	01	588	Neufmoulin	348	9	357
22	Picardie	80	1	31	590	Neuilly-l;Hôpital	323	3	326
22	Picardie	80	1	19	589	Neuilly-le-Dien	101	5	106
22	Picardie	80	1	32	591	Neuville-au-Bois	172	0	172
22	Picardie	80	1	32	592	Neuville-Coppegueule	583	7	590
22	Picardie	80	4	14	593	La Neuville-lès-Bray	270	10	280
22	Picardie	80	2	17	594	Neuville-lès-Loeuilly	126	6	132
22	Picardie	80	3	28	595	La Neuville-Sire-Bernard	271	0	271
22	Picardie	80	2	21	596	Neuvillette	204	3	207
22	Picardie	80	1	46	597	Nibas	840	17	857
22	Picardie	80	1	31	598	Nouvion	1241	38	1279
22	Picardie	80	1	19	599	Noyelles-en-Chaussée	259	2	261
22	Picardie	80	1	31	600	Noyelles-sur-Mer	773	13	786
22	Picardie	80	4	33	601	Nurlu	385	14	399
22	Picardie	80	2	12	602	Occoches	129	1	130
22	Picardie	80	1	46	603	Ochancourt	278	7	285
22	Picardie	80	2	35	604	Offignies	66	2	68
22	Picardie	80	4	24	605	Offoy	217	5	222
22	Picardie	80	1	32	606	Oisemont	1189	71	1260
22	Picardie	80	2	26	607	Oissy	240	5	245
22	Picardie	80	4	15	608	Omiécourt	241	8	249
22	Picardie	80	1	04	609	Oneux	382	10	392
22	Picardie	80	2	17	611	Oresmaux	838	10	848
22	Picardie	80	1	11	613	Oust-Marest	646	13	659
22	Picardie	80	2	12	614	Outrebois	303	4	307
22	Picardie	80	4	06	615	Ovillers-la-Boisselle	417	5	422
22	Picardie	80	4	30	616	Pargny	166	2	168
22	Picardie	80	3	37	617	Parvillers-le-Quesnoy	214	5	219
22	Picardie	80	1	40	618	Pendé	1152	14	1166
22	Picardie	80	2	20	619	Pernois	716	14	730
22	Picardie	80	4	33	620	Péronne	7887	451	8338
22	Picardie	80	4	30	621	Pertain	382	10	392
22	Picardie	80	2	34	622	Picquigny	1357	9	1366
22	Picardie	80	3	27	623	Piennes-Onvillers	352	11	363
22	Picardie	80	2	41	624	Pierregot	250	3	253
22	Picardie	80	3	28	625	Pierrepont-sur-Avre	571	9	580
22	Picardie	80	2	26	626	Pissy	288	9	297
22	Picardie	80	2	17	627	Plachy-Buyon	892	12	904
22	Picardie	80	3	28	628	Le Plessier-Rozainvillers	659	6	665
22	Picardie	80	4	36	629	Poeuilly	100	6	106
22	Picardie	80	2	35	630	Poix-de-Picardie	2407	21	2428
22	Picardie	80	1	19	631	Ponches-Estruval	111	1	112
22	Picardie	80	2	44	632	Pont-de-Metz	2195	29	2224
22	Picardie	80	2	41	634	Pont-Noyelles	742	3	745
22	Picardie	80	1	04	635	Pont-Remy	1421	24	1445
22	Picardie	80	1	31	633	Ponthoile	614	15	629
22	Picardie	80	1	31	637	Port-le-Grand	288	9	297
22	Picardie	80	4	30	638	Potte	119	6	125
22	Picardie	80	2	45	639	Poulainville	1271	31	1302
22	Picardie	80	4	06	640	Pozières	250	4	254
22	Picardie	80	2	12	642	Prouville	305	9	314
22	Picardie	80	2	17	643	Prouzel	483	16	499
22	Picardie	80	4	15	644	Proyart	637	11	648
22	Picardie	80	2	03	645	Puchevillers	522	6	528
22	Picardie	80	3	37	646	Punchy	78	0	78
22	Picardie	80	4	15	647	Puzeaux	253	2	255
22	Picardie	80	4	06	648	Pys	110	3	113
22	Picardie	80	1	39	649	Quend	1381	31	1412
22	Picardie	80	2	41	650	Querrieu	673	4	677
22	Picardie	80	2	25	651	Le Quesne	286	6	292
22	Picardie	80	3	28	652	Le Quesnel	737	8	745
22	Picardie	80	1	29	654	Quesnoy-le-Montant	584	10	594
22	Picardie	80	2	26	655	Quesnoy-sur-Airaines	437	5	442
22	Picardie	80	2	26	656	Quevauvillers	1099	21	1120
22	Picardie	80	3	05	657	Quiry-le-Sec	308	7	315
22	Picardie	80	4	24	658	Quivières	170	2	172
22	Picardie	80	2	03	659	Raincheval	293	4	297
22	Picardie	80	2	41	661	Rainneville	804	10	814
22	Picardie	80	1	22	662	Ramburelles	256	2	258
22	Picardie	80	1	22	663	Rambures	393	6	399
22	Picardie	80	4	16	664	Rancourt	185	7	192
22	Picardie	80	1	39	665	Regnière-Écluse	141	2	143
22	Picardie	80	2	12	666	Remaisnil	39	0	39
22	Picardie	80	3	27	667	Remaugies	119	1	120
22	Picardie	80	2	13	668	Remiencourt	186	5	191
22	Picardie	80	3	38	669	Rethonvillers	343	9	352
22	Picardie	80	2	26	670	Revelles	544	7	551
22	Picardie	80	2	20	671	Ribeaucourt	235	3	238
22	Picardie	80	2	18	672	Ribemont-sur-Ancre	611	10	621
22	Picardie	80	2	26	673	Riencourt	183	0	183
22	Picardie	80	2	09	674	Rivery	3435	54	3489
22	Picardie	80	3	05	675	Rogy	138	3	141
22	Picardie	80	3	38	676	Roiglise	174	7	181
22	Picardie	80	4	36	677	Roisel	1773	61	1834
22	Picardie	80	3	27	678	Rollot	768	7	775
22	Picardie	80	4	36	679	Ronssoy	561	5	566
22	Picardie	80	3	37	680	Rosières-en-Santerre	2924	41	2965
22	Picardie	80	3	05	681	Rouvrel	272	3	275
22	Picardie	80	3	37	682	Rouvroy-en-Santerre	198	4	202
22	Picardie	80	4	30	683	Rouy-le-Grand	109	0	109
22	Picardie	80	4	30	684	Rouy-le-Petit	126	4	130
22	Picardie	80	3	38	685	Roye	6326	122	6448
22	Picardie	80	2	41	686	Rubempré	762	7	769
22	Picardie	80	3	27	687	Rubescourt	141	3	144
22	Picardie	80	1	39	688	Rue	3145	100	3245
22	Picardie	80	2	13	690	Rumigny	581	4	585
22	Picardie	80	1	40	691	Saigneville	393	5	398
22	Picardie	80	1	31	692	Sailly-Flibeaucourt	1014	4	1018
22	Picardie	80	4	14	693	Sailly-Laurette	310	7	317
22	Picardie	80	4	14	694	Sailly-le-Sec	356	5	361
22	Picardie	80	4	16	695	Sailly-Saillisel	495	10	505
22	Picardie	80	2	13	696	Sains-en-Amiénois	1170	30	1200
22	Picardie	80	2	12	697	Saint-Acheul	28	1	29
22	Picardie	80	2	26	698	Saint-Aubin-Montenoy	226	2	228
22	Picardie	80	1	32	699	Saint-Aubin-Rivière	113	1	114
22	Picardie	80	1	40	700	Saint-Blimont	943	17	960
22	Picardie	80	4	30	701	Saint-Christ-Briost	463	8	471
22	Picardie	80	2	13	702	Saint-Fuscien	938	23	961
22	Picardie	80	2	25	703	Saint-Germain-sur-Bresle	196	8	204
22	Picardie	80	2	41	704	Saint-Gratien	369	7	376
22	Picardie	80	2	03	705	Saint-Léger-lès-Authie	90	3	93
22	Picardie	80	2	20	706	Saint-Léger-lès-Domart	1870	19	1889
22	Picardie	80	1	32	707	Saint-Léger-sur-Bresle	84	1	85
22	Picardie	80	3	38	708	Saint-Mard	194	6	200
22	Picardie	80	1	32	709	Saint-Maulvis	258	7	265
22	Picardie	80	1	29	710	Saint-Maxent	414	4	418
22	Picardie	80	2	20	711	Saint-Ouen	2028	14	2042
22	Picardie	80	1	39	713	Saint-Quentin-en-Tourmont	306	7	313
22	Picardie	80	1	11	714	Saint-Quentin-la-Motte-Croix-au-Bailly	1322	22	1344
22	Picardie	80	1	04	716	Saint-Riquier	1261	22	1283
22	Picardie	80	2	13	717	Saint-Sauflieu	912	16	928
22	Picardie	80	2	08	718	Saint-Sauveur	1400	16	1416
22	Picardie	80	2	41	722	Saint-Vaast-en-Chaussée	518	3	521
22	Picardie	80	1	40	721	Saint-Valery-sur-Somme	2818	38	2856
22	Picardie	80	2	35	719	Sainte-Segrée	59	0	59
22	Picardie	80	2	26	723	Saisseval	227	1	228
22	Picardie	80	2	13	724	Saleux	2410	26	2436
22	Picardie	80	2	13	725	Salouël	4186	94	4280
22	Picardie	80	4	24	726	Sancourt	268	11	279
22	Picardie	80	2	35	728	Saulchoy-sous-Poix	53	0	53
22	Picardie	80	3	05	729	Sauvillers-Mongival	186	0	186
22	Picardie	80	2	07	730	Saveuse	751	15	766
22	Picardie	80	1	32	732	Senarpont	676	18	694
22	Picardie	80	2	03	733	Senlis-le-Sec	283	2	285
22	Picardie	80	2	17	734	Sentelie	208	5	213
22	Picardie	80	2	26	735	Seux	162	1	163
22	Picardie	80	4	36	737	Sorel	173	0	173
22	Picardie	80	1	23	736	Sorel-en-Vimeu	236	3	239
22	Picardie	80	2	34	738	Soues	143	1	144
22	Picardie	80	3	05	740	Sourdon	283	6	289
22	Picardie	80	4	15	741	Soyécourt	185	8	193
22	Picardie	80	2	20	742	Surcamps	72	0	72
22	Picardie	80	4	14	743	Suzanne	188	4	192
22	Picardie	80	2	26	744	Tailly	62	1	63
22	Picardie	80	2	41	746	Talmas	1093	13	1106
22	Picardie	80	4	36	747	Templeux-la-Fosse	143	2	145
22	Picardie	80	4	36	748	Templeux-le-Guérard	210	3	213
22	Picardie	80	2	21	749	Terramesnil	284	4	288
22	Picardie	80	4	24	750	Tertry	182	4	186
22	Picardie	80	3	28	751	Thennes	470	4	474
22	Picardie	80	2	13	752	Thézy-Glimont	467	4	471
22	Picardie	80	4	06	753	Thiepval	124	1	125
22	Picardie	80	2	25	754	Thieulloy-l;Abbaye	315	7	322
22	Picardie	80	2	35	755	Thieulloy-la-Ville	119	3	122
22	Picardie	80	2	03	756	Thièvres	61	0	61
22	Picardie	80	2	17	757	Thoix	131	1	132
22	Picardie	80	3	05	758	Thory	172	1	173
22	Picardie	80	3	38	759	Tilloloy	369	10	379
22	Picardie	80	1	22	760	Tilloy-Floriville	387	8	395
22	Picardie	80	2	17	761	Tilloy-lès-Conty	256	3	259
22	Picardie	80	4	36	762	Tincourt-Boucly	384	11	395
22	Picardie	80	1	31	763	Le Titre	384	7	391
22	Picardie	80	1	29	764	Toeufles	275	12	287
22	Picardie	80	1	29	765	Tours-en-Vimeu	881	13	894
22	Picardie	80	2	03	766	Toutencourt	517	13	530
22	Picardie	80	1	22	767	Le Translay	223	7	230
22	Picardie	80	4	14	769	Treux	243	3	246
22	Picardie	80	1	46	770	Tully	623	7	630
22	Picardie	80	4	24	771	Ugny-l;Équipée	41	0	41
22	Picardie	80	2	41	773	Vadencourt	99	1	100
22	Picardie	80	2	18	774	Vaire-sous-Corbie	269	3	272
22	Picardie	80	1	46	775	Valines	639	11	650
22	Picardie	80	2	03	776	Varennes	204	2	206
22	Picardie	80	2	03	777	Vauchelles-lès-Authie	131	4	135
22	Picardie	80	2	20	778	Vauchelles-lès-Domart	125	5	130
22	Picardie	80	1	01	779	Vauchelles-les-Quesnoy	871	25	896
22	Picardie	80	1	46	780	Vaudricourt	402	11	413
22	Picardie	80	4	15	781	Vauvillers	275	2	277
22	Picardie	80	2	41	782	Vaux-en-Amiénois	424	6	430
22	Picardie	80	1	23	783	Vaux-Marquenneville	77	2	79
22	Picardie	80	2	18	784	Vaux-sur-Somme	308	8	316
22	Picardie	80	2	18	785	Vecquemont	545	7	552
22	Picardie	80	2	17	786	Velennes	151	4	155
22	Picardie	80	1	39	787	Vercourt	114	5	119
22	Picardie	80	1	32	788	Vergies	193	2	195
22	Picardie	80	4	15	789	Vermandovillers	135	2	137
22	Picardie	80	3	38	790	Verpillières	166	9	175
22	Picardie	80	2	13	791	Vers-sur-Selles	725	13	738
22	Picardie	80	2	20	792	La Vicogne	253	0	253
22	Picardie	80	2	34	793	Vignacourt	2372	24	2396
22	Picardie	80	2	34	795	Ville-le-Marclet	510	39	549
22	Picardie	80	4	14	807	Ville-sur-Ancre	279	11	290
22	Picardie	80	4	24	794	Villecourt	62	0	62
22	Picardie	80	1	32	796	Villeroy	210	3	213
22	Picardie	80	3	28	797	Villers-aux-Érables	137	1	138
22	Picardie	80	2	41	798	Villers-Bocage	1437	85	1522
22	Picardie	80	2	18	799	Villers-Bretonneux	4187	46	4233
22	Picardie	80	2	25	800	Villers-Campsart	137	1	138
22	Picardie	80	4	33	801	Villers-Carbonnel	321	5	326
22	Picardie	80	4	36	802	Villers-Faucon	658	14	672
22	Picardie	80	3	38	803	Villers-lès-Roye	224	1	225
22	Picardie	80	1	04	804	Villers-sous-Ailly	189	3	192
22	Picardie	80	1	39	806	Villers-sur-Authie	412	13	425
22	Picardie	80	3	27	805	Villers-Tournelle	161	7	168
22	Picardie	80	1	39	808	Vironchaux	419	8	427
22	Picardie	80	1	22	809	Vismes	427	7	434
22	Picardie	80	1	19	810	Vitz-sur-Authie	114	1	115
22	Picardie	80	4	30	811	Voyennes	604	21	625
22	Picardie	80	4	36	812	Vraignes-en-Vermandois	165	5	170
22	Picardie	80	2	25	813	Vraignes-lès-Hornoy	87	2	89
22	Picardie	80	3	37	814	Vrély	455	5	460
22	Picardie	80	1	39	815	Vron	860	16	876
22	Picardie	80	2	20	819	Wargnies	93	1	94
22	Picardie	80	2	18	820	Warloy-Baillon	807	3	810
22	Picardie	80	2	26	821	Warlus	233	4	237
22	Picardie	80	3	27	822	Warsy	119	1	120
22	Picardie	80	3	37	823	Warvillers	135	2	137
22	Picardie	80	3	28	824	Wiencourt-l;Équipée	256	6	262
22	Picardie	80	1	23	825	Wiry-au-Mont	121	6	127
22	Picardie	80	1	11	826	Woignarue	822	14	836
22	Picardie	80	1	46	827	Woincourt	1450	25	1475
22	Picardie	80	1	32	828	Woirel	41	0	41
22	Picardie	80	4	24	829	Y	85	3	88
22	Picardie	80	1	04	830	Yaucourt-Bussus	207	6	213
22	Picardie	80	1	02	836	Yonval	239	9	248
22	Picardie	80	1	19	832	Yvrench	301	7	308
22	Picardie	80	1	19	833	Yvrencheux	159	5	164
22	Picardie	80	1	11	834	Yzengremer	556	39	595
22	Picardie	80	2	34	835	Yzeux	265	7	272
73	Midi-Pyrénées	81	2	10	001	Aguts	239	3	242
73	Midi-Pyrénées	81	2	42	002	Aiguefonde	2731	78	2809
73	Midi-Pyrénées	81	1	01	003	Alban	992	58	1050
73	Midi-Pyrénées	81	1	96	004	Albi	48916	2265	51181
73	Midi-Pyrénées	81	2	28	005	Albine	554	6	560
73	Midi-Pyrénées	81	2	10	006	Algans	212	7	219
73	Midi-Pyrénées	81	1	23	008	Almayrac	293	9	302
73	Midi-Pyrénées	81	1	07	007	Alos	110	1	111
73	Midi-Pyrénées	81	1	09	009	Amarens	70	0	70
73	Midi-Pyrénées	81	1	36	010	Ambialet	447	13	460
73	Midi-Pyrénées	81	2	17	011	Ambres	945	34	979
73	Midi-Pyrénées	81	1	07	012	Andillac	116	1	117
73	Midi-Pyrénées	81	1	32	013	Andouque	384	6	390
73	Midi-Pyrénées	81	2	03	014	Anglès	531	12	543
73	Midi-Pyrénées	81	2	24	015	Appelle	66	3	69
73	Midi-Pyrénées	81	2	11	016	Arfons	182	7	189
73	Midi-Pyrénées	81	2	21	017	Arifat	156	2	158
73	Midi-Pyrénées	81	1	43	018	Arthès	2463	58	2521
73	Midi-Pyrénées	81	1	33	019	Assac	156	0	156
73	Midi-Pyrénées	81	1	05	020	Aussac	276	6	282
73	Midi-Pyrénées	81	2	42	021	Aussillon	6459	138	6597
73	Midi-Pyrénées	81	2	17	022	Bannières	177	5	182
73	Midi-Pyrénées	81	2	22	023	Barre	211	4	215
73	Midi-Pyrénées	81	1	30	024	Beauvais-sur-Tescou	305	15	320
73	Midi-Pyrénées	81	2	17	025	Belcastel	196	6	202
73	Midi-Pyrénées	81	1	36	026	Bellegarde	420	9	429
73	Midi-Pyrénées	81	2	11	027	Belleserre	167	9	176
73	Midi-Pyrénées	81	2	15	028	Berlats	105	3	108
73	Midi-Pyrénées	81	1	12	029	Bernac	174	4	178
73	Midi-Pyrénées	81	2	24	030	Bertre	108	2	110
73	Midi-Pyrénées	81	2	04	031	Le Bez	812	20	832
73	Midi-Pyrénées	81	2	24	032	Blan	1070	20	1090
73	Midi-Pyrénées	81	1	39	033	Blaye-les-Mines	3074	134	3208
73	Midi-Pyrénées	81	2	19	034	Boissezon	389	6	395
73	Midi-Pyrénées	81	1	09	035	Bournazel	177	6	183
73	Midi-Pyrénées	81	2	28	036	Bout-du-Pont-de-Larn	1078	36	1114
73	Midi-Pyrénées	81	2	04	037	Brassac	1396	35	1431
73	Midi-Pyrénées	81	1	12	038	Brens	2178	59	2237
73	Midi-Pyrénées	81	2	13	039	Briatexte	1936	33	1969
73	Midi-Pyrénées	81	2	16	040	Brousse	369	16	385
73	Midi-Pyrénées	81	1	12	041	Broze	104	3	107
73	Midi-Pyrénées	81	2	27	042	Burlats	1902	59	1961
73	Midi-Pyrénées	81	2	13	043	Busque	728	22	750
73	Midi-Pyrénées	81	2	29	044	Cabanès	223	3	226
73	Midi-Pyrénées	81	1	09	045	Les Cabannes	352	4	356
73	Midi-Pyrénées	81	1	05	046	Cadalen	1473	26	1499
73	Midi-Pyrénées	81	1	33	047	Cadix	233	8	241
73	Midi-Pyrénées	81	1	37	048	Cagnac-les-Mines	2284	42	2326
73	Midi-Pyrénées	81	2	11	049	Cahuzac	359	4	363
73	Midi-Pyrénées	81	1	07	051	Cahuzac-sur-Vère	1054	30	1084
73	Midi-Pyrénées	81	1	36	052	Cambon	1917	53	1970
73	Midi-Pyrénées	81	2	10	050	Cambon-lès-Lavaur	262	3	265
73	Midi-Pyrénées	81	2	04	053	Cambounès	338	11	349
73	Midi-Pyrénées	81	2	24	054	Cambounet-sur-le-Sor	830	24	854
73	Midi-Pyrénées	81	2	11	055	Les Cammazes	298	10	308
73	Midi-Pyrénées	81	1	07	056	Campagnac	115	4	119
73	Midi-Pyrénées	81	2	35	058	Carbes	177	8	185
73	Midi-Pyrénées	81	1	38	059	Carlus	665	13	678
73	Midi-Pyrénées	81	1	97	060	Carmaux	10116	245	10361
73	Midi-Pyrénées	81	1	12	061	Castanet	186	2	188
73	Midi-Pyrénées	81	2	04	062	Castelnau-de-Brassac	763	27	790
73	Midi-Pyrénées	81	1	37	063	Castelnau-de-Lévis	1522	40	1562
73	Midi-Pyrénées	81	1	07	064	Castelnau-de-Montmiral	957	25	982
73	Midi-Pyrénées	81	2	98	065	Castres	42314	1681	43995
73	Midi-Pyrénées	81	2	42	066	Caucalières	318	12	330
73	Midi-Pyrénées	81	1	12	067	Cestayrols	478	12	490
73	Midi-Pyrénées	81	1	20	068	Combefa	153	3	156
73	Midi-Pyrénées	81	1	09	069	Cordes-sur-Ciel	1011	57	1068
73	Midi-Pyrénées	81	1	25	070	Coufouleux	2260	68	2328
73	Midi-Pyrénées	81	1	33	071	Courris	82	1	83
73	Midi-Pyrénées	81	1	32	072	Crespin	122	6	128
73	Midi-Pyrénées	81	1	32	073	Crespinet	156	5	161
73	Midi-Pyrénées	81	1	36	074	Cunac	1493	93	1586
73	Midi-Pyrénées	81	2	35	075	Cuq	479	10	489
73	Midi-Pyrénées	81	2	10	076	Cuq-Toulza	677	9	686
73	Midi-Pyrénées	81	1	01	077	Curvalle	446	14	460
73	Midi-Pyrénées	81	2	29	078	Damiatte	971	31	1002
73	Midi-Pyrénées	81	1	26	079	Dénat	706	18	724
73	Midi-Pyrénées	81	1	09	080	Donnazac	84	2	86
73	Midi-Pyrénées	81	2	11	081	Dourgne	1287	53	1340
73	Midi-Pyrénées	81	1	33	082	Le Dourn	128	6	134
73	Midi-Pyrénées	81	2	11	083	Durfort	275	7	282
73	Midi-Pyrénées	81	2	14	084	Escoussens	643	12	655
73	Midi-Pyrénées	81	2	15	085	Escroux	49	2	51
73	Midi-Pyrénées	81	2	15	086	Espérausses	157	7	164
73	Midi-Pyrénées	81	1	26	088	Fauch	490	9	499
73	Midi-Pyrénées	81	1	33	089	Faussergues	136	2	138
73	Midi-Pyrénées	81	1	12	087	Fayssac	368	11	379
73	Midi-Pyrénées	81	1	05	090	Fénols	227	3	230
73	Midi-Pyrénées	81	2	31	091	Ferrières	144	4	148
73	Midi-Pyrénées	81	2	29	092	Fiac	865	28	893
73	Midi-Pyrénées	81	1	05	093	Florentin	706	38	744
73	Midi-Pyrénées	81	1	33	094	Fraissines	93	2	95
73	Midi-Pyrénées	81	1	09	095	Frausseilles	97	1	98
73	Midi-Pyrénées	81	1	36	096	Le Fraysse	387	12	399
73	Midi-Pyrénées	81	1	44	097	Fréjairolles	1319	32	1351
73	Midi-Pyrénées	81	2	35	098	Fréjeville	661	12	673
73	Midi-Pyrénées	81	1	12	099	Gaillac	13293	265	13558
73	Midi-Pyrénées	81	2	11	100	Garrevaques	374	6	380
73	Midi-Pyrénées	81	1	43	101	Le Garric	1163	19	1182
73	Midi-Pyrénées	81	2	17	102	Garrigues	287	10	297
73	Midi-Pyrénées	81	2	15	103	Gijounet	134	6	140
73	Midi-Pyrénées	81	2	17	104	Giroussens	1365	28	1393
73	Midi-Pyrénées	81	2	13	105	Graulhet	11955	245	12200
73	Midi-Pyrénées	81	1	25	106	Grazac	504	11	515
73	Midi-Pyrénées	81	2	35	132	Guitalens-L;Albarède	816	13	829
73	Midi-Pyrénées	81	1	34	108	Itzac	144	2	146
73	Midi-Pyrénées	81	2	16	109	Jonquières	471	11	482
73	Midi-Pyrénées	81	1	23	110	Jouqueviel	101	4	105
73	Midi-Pyrénées	81	1	09	111	Labarthe-Bleys	83	4	87
73	Midi-Pyrénées	81	1	12	112	Labastide-de-Lévis	983	25	1008
73	Midi-Pyrénées	81	1	26	113	Labastide-Dénat	375	7	382
73	Midi-Pyrénées	81	1	39	114	Labastide-Gabausse	449	14	463
73	Midi-Pyrénées	81	2	28	115	Labastide-Rouairoux	1539	27	1566
73	Midi-Pyrénées	81	2	17	116	Labastide-Saint-Georges	1752	68	1820
73	Midi-Pyrénées	81	1	05	117	Labessière-Candeil	732	21	753
73	Midi-Pyrénées	81	2	40	118	Laboulbène	138	4	142
73	Midi-Pyrénées	81	1	26	119	Laboutarie	449	5	454
73	Midi-Pyrénées	81	2	14	120	Labruguière	6231	196	6427
73	Midi-Pyrénées	81	2	28	121	Lacabarède	290	5	295
73	Midi-Pyrénées	81	1	33	122	Lacapelle-Pinet	69	0	69
73	Midi-Pyrénées	81	1	09	123	Lacapelle-Ségalar	96	2	98
73	Midi-Pyrénées	81	2	15	124	Lacaune	2603	83	2686
73	Midi-Pyrénées	81	2	31	125	Lacaze	308	5	313
73	Midi-Pyrénées	81	2	17	126	Lacougotte-Cadoul	163	2	165
73	Midi-Pyrénées	81	2	10	127	Lacroisille	127	4	131
73	Midi-Pyrénées	81	2	27	128	Lacrouzette	1731	42	1773
73	Midi-Pyrénées	81	2	11	129	Lagardiolle	225	12	237
73	Midi-Pyrénées	81	2	14	130	Lagarrigue	1774	51	1825
73	Midi-Pyrénées	81	1	12	131	Lagrave	1828	26	1854
73	Midi-Pyrénées	81	1	26	133	Lamillarié	435	7	442
73	Midi-Pyrénées	81	2	03	134	Lamontélarié	64	2	66
73	Midi-Pyrénées	81	1	20	135	Laparrouquial	103	3	106
73	Midi-Pyrénées	81	1	07	136	Larroque	171	7	178
73	Midi-Pyrénées	81	2	03	137	Lasfaillades	75	2	77
73	Midi-Pyrénées	81	1	05	138	Lasgraisses	374	4	378
73	Midi-Pyrénées	81	2	16	139	Lautrec	1756	38	1794
73	Midi-Pyrénées	81	2	17	140	Lavaur	10148	501	10649
73	Midi-Pyrénées	81	1	33	141	Lédas-et-Penthiès	161	2	163
73	Midi-Pyrénées	81	2	24	142	Lempaut	729	11	740
73	Midi-Pyrénées	81	2	24	143	Lescout	587	7	594
73	Midi-Pyrénées	81	1	43	144	Lescure-d;Albigeois	4186	102	4288
73	Midi-Pyrénées	81	1	18	145	Lisle-sur-Tarn	4277	56	4333
73	Midi-Pyrénées	81	1	09	146	Livers-Cazelles	235	3	238
73	Midi-Pyrénées	81	1	26	147	Lombers	1046	24	1070
73	Midi-Pyrénées	81	1	09	148	Loubers	93	5	98
73	Midi-Pyrénées	81	1	25	149	Loupiac	396	11	407
73	Midi-Pyrénées	81	2	17	150	Lugan	423	17	440
73	Midi-Pyrénées	81	2	29	151	Magrin	133	5	138
73	Midi-Pyrénées	81	1	37	152	Mailhoc	255	7	262
73	Midi-Pyrénées	81	2	04	153	Le Margnès	44	0	44
73	Midi-Pyrénées	81	1	34	154	Marnaves	78	0	78
73	Midi-Pyrénées	81	1	36	155	Marsal	279	8	287
73	Midi-Pyrénées	81	1	45	156	Marssac-sur-Tarn	2930	56	2986
73	Midi-Pyrénées	81	2	17	157	Marzens	303	20	323
73	Midi-Pyrénées	81	2	31	158	Le Masnau-Massuguiès	299	6	305
73	Midi-Pyrénées	81	2	29	159	Massac-Séran	321	12	333
73	Midi-Pyrénées	81	2	11	160	Massaguel	422	2	424
73	Midi-Pyrénées	81	1	01	161	Massals	113	8	121
73	Midi-Pyrénées	81	2	10	162	Maurens-Scopont	174	3	177
73	Midi-Pyrénées	81	2	99	163	Mazamet	9995	442	10437
73	Midi-Pyrénées	81	1	25	164	Mézens	398	13	411
73	Midi-Pyrénées	81	1	34	165	Milhars	253	6	259
73	Midi-Pyrénées	81	1	37	166	Milhavet	86	2	88
73	Midi-Pyrénées	81	1	01	167	Miolles	103	4	107
73	Midi-Pyrénées	81	1	23	168	Mirandol-Bourgnounac	1084	22	1106
73	Midi-Pyrénées	81	2	13	169	Missècle	93	1	94
73	Midi-Pyrénées	81	1	20	170	Monestiés	1381	11	1392
73	Midi-Pyrénées	81	2	21	183	Mont-Roc	177	2	179
73	Midi-Pyrénées	81	1	12	171	Montans	1353	29	1382
73	Midi-Pyrénées	81	1	23	172	Montauriol	57	0	57
73	Midi-Pyrénées	81	2	17	173	Montcabrier	231	0	231
73	Midi-Pyrénées	81	2	16	174	Montdragon	608	10	618
73	Midi-Pyrénées	81	1	30	175	Montdurausse	323	6	329
73	Midi-Pyrénées	81	1	07	176	Montels	103	3	106
73	Midi-Pyrénées	81	2	27	177	Montfa	398	7	405
73	Midi-Pyrénées	81	1	30	178	Montgaillard	356	15	371
73	Midi-Pyrénées	81	2	10	179	Montgey	287	10	297
73	Midi-Pyrénées	81	1	20	180	Montirat	262	8	270
73	Midi-Pyrénées	81	2	16	181	Montpinier	175	5	180
73	Midi-Pyrénées	81	2	21	182	Montredon-Labessonnié	2078	35	2113
73	Midi-Pyrénées	81	1	34	184	Montrosier	30	0	30
73	Midi-Pyrénées	81	1	30	185	Montvalen	204	7	211
73	Midi-Pyrénées	81	1	23	186	Moularès	271	13	284
73	Midi-Pyrénées	81	2	13	187	Moulayrès	175	9	184
73	Midi-Pyrénées	81	2	22	188	Moulin-Mage	319	13	332
73	Midi-Pyrénées	81	2	10	189	Mouzens	126	1	127
73	Midi-Pyrénées	81	1	09	191	Mouzieys-Panens	223	9	232
73	Midi-Pyrénées	81	1	36	190	Mouzieys-Teulet	417	6	423
73	Midi-Pyrénées	81	2	22	192	Murat-sur-Vèbre	839	22	861
73	Midi-Pyrénées	81	2	22	193	Nages	338	8	346
73	Midi-Pyrénées	81	2	46	195	Navès	699	41	740
73	Midi-Pyrénées	81	2	14	196	Noailhac	827	17	844
73	Midi-Pyrénées	81	1	09	197	Noailles	206	4	210
73	Midi-Pyrénées	81	1	26	198	Orban	310	4	314
73	Midi-Pyrénées	81	1	33	199	Padiès	195	7	202
73	Midi-Pyrénées	81	2	11	200	Palleville	424	59	483
73	Midi-Pyrénées	81	1	23	201	Pampelonne	761	10	771
73	Midi-Pyrénées	81	1	18	202	Parisot	883	20	903
73	Midi-Pyrénées	81	1	01	203	Paulinet	530	11	541
73	Midi-Pyrénées	81	2	19	204	Payrin-Augmontel	2188	66	2254
73	Midi-Pyrénées	81	2	10	205	Péchaudier	180	4	184
73	Midi-Pyrénées	81	1	34	206	Penne	563	16	579
73	Midi-Pyrénées	81	2	16	207	Peyregoux	94	32	126
73	Midi-Pyrénées	81	1	18	208	Peyrole	491	13	504
73	Midi-Pyrénées	81	2	19	209	Pont-de-Larn	2874	91	2965
73	Midi-Pyrénées	81	2	24	210	Poudis	222	1	223
73	Midi-Pyrénées	81	1	26	211	Poulan-Pouzols	430	7	437
73	Midi-Pyrénées	81	2	29	212	Prades	149	4	153
73	Midi-Pyrénées	81	2	29	213	Pratviel	82	0	82
73	Midi-Pyrénées	81	2	10	214	Puéchoursi	87	5	92
73	Midi-Pyrénées	81	2	13	215	Puybegon	597	7	604
73	Midi-Pyrénées	81	2	16	216	Puycalvel	208	4	212
73	Midi-Pyrénées	81	1	07	217	Puycelsi	474	10	484
73	Midi-Pyrénées	81	1	38	218	Puygouzon	2916	94	3010
73	Midi-Pyrénées	81	2	24	219	Puylaurens	3191	95	3286
73	Midi-Pyrénées	81	1	25	220	Rabastens	5051	131	5182
73	Midi-Pyrénées	81	2	21	221	Rayssac	248	3	251
73	Midi-Pyrénées	81	1	26	222	Réalmont	3294	64	3358
73	Midi-Pyrénées	81	2	19	223	Le Rialet	52	1	53
73	Midi-Pyrénées	81	1	34	224	Le Riols	119	4	123
73	Midi-Pyrénées	81	1	12	225	Rivières	890	14	904
73	Midi-Pyrénées	81	1	26	226	Ronel	278	4	282
73	Midi-Pyrénées	81	2	27	227	Roquecourbe	2281	41	2322
73	Midi-Pyrénées	81	1	25	228	Roquemaure	386	8	394
73	Midi-Pyrénées	81	2	10	229	Roquevidal	122	1	123
73	Midi-Pyrénées	81	1	06	230	Rosières	764	16	780
73	Midi-Pyrénées	81	2	28	231	Rouairoux	369	6	375
73	Midi-Pyrénées	81	1	38	232	Rouffiac	569	16	585
73	Midi-Pyrénées	81	1	26	233	Roumégoux	240	5	245
73	Midi-Pyrénées	81	1	34	234	Roussayrolles	71	2	73
73	Midi-Pyrénées	81	2	14	235	Saint-Affrique-les-Montagnes	744	31	775
73	Midi-Pyrénées	81	2	17	236	Saint-Agnan	226	11	237
73	Midi-Pyrénées	81	2	11	237	Saint-Amancet	174	5	179
73	Midi-Pyrénées	81	2	28	238	Saint-Amans-Soult	1677	79	1756
73	Midi-Pyrénées	81	2	28	239	Saint-Amans-Valtoret	940	31	971
73	Midi-Pyrénées	81	1	01	240	Saint-André	100	5	105
73	Midi-Pyrénées	81	1	26	241	Saint-Antonin-de-Lacalm	258	4	262
73	Midi-Pyrénées	81	2	11	242	Saint-Avit	255	4	259
73	Midi-Pyrénées	81	1	07	243	Saint-Beauzile	116	3	119
73	Midi-Pyrénées	81	1	06	244	Saint-Benoît-de-Carmaux	2152	17	2169
73	Midi-Pyrénées	81	1	20	245	Saint-Christophe	130	5	135
73	Midi-Pyrénées	81	1	33	247	Saint-Cirgue	219	7	226
73	Midi-Pyrénées	81	2	13	248	Saint-Gauzens	790	16	806
73	Midi-Pyrénées	81	2	16	250	Saint-Genest-de-Contest	245	4	249
73	Midi-Pyrénées	81	2	24	251	Saint-Germain-des-Prés	851	22	873
73	Midi-Pyrénées	81	2	27	252	Saint-Germier	128	8	136
73	Midi-Pyrénées	81	1	32	253	Saint-Grégoire	449	9	458
73	Midi-Pyrénées	81	1	32	254	Saint-Jean-de-Marcel	367	3	370
73	Midi-Pyrénées	81	2	17	255	Saint-Jean-de-Rives	408	10	418
73	Midi-Pyrénées	81	2	27	256	Saint-Jean-de-Vals	73	2	75
73	Midi-Pyrénées	81	1	36	257	Saint-Juéry	6797	123	6920
73	Midi-Pyrénées	81	2	16	258	Saint-Julien-du-Puy	405	7	412
73	Midi-Pyrénées	81	1	33	259	Saint-Julien-Gaulène	212	4	216
73	Midi-Pyrénées	81	1	26	260	Saint-Lieux-Lafenasse	449	7	456
73	Midi-Pyrénées	81	2	17	261	Saint-Lieux-lès-Lavaur	878	19	897
73	Midi-Pyrénées	81	1	09	262	Saint-Marcel-Campes	241	2	243
73	Midi-Pyrénées	81	1	09	263	Saint-Martin-Laguépie	451	13	464
73	Midi-Pyrénées	81	1	34	265	Saint-Michel-de-Vax	68	5	73
73	Midi-Pyrénées	81	1	33	264	Saint-Michel-Labadié	83	3	86
73	Midi-Pyrénées	81	2	29	266	Saint-Paul-Cap-de-Joux	1071	17	1088
73	Midi-Pyrénées	81	2	31	267	Saint-Pierre-de-Trivisy	626	8	634
73	Midi-Pyrénées	81	2	31	268	Saint-Salvi-de-Carcavès	92	1	93
73	Midi-Pyrénées	81	2	19	269	Saint-Salvy-de-la-Balme	556	11	567
73	Midi-Pyrénées	81	2	24	270	Saint-Sernin-lès-Lavaur	120	2	122
73	Midi-Pyrénées	81	2	17	271	Saint-Sulpice	8091	205	8296
73	Midi-Pyrénées	81	1	30	272	Saint-Urcisse	240	3	243
73	Midi-Pyrénées	81	1	07	246	Sainte-Cécile-du-Cayrou	122	2	124
73	Midi-Pyrénées	81	1	37	326	Sainte-Croix	355	14	369
73	Midi-Pyrénées	81	1	23	249	Sainte-Gemme	807	14	821
73	Midi-Pyrénées	81	2	46	273	Saïx	3307	113	3420
73	Midi-Pyrénées	81	1	38	274	Saliès	781	18	799
73	Midi-Pyrénées	81	1	20	275	Salles	195	5	200
73	Midi-Pyrénées	81	1	30	276	Salvagnac	1078	26	1104
73	Midi-Pyrénées	81	1	32	277	Saussenac	502	20	522
73	Midi-Pyrénées	81	2	28	278	Sauveterre	179	6	185
73	Midi-Pyrénées	81	1	30	279	La Sauzière-Saint-Jean	238	5	243
73	Midi-Pyrénées	81	1	20	280	Le Ségur	237	9	246
73	Midi-Pyrénées	81	2	35	281	Sémalens	1979	50	2029
73	Midi-Pyrénées	81	2	15	282	Senaux	39	2	41
73	Midi-Pyrénées	81	1	12	283	Senouillac	1059	38	1097
73	Midi-Pyrénées	81	1	38	284	Le Sequestre	1543	54	1597
73	Midi-Pyrénées	81	1	32	285	Sérénac	483	7	490
73	Midi-Pyrénées	81	2	35	286	Serviès	597	11	608
73	Midi-Pyrénées	81	1	26	287	Sieurac	210	5	215
73	Midi-Pyrénées	81	2	11	288	Sorèze	2610	58	2668
73	Midi-Pyrénées	81	2	11	289	Soual	2308	42	2350
73	Midi-Pyrénées	81	1	09	290	Souel	186	3	189
73	Midi-Pyrénées	81	1	39	291	Taïx	356	9	365
73	Midi-Pyrénées	81	1	23	292	Tanus	526	14	540
73	Midi-Pyrénées	81	1	30	293	Tauriac	255	6	261
73	Midi-Pyrénées	81	1	05	294	Técou	882	11	893
73	Midi-Pyrénées	81	1	01	295	Teillet	456	6	462
73	Midi-Pyrénées	81	1	26	296	Terre-Clapier	239	8	247
73	Midi-Pyrénées	81	1	45	297	Terssac	1023	17	1040
73	Midi-Pyrénées	81	2	17	298	Teulat	484	14	498
73	Midi-Pyrénées	81	2	29	299	Teyssode	373	20	393
73	Midi-Pyrénées	81	1	09	300	Tonnac	124	1	125
73	Midi-Pyrénées	81	1	26	301	Le Travet	127	5	132
73	Midi-Pyrénées	81	1	23	302	Tréban	43	1	44
73	Midi-Pyrénées	81	1	33	303	Trébas	412	16	428
73	Midi-Pyrénées	81	1	20	304	Trévien	193	2	195
73	Midi-Pyrénées	81	2	31	305	Vabre	806	16	822
73	Midi-Pyrénées	81	1	32	306	Valderiès	838	16	854
73	Midi-Pyrénées	81	2	14	307	Valdurenque	824	14	838
73	Midi-Pyrénées	81	1	33	308	Valence-d;Albigeois	1295	16	1311
73	Midi-Pyrénées	81	1	34	309	Vaour	328	0	328
73	Midi-Pyrénées	81	2	17	310	Veilhes	108	5	113
73	Midi-Pyrénées	81	2	16	311	Vénès	732	20	752
73	Midi-Pyrénées	81	2	11	312	Verdalle	948	219	1167
73	Midi-Pyrénées	81	1	07	313	Le Verdier	238	8	246
73	Midi-Pyrénées	81	2	15	314	Viane	620	59	679
73	Midi-Pyrénées	81	2	35	315	Vielmur-sur-Agout	1444	25	1469
73	Midi-Pyrénées	81	1	07	316	Vieux	175	3	178
73	Midi-Pyrénées	81	1	36	317	Villefranche-d;Albigeois	1138	21	1159
73	Midi-Pyrénées	81	2	17	318	Villeneuve-lès-Lavaur	136	3	139
73	Midi-Pyrénées	81	1	37	319	Villeneuve-sur-Vère	461	4	465
73	Midi-Pyrénées	81	1	09	320	Vindrac-Alayrac	153	6	159
73	Midi-Pyrénées	81	2	19	321	Le Vintrou	85	2	87
73	Midi-Pyrénées	81	1	20	322	Virac	224	4	228
73	Midi-Pyrénées	81	2	29	323	Viterbe	352	10	362
73	Midi-Pyrénées	81	2	17	324	Viviers-lès-Lavaur	201	5	206
73	Midi-Pyrénées	81	2	14	325	Viviers-lès-Montagnes	1783	59	1842
73	Midi-Pyrénées	82	1	25	001	Albefeuille-Lagarde	625	25	650
73	Midi-Pyrénées	82	2	19	002	Albias	2956	66	3022
73	Midi-Pyrénées	82	1	21	003	Angeville	213	2	215
73	Midi-Pyrénées	82	1	10	004	Asques	140	3	143
73	Midi-Pyrénées	82	2	23	005	Aucamville	1024	12	1036
73	Midi-Pyrénées	82	1	02	006	Auterive	61	2	63
73	Midi-Pyrénées	82	2	12	007	Auty	111	3	114
73	Midi-Pyrénées	82	1	01	008	Auvillar	960	60	1020
73	Midi-Pyrénées	82	1	10	009	Balignac	32	1	33
73	Midi-Pyrénées	82	1	01	010	Bardigues	257	7	264
73	Midi-Pyrénées	82	1	25	011	Barry-d;Islemade	849	18	867
73	Midi-Pyrénées	82	1	25	012	Les Barthes	488	19	507
73	Midi-Pyrénées	82	1	02	013	Beaumont-de-Lomagne	3852	252	4104
73	Midi-Pyrénées	82	2	23	014	Beaupuy	303	1	304
73	Midi-Pyrénées	82	1	02	015	Belbèse	118	0	118
73	Midi-Pyrénées	82	1	14	016	Belvèze	211	8	219
73	Midi-Pyrénées	82	2	07	017	Bessens	1350	8	1358
73	Midi-Pyrénées	82	2	19	018	Bioule	1055	23	1078
73	Midi-Pyrénées	82	1	11	019	Boudou	692	27	719
73	Midi-Pyrénées	82	2	23	020	Bouillac	574	14	588
73	Midi-Pyrénées	82	1	09	021	Bouloc	231	4	235
73	Midi-Pyrénées	82	1	03	022	Bourg-de-Visa	398	11	409
73	Midi-Pyrénées	82	2	23	023	Bourret	791	15	806
73	Midi-Pyrénées	82	1	03	024	Brassac	260	5	265
73	Midi-Pyrénées	82	2	17	025	Bressols	3580	82	3662
73	Midi-Pyrénées	82	2	13	026	Bruniquel	607	21	628
73	Midi-Pyrénées	82	2	07	027	Campsas	1219	35	1254
73	Midi-Pyrénées	82	2	07	028	Canals	653	5	658
73	Midi-Pyrénées	82	2	20	029	Castanet	241	2	243
73	Midi-Pyrénées	82	1	21	030	Castelferrus	419	12	431
73	Midi-Pyrénées	82	1	21	031	Castelmayran	1119	18	1137
73	Midi-Pyrénées	82	1	22	032	Castelsagrat	548	12	560
73	Midi-Pyrénées	82	1	97	033	Castelsarrasin	12770	479	13249
73	Midi-Pyrénées	82	1	10	034	Castéra-Bouzet	114	2	116
73	Midi-Pyrénées	82	1	21	035	Caumont	321	3	324
73	Midi-Pyrénées	82	1	02	036	Le Causé	148	4	152
73	Midi-Pyrénées	82	2	05	037	Caussade	6623	210	6833
73	Midi-Pyrénées	82	2	06	038	Caylus	1536	31	1567
73	Midi-Pyrénées	82	2	05	039	Cayrac	499	5	504
73	Midi-Pyrénées	82	2	05	040	Cayriech	259	13	272
73	Midi-Pyrénées	82	2	20	041	Cazals	243	7	250
73	Midi-Pyrénées	82	1	09	042	Cazes-Mondenard	1213	24	1237
73	Midi-Pyrénées	82	2	23	043	Comberouger	293	2	295
73	Midi-Pyrénées	82	2	24	044	Corbarieu	1663	30	1693
73	Midi-Pyrénées	82	1	21	045	Cordes-Tolosannes	272	7	279
73	Midi-Pyrénées	82	1	21	046	Coutures	104	0	104
73	Midi-Pyrénées	82	1	02	047	Cumont	58	3	61
73	Midi-Pyrénées	82	2	07	048	Dieupentale	1426	17	1443
73	Midi-Pyrénées	82	1	01	049	Donzac	1027	31	1058
73	Midi-Pyrénées	82	1	01	050	Dunes	1176	7	1183
73	Midi-Pyrénées	82	1	09	051	Durfort-Lacapelette	798	98	896
73	Midi-Pyrénées	82	2	17	052	Escatalens	1066	67	1133
73	Midi-Pyrénées	82	1	02	053	Escazeaux	300	11	311
73	Midi-Pyrénées	82	1	22	054	Espalais	412	12	424
73	Midi-Pyrénées	82	1	02	055	Esparsac	246	8	254
73	Midi-Pyrénées	82	2	06	056	Espinas	176	4	180
73	Midi-Pyrénées	82	2	07	057	Fabas	554	13	567
73	Midi-Pyrénées	82	1	21	058	Fajolles	104	1	105
73	Midi-Pyrénées	82	1	02	059	Faudoas	291	8	299
73	Midi-Pyrénées	82	1	03	060	Fauroux	221	5	226
73	Midi-Pyrénées	82	2	20	061	Féneyrols	170	8	178
73	Midi-Pyrénées	82	2	17	062	Finhan	1395	20	1415
73	Midi-Pyrénées	82	1	21	063	Garganvillar	628	8	636
73	Midi-Pyrénées	82	1	02	064	Gariès	106	5	111
73	Midi-Pyrénées	82	1	22	065	Gasques	433	16	449
73	Midi-Pyrénées	82	2	13	066	Génébrières	591	13	604
73	Midi-Pyrénées	82	1	10	067	Gensac	109	3	112
73	Midi-Pyrénées	82	1	02	068	Gimat	185	7	192
73	Midi-Pyrénées	82	2	20	069	Ginals	202	4	206
73	Midi-Pyrénées	82	1	02	070	Glatens	69	0	69
73	Midi-Pyrénées	82	1	02	071	Goas	43	0	43
73	Midi-Pyrénées	82	1	22	072	Golfech	912	10	922
73	Midi-Pyrénées	82	1	22	073	Goudourville	901	18	919
73	Midi-Pyrénées	82	1	10	074	Gramont	153	7	160
73	Midi-Pyrénées	82	2	07	075	Grisolles	3641	54	3695
73	Midi-Pyrénées	82	2	08	076	L; Honor-de-Cos	1571	34	1605
73	Midi-Pyrénées	82	2	12	077	Labarthe	365	3	368
73	Midi-Pyrénées	82	2	18	078	Labastide-de-Penne	128	4	132
73	Midi-Pyrénées	82	1	25	080	Labastide-du-Temple	1077	27	1104
73	Midi-Pyrénées	82	2	07	079	Labastide-Saint-Pierre	3680	86	3766
73	Midi-Pyrénées	82	1	21	081	Labourgade	166	7	173
73	Midi-Pyrénées	82	2	06	082	Lacapelle-Livron	184	6	190
73	Midi-Pyrénées	82	1	10	083	Lachapelle	125	2	127
73	Midi-Pyrénées	82	1	03	084	Lacour	181	0	181
73	Midi-Pyrénées	82	2	17	085	Lacourt-Saint-Pierre	1118	23	1141
73	Midi-Pyrénées	82	1	21	086	Lafitte	232	6	238
73	Midi-Pyrénées	82	2	08	087	Lafrançaise	2854	101	2955
73	Midi-Pyrénées	82	2	20	088	Laguépie	701	12	713
73	Midi-Pyrénées	82	1	22	089	Lamagistère	1162	23	1185
73	Midi-Pyrénées	82	2	15	090	Lamothe-Capdeville	1006	63	1069
73	Midi-Pyrénées	82	1	02	091	Lamothe-Cumont	123	2	125
73	Midi-Pyrénées	82	2	18	092	Lapenche	170	3	173
73	Midi-Pyrénées	82	1	02	093	Larrazet	640	20	660
73	Midi-Pyrénées	82	1	09	094	Lauzerte	1506	31	1537
73	Midi-Pyrénées	82	2	05	095	Lavaurette	207	8	215
73	Midi-Pyrénées	82	1	10	097	Lavit	1508	30	1538
73	Midi-Pyrénées	82	2	27	098	Léojac	1089	30	1119
73	Midi-Pyrénées	82	1	26	099	Lizac	482	2	484
73	Midi-Pyrénées	82	2	06	100	Loze	130	4	134
73	Midi-Pyrénées	82	1	11	101	Malause	1075	32	1107
73	Midi-Pyrénées	82	1	10	102	Mansonville	273	3	276
73	Midi-Pyrénées	82	1	02	103	Marignac	106	4	110
73	Midi-Pyrénées	82	1	10	104	Marsac	177	3	180
73	Midi-Pyrénées	82	2	23	105	Mas-Grenier	1164	20	1184
73	Midi-Pyrénées	82	1	02	106	Maubec	143	2	145
73	Midi-Pyrénées	82	1	10	107	Maumusson	55	2	57
73	Midi-Pyrénées	82	1	25	108	Meauzac	1155	26	1181
73	Midi-Pyrénées	82	1	01	109	Merles	238	8	246
73	Midi-Pyrénées	82	2	05	110	Mirabel	992	18	1010
73	Midi-Pyrénées	82	1	03	111	Miramont-de-Quercy	353	7	360
73	Midi-Pyrénées	82	1	98	112	Moissac	12192	428	12620
73	Midi-Pyrénées	82	2	12	113	Molières	1174	28	1202
73	Midi-Pyrénées	82	2	07	114	Monbéqui	587	13	600
73	Midi-Pyrénées	82	2	13	115	Monclar-de-Quercy	1763	16	1779
73	Midi-Pyrénées	82	1	09	116	Montagudet	189	4	193
73	Midi-Pyrénées	82	1	14	117	Montaigu-de-Quercy	1410	42	1452
73	Midi-Pyrénées	82	1	21	118	Montaïn	116	1	117
73	Midi-Pyrénées	82	2	18	119	Montalzat	639	11	650
73	Midi-Pyrénées	82	2	08	120	Montastruc	275	11	286
73	Midi-Pyrénées	82	2	99	121	Montauban	56271	1743	58014
73	Midi-Pyrénées	82	1	09	122	Montbarla	162	1	163
73	Midi-Pyrénées	82	2	17	123	Montbartier	1248	38	1286
73	Midi-Pyrénées	82	2	17	124	Montbeton	3442	90	3532
73	Midi-Pyrénées	82	2	17	125	Montech	5631	115	5746
73	Midi-Pyrénées	82	2	05	126	Monteils	1303	27	1330
73	Midi-Pyrénées	82	1	26	127	Montesquieu	785	20	805
73	Midi-Pyrénées	82	2	18	128	Montfermier	108	4	112
73	Midi-Pyrénées	82	1	10	129	Montgaillard	99	2	101
73	Midi-Pyrénées	82	1	22	130	Montjoi	181	1	182
73	Midi-Pyrénées	82	2	18	131	Montpezat-de-Quercy	1480	24	1504
73	Midi-Pyrénées	82	2	19	132	Montricoux	1091	20	1111
73	Midi-Pyrénées	82	2	06	133	Mouillac	92	3	95
73	Midi-Pyrénées	82	2	19	134	Nègrepelisse	5168	78	5246
73	Midi-Pyrénées	82	2	07	135	Nohic	1192	24	1216
73	Midi-Pyrénées	82	2	07	136	Orgueil	1462	23	1485
73	Midi-Pyrénées	82	2	20	137	Parisot	552	15	567
73	Midi-Pyrénées	82	1	22	138	Perville	122	3	125
73	Midi-Pyrénées	82	1	01	139	Le Pin	120	2	122
73	Midi-Pyrénées	82	2	08	140	Piquecos	399	11	410
73	Midi-Pyrénées	82	1	22	141	Pommevic	575	8	583
73	Midi-Pyrénées	82	2	07	142	Pompignan	1383	6	1389
73	Midi-Pyrénées	82	1	10	143	Poupas	97	0	97
73	Midi-Pyrénées	82	2	12	144	Puycornet	669	8	677
73	Midi-Pyrénées	82	1	10	146	Puygaillard-de-Lomagne	61	1	62
73	Midi-Pyrénées	82	2	13	145	Puygaillard-de-Quercy	360	5	365
73	Midi-Pyrénées	82	2	06	147	Puylagarde	348	8	356
73	Midi-Pyrénées	82	2	18	148	Puylaroque	671	13	684
73	Midi-Pyrénées	82	2	05	149	Réalville	1849	68	1917
73	Midi-Pyrénées	82	2	24	150	Reyniès	928	10	938
73	Midi-Pyrénées	82	1	14	151	Roquecor	431	14	445
73	Midi-Pyrénées	82	1	21	152	Saint-Aignan	414	12	426
73	Midi-Pyrénées	82	1	09	154	Saint-Amans-de-Pellagal	235	5	240
73	Midi-Pyrénées	82	1	14	153	Saint-Amans-du-Pech	193	4	197
73	Midi-Pyrénées	82	2	20	155	Saint-Antonin-Noble-Val	1864	44	1908
73	Midi-Pyrénées	82	1	21	156	Saint-Arroumex	145	1	146
73	Midi-Pyrénées	82	1	14	157	Saint-Beauzeil	124	1	125
73	Midi-Pyrénées	82	1	01	158	Saint-Cirice	168	3	171
73	Midi-Pyrénées	82	2	05	159	Saint-Cirq	488	18	506
73	Midi-Pyrénées	82	1	22	160	Saint-Clair	276	7	283
73	Midi-Pyrénées	82	2	19	161	Saint-Étienne-de-Tulmont	3529	76	3605
73	Midi-Pyrénées	82	2	05	162	Saint-Georges	221	4	225
73	Midi-Pyrénées	82	1	10	163	Saint-Jean-du-Bouzet	65	4	69
73	Midi-Pyrénées	82	1	01	165	Saint-Loup	492	18	510
73	Midi-Pyrénées	82	1	01	166	Saint-Michel	246	9	255
73	Midi-Pyrénées	82	2	24	167	Saint-Nauphary	1712	36	1748
73	Midi-Pyrénées	82	1	03	168	Saint-Nazaire-de-Valentane	325	7	332
73	Midi-Pyrénées	82	1	21	169	Saint-Nicolas-de-la-Grave	2140	59	2199
73	Midi-Pyrénées	82	1	11	170	Saint-Paul-d;Espis	607	16	623
73	Midi-Pyrénées	82	2	17	171	Saint-Porquier	1375	21	1396
73	Midi-Pyrénées	82	2	06	172	Saint-Projet	299	7	306
73	Midi-Pyrénées	82	2	23	173	Saint-Sardos	887	14	901
73	Midi-Pyrénées	82	2	05	174	Saint-Vincent	299	4	303
73	Midi-Pyrénées	82	1	11	175	Saint-Vincent-Lespinasse	231	6	237
73	Midi-Pyrénées	82	1	09	164	Sainte-Juliette	122	5	127
73	Midi-Pyrénées	82	2	13	176	La Salvetat-Belmontet	663	7	670
73	Midi-Pyrénées	82	1	09	177	Sauveterre	167	2	169
73	Midi-Pyrénées	82	2	23	178	Savenès	741	8	749
73	Midi-Pyrénées	82	2	05	179	Septfonds	2140	30	2170
73	Midi-Pyrénées	82	1	02	180	Sérignac	487	12	499
73	Midi-Pyrénées	82	1	01	181	Sistels	205	2	207
73	Midi-Pyrénées	82	1	03	182	Touffailles	396	6	402
73	Midi-Pyrénées	82	1	09	183	Tréjouls	260	13	273
73	Midi-Pyrénées	82	2	19	184	Vaïssac	789	17	806
73	Midi-Pyrénées	82	1	14	185	Valeilles	233	4	237
73	Midi-Pyrénées	82	1	22	186	Valence	5137	177	5314
73	Midi-Pyrénées	82	2	20	187	Varen	674	16	690
73	Midi-Pyrénées	82	2	24	188	Varennes	633	11	644
73	Midi-Pyrénées	82	2	12	189	Vazerac	759	5	764
73	Midi-Pyrénées	82	2	23	190	Verdun-sur-Garonne	4112	69	4181
73	Midi-Pyrénées	82	2	20	191	Verfeil	314	7	321
73	Midi-Pyrénées	82	2	24	192	Verlhac-Tescou	473	10	483
73	Midi-Pyrénées	82	1	02	193	Vigueron	124	4	128
73	Midi-Pyrénées	82	2	17	096	La Ville-Dieu-du-Temple	2845	60	2905
73	Midi-Pyrénées	82	2	24	194	Villebrumier	1240	24	1264
73	Midi-Pyrénées	82	2	15	195	Villemade	700	25	725
93	Provence-Alpes-Côte d;Azur	83	1	13	001	Les Adrets-de-l;Estérel	2629	71	2700
93	Provence-Alpes-Côte d;Azur	83	3	01	002	Aiguines	261	2	263
93	Provence-Alpes-Côte d;Azur	83	1	11	003	Ampus	925	21	946
93	Provence-Alpes-Côte d;Azur	83	1	16	004	Les Arcs	6515	178	6693
93	Provence-Alpes-Côte d;Azur	83	3	26	005	Artignosc-sur-Verdon	297	13	310
93	Provence-Alpes-Côte d;Azur	83	3	19	006	Artigues	199	2	201
93	Provence-Alpes-Côte d;Azur	83	3	01	007	Aups	2095	66	2161
93	Provence-Alpes-Côte d;Azur	83	1	13	008	Bagnols-en-Forêt	2440	31	2471
93	Provence-Alpes-Côte d;Azur	83	2	18	009	Bandol	8028	127	8155
93	Provence-Alpes-Côte d;Azur	83	1	08	010	Bargème	155	5	160
93	Provence-Alpes-Côte d;Azur	83	1	06	011	Bargemon	1496	21	1517
93	Provence-Alpes-Côte d;Azur	83	3	02	012	Barjols	3059	51	3110
93	Provence-Alpes-Côte d;Azur	83	1	08	013	La Bastide	205	3	208
93	Provence-Alpes-Côte d;Azur	83	3	01	014	Baudinard-sur-Verdon	189	6	195
93	Provence-Alpes-Côte d;Azur	83	3	01	015	Bauduen	320	10	330
93	Provence-Alpes-Côte d;Azur	83	2	03	016	Le Beausset	9115	155	9270
93	Provence-Alpes-Côte d;Azur	83	2	25	017	Belgentier	2424	28	2452
93	Provence-Alpes-Côte d;Azur	83	3	04	018	Besse-sur-Issole	2918	35	2953
93	Provence-Alpes-Côte d;Azur	83	2	07	019	Bormes-les-Mimosas	7406	111	7517
93	Provence-Alpes-Côte d;Azur	83	1	08	020	Le Bourguet	26	0	26
93	Provence-Alpes-Côte d;Azur	83	3	02	021	Bras	2449	36	2485
93	Provence-Alpes-Côte d;Azur	83	1	08	022	Brenon	24	2	26
93	Provence-Alpes-Côte d;Azur	83	3	05	023	Brignoles	16368	389	16757
93	Provence-Alpes-Côte d;Azur	83	3	02	025	Brue-Auriac	1210	30	1240
93	Provence-Alpes-Côte d;Azur	83	3	04	026	Cabasse	1988	37	2025
93	Provence-Alpes-Côte d;Azur	83	2	03	027	La Cadière-d;Azur	5385	93	5478
93	Provence-Alpes-Côte d;Azur	83	1	06	028	Callas	1816	44	1860
93	Provence-Alpes-Côte d;Azur	83	1	12	029	Callian	3208	67	3275
93	Provence-Alpes-Côte d;Azur	83	3	05	030	Camps-la-Source	1713	33	1746
93	Provence-Alpes-Côte d;Azur	83	1	17	031	Le Cannet-des-Maures	4070	58	4128
93	Provence-Alpes-Côte d;Azur	83	3	09	032	Carcès	3332	58	3390
93	Provence-Alpes-Côte d;Azur	83	2	10	033	Carnoules	3241	47	3288
93	Provence-Alpes-Côte d;Azur	83	2	36	034	Carqueiranne	9886	174	10060
93	Provence-Alpes-Côte d;Azur	83	2	03	035	Le Castellet	4099	84	4183
93	Provence-Alpes-Côte d;Azur	83	1	22	036	Cavalaire-sur-Mer	6884	121	7005
93	Provence-Alpes-Côte d;Azur	83	3	05	037	La Celle	1305	71	1376
93	Provence-Alpes-Côte d;Azur	83	1	06	038	Châteaudouble	465	10	475
93	Provence-Alpes-Côte d;Azur	83	3	02	039	Châteauvert	135	29	164
93	Provence-Alpes-Côte d;Azur	83	1	08	040	Châteauvieux	76	0	76
93	Provence-Alpes-Côte d;Azur	83	1	06	041	Claviers	583	15	598
93	Provence-Alpes-Côte d;Azur	83	1	14	042	Cogolin	11108	184	11292
93	Provence-Alpes-Côte d;Azur	83	2	07	043	Collobrières	1866	82	1948
93	Provence-Alpes-Côte d;Azur	83	1	08	044	Comps-sur-Artuby	325	8	333
93	Provence-Alpes-Côte d;Azur	83	3	09	045	Correns	842	13	855
93	Provence-Alpes-Côte d;Azur	83	3	09	046	Cotignac	2201	65	2266
93	Provence-Alpes-Côte d;Azur	83	2	36	047	La Crau	16786	439	17225
93	Provence-Alpes-Côte d;Azur	83	1	22	048	La Croix-Valmer	3429	142	3571
93	Provence-Alpes-Côte d;Azur	83	2	10	049	Cuers	10246	143	10389
93	Provence-Alpes-Côte d;Azur	83	1	11	050	Draguignan	36391	904	37295
93	Provence-Alpes-Côte d;Azur	83	3	09	051	Entrecasteaux	1065	11	1076
93	Provence-Alpes-Côte d;Azur	83	3	02	052	Esparron	324	5	329
93	Provence-Alpes-Côte d;Azur	83	2	18	053	Évenos	2137	46	2183
93	Provence-Alpes-Côte d;Azur	83	2	25	054	La Farlède	8304	122	8426
93	Provence-Alpes-Côte d;Azur	83	1	12	055	Fayence	5109	87	5196
93	Provence-Alpes-Côte d;Azur	83	1	06	056	Figanières	2547	48	2595
93	Provence-Alpes-Côte d;Azur	83	3	04	057	Flassans-sur-Issole	3093	50	3143
93	Provence-Alpes-Côte d;Azur	83	1	11	058	Flayosc	4419	108	4527
93	Provence-Alpes-Côte d;Azur	83	3	20	059	Forcalqueiret	2421	34	2455
93	Provence-Alpes-Côte d;Azur	83	3	26	060	Fox-Amphoux	455	4	459
93	Provence-Alpes-Côte d;Azur	83	1	13	061	Fréjus	51839	741	52580
93	Provence-Alpes-Côte d;Azur	83	2	42	062	La Garde	25930	391	26321
93	Provence-Alpes-Côte d;Azur	83	1	14	063	La Garde-Freinet	1746	37	1783
93	Provence-Alpes-Côte d;Azur	83	3	20	064	Garéoult	5613	109	5722
93	Provence-Alpes-Côte d;Azur	83	1	22	065	Gassin	2853	72	2925
93	Provence-Alpes-Côte d;Azur	83	3	19	066	Ginasservis	1496	30	1526
93	Provence-Alpes-Côte d;Azur	83	3	04	067	Gonfaron	4192	53	4245
93	Provence-Alpes-Côte d;Azur	83	1	14	068	Grimaud	4171	108	4279
93	Provence-Alpes-Côte d;Azur	83	2	97	069	Hyères	54600	1306	55906
93	Provence-Alpes-Côte d;Azur	83	2	07	070	Le Lavandou	5546	79	5625
93	Provence-Alpes-Côte d;Azur	83	2	36	071	La Londe-les-Maures	9870	147	10017
93	Provence-Alpes-Côte d;Azur	83	1	16	072	Lorgues	8976	302	9278
93	Provence-Alpes-Côte d;Azur	83	1	17	073	Le Luc	9498	112	9610
93	Provence-Alpes-Côte d;Azur	83	1	08	074	La Martre	183	4	187
93	Provence-Alpes-Côte d;Azur	83	1	17	075	Les Mayons	639	12	651
93	Provence-Alpes-Côte d;Azur	83	3	20	076	Mazaugues	822	10	832
93	Provence-Alpes-Côte d;Azur	83	3	20	077	Méounes-lès-Montrieux	2001	34	2035
93	Provence-Alpes-Côte d;Azur	83	3	26	078	Moissac-Bellevue	284	6	290
93	Provence-Alpes-Côte d;Azur	83	1	22	079	La Môle	1067	18	1085
93	Provence-Alpes-Côte d;Azur	83	1	12	080	Mons	863	20	883
93	Provence-Alpes-Côte d;Azur	83	1	12	081	Montauroux	5801	98	5899
93	Provence-Alpes-Côte d;Azur	83	1	06	082	Montferrat	1344	20	1364
93	Provence-Alpes-Côte d;Azur	83	3	09	083	Montfort-sur-Argens	1209	9	1218
93	Provence-Alpes-Côte d;Azur	83	3	26	084	Montmeyan	560	6	566
93	Provence-Alpes-Côte d;Azur	83	1	11	085	La Motte	2930	66	2996
93	Provence-Alpes-Côte d;Azur	83	1	37	086	Le Muy	9050	295	9345
93	Provence-Alpes-Côte d;Azur	83	3	21	087	Nans-les-Pins	4132	71	4203
93	Provence-Alpes-Côte d;Azur	83	3	20	088	Néoules	2486	48	2534
93	Provence-Alpes-Côte d;Azur	83	3	21	089	Ollières	635	12	647
93	Provence-Alpes-Côte d;Azur	83	2	18	090	Ollioules	12774	263	13037
93	Provence-Alpes-Côte d;Azur	83	2	10	091	Pierrefeu-du-Var	5548	76	5624
93	Provence-Alpes-Côte d;Azur	83	3	04	092	Pignans	3357	47	3404
93	Provence-Alpes-Côte d;Azur	83	3	21	093	Plan-d;Aups-Sainte-Baume	1577	17	1594
93	Provence-Alpes-Côte d;Azur	83	1	14	094	Le Plan-de-la-Tour	2875	57	2932
93	Provence-Alpes-Côte d;Azur	83	3	02	095	Pontevès	712	13	725
93	Provence-Alpes-Côte d;Azur	83	3	21	096	Pourcieux	1136	20	1156
93	Provence-Alpes-Côte d;Azur	83	3	21	097	Pourrières	4475	55	4530
93	Provence-Alpes-Côte d;Azur	83	2	42	098	Le Pradet	11506	324	11830
93	Provence-Alpes-Côte d;Azur	83	1	37	099	Puget-sur-Argens	6587	125	6712
93	Provence-Alpes-Côte d;Azur	83	2	10	100	Puget-Ville	3801	71	3872
93	Provence-Alpes-Côte d;Azur	83	1	22	101	Ramatuelle	2183	43	2226
93	Provence-Alpes-Côte d;Azur	83	1	22	152	Rayol-Canadel-sur-Mer	727	12	739
93	Provence-Alpes-Côte d;Azur	83	3	26	102	Régusse	2156	31	2187
93	Provence-Alpes-Côte d;Azur	83	2	41	103	Le Revest-les-Eaux	3693	79	3772
93	Provence-Alpes-Côte d;Azur	83	3	19	104	Rians	4197	53	4250
93	Provence-Alpes-Côte d;Azur	83	2	03	105	Riboux	33	0	33
93	Provence-Alpes-Côte d;Azur	83	3	20	106	Rocbaron	3595	76	3671
93	Provence-Alpes-Côte d;Azur	83	1	08	109	La Roque-Esclapon	240	3	243
93	Provence-Alpes-Côte d;Azur	83	1	37	107	Roquebrune-sur-Argens	12822	303	13125
93	Provence-Alpes-Côte d;Azur	83	3	20	108	La Roquebrussanne	2372	31	2403
93	Provence-Alpes-Côte d;Azur	83	3	21	110	Rougiers	1531	29	1560
93	Provence-Alpes-Côte d;Azur	83	3	09	154	Saint-Antonin-du-Var	633	11	644
93	Provence-Alpes-Côte d;Azur	83	2	03	112	Saint-Cyr-sur-Mer	11819	153	11972
93	Provence-Alpes-Côte d;Azur	83	3	19	113	Saint-Julien	2063	22	2085
93	Provence-Alpes-Côte d;Azur	83	2	38	153	Saint-Mandrier-sur-Mer	5750	70	5820
93	Provence-Alpes-Côte d;Azur	83	3	02	114	Saint-Martin	212	3	215
93	Provence-Alpes-Côte d;Azur	83	3	21	116	Saint-Maximin-la-Sainte-Baume	14505	402	14907
93	Provence-Alpes-Côte d;Azur	83	1	12	117	Saint-Paul-en-Forêt	1675	42	1717
93	Provence-Alpes-Côte d;Azur	83	1	39	118	Saint-Raphaël	33603	617	34220
93	Provence-Alpes-Côte d;Azur	83	1	22	119	Saint-Tropez	4532	75	4607
93	Provence-Alpes-Côte d;Azur	83	3	21	120	Saint-Zacharie	4914	83	4997
93	Provence-Alpes-Côte d;Azur	83	3	20	111	Sainte-Anastasie-sur-Issole	1922	32	1954
93	Provence-Alpes-Côte d;Azur	83	1	14	115	Sainte-Maxime	12938	282	13220
93	Provence-Alpes-Côte d;Azur	83	1	23	121	Salernes	3670	81	3751
93	Provence-Alpes-Côte d;Azur	83	3	01	122	Les Salles-sur-Verdon	228	5	233
93	Provence-Alpes-Côte d;Azur	83	2	18	123	Sanary-sur-Mer	16429	214	16643
93	Provence-Alpes-Côte d;Azur	83	1	12	124	Seillans	2530	25	2555
93	Provence-Alpes-Côte d;Azur	83	3	02	125	Seillons-Source-d;Argens	2173	45	2218
93	Provence-Alpes-Côte d;Azur	83	2	98	126	La Seyne-sur-Mer	62082	801	62883
93	Provence-Alpes-Côte d;Azur	83	2	03	127	Signes	2801	39	2840
93	Provence-Alpes-Côte d;Azur	83	3	26	128	Sillans-la-Cascade	631	58	689
93	Provence-Alpes-Côte d;Azur	83	2	40	129	Six-Fours-les-Plages	34897	518	35415
93	Provence-Alpes-Côte d;Azur	83	2	25	130	Solliès-Pont	11090	124	11214
93	Provence-Alpes-Côte d;Azur	83	2	25	131	Solliès-Toucas	5131	99	5230
93	Provence-Alpes-Côte d;Azur	83	2	25	132	Solliès-Ville	2464	52	2516
93	Provence-Alpes-Côte d;Azur	83	1	12	133	Tanneron	1468	29	1497
93	Provence-Alpes-Côte d;Azur	83	1	16	134	Taradeau	1748	38	1786
93	Provence-Alpes-Côte d;Azur	83	3	26	135	Tavernes	1250	12	1262
93	Provence-Alpes-Côte d;Azur	83	1	16	136	Le Thoronet	2293	40	2333
93	Provence-Alpes-Côte d;Azur	83	2	99	137	Toulon	164532	2319	166851
93	Provence-Alpes-Côte d;Azur	83	1	12	138	Tourrettes	2743	46	2789
93	Provence-Alpes-Côte d;Azur	83	1	23	139	Tourtour	589	10	599
93	Provence-Alpes-Côte d;Azur	83	3	05	140	Tourves	4855	78	4933
93	Provence-Alpes-Côte d;Azur	83	1	11	141	Trans-en-Provence	5531	166	5697
93	Provence-Alpes-Côte d;Azur	83	1	08	142	Trigance	163	2	165
93	Provence-Alpes-Côte d;Azur	83	3	05	143	Le Val	4174	76	4250
93	Provence-Alpes-Côte d;Azur	83	2	41	144	La Valette-du-Var	20754	281	21035
93	Provence-Alpes-Côte d;Azur	83	3	02	145	Varages	1117	28	1145
93	Provence-Alpes-Côte d;Azur	83	3	19	146	La Verdière	1543	27	1570
93	Provence-Alpes-Côte d;Azur	83	3	01	147	Vérignon	11	0	11
93	Provence-Alpes-Côte d;Azur	83	1	17	148	Vidauban	10165	147	10312
93	Provence-Alpes-Côte d;Azur	83	1	23	149	Villecroze	1201	23	1224
93	Provence-Alpes-Côte d;Azur	83	3	19	150	Vinon-sur-Verdon	4198	77	4275
93	Provence-Alpes-Côte d;Azur	83	3	05	151	Vins-sur-Caramy	916	14	930
93	Provence-Alpes-Côte d;Azur	84	3	10	001	Althen-des-Paluds	2685	39	2724
93	Provence-Alpes-Côte d;Azur	84	1	19	002	Ansouis	1125	34	1159
93	Provence-Alpes-Côte d;Azur	84	1	01	003	Apt	11755	309	12064
93	Provence-Alpes-Côte d;Azur	84	3	09	004	Aubignan	4864	134	4998
93	Provence-Alpes-Côte d;Azur	84	3	20	005	Aurel	182	6	188
93	Provence-Alpes-Côte d;Azur	84	1	01	006	Auribeau	75	1	76
93	Provence-Alpes-Côte d;Azur	84	2	97	007	Avignon	89683	1974	91657
93	Provence-Alpes-Côte d;Azur	84	3	14	008	Le Barroux	643	34	677
93	Provence-Alpes-Côte d;Azur	84	1	19	009	La Bastide-des-Jourdans	1308	82	1390
93	Provence-Alpes-Côte d;Azur	84	1	19	010	La Bastidonne	736	27	763
93	Provence-Alpes-Côte d;Azur	84	3	18	011	Le Beaucet	363	10	373
93	Provence-Alpes-Côte d;Azur	84	3	04	012	Beaumes-de-Venise	2305	37	2342
93	Provence-Alpes-Côte d;Azur	84	1	12	013	Beaumettes	239	2	241
93	Provence-Alpes-Côte d;Azur	84	1	19	014	Beaumont-de-Pertuis	1055	13	1068
93	Provence-Alpes-Côte d;Azur	84	3	14	015	Beaumont-du-Ventoux	311	0	311
93	Provence-Alpes-Côte d;Azur	84	2	05	016	Bédarrides	5146	67	5213
93	Provence-Alpes-Côte d;Azur	84	3	15	017	Bédoin	3207	72	3279
93	Provence-Alpes-Côte d;Azur	84	3	15	018	Blauvac	447	9	456
93	Provence-Alpes-Côte d;Azur	84	2	06	019	Bollène	13843	249	14092
93	Provence-Alpes-Côte d;Azur	84	1	07	020	Bonnieux	1420	39	1459
93	Provence-Alpes-Côte d;Azur	84	3	14	021	Brantes	84	3	87
93	Provence-Alpes-Côte d;Azur	84	3	21	022	Buisson	278	6	284
93	Provence-Alpes-Côte d;Azur	84	1	07	023	Buoux	116	3	119
93	Provence-Alpes-Côte d;Azur	84	1	19	024	Cabrières-d;Aigues	841	22	863
93	Provence-Alpes-Côte d;Azur	84	2	13	025	Cabrières-d;Avignon	1810	53	1863
93	Provence-Alpes-Côte d;Azur	84	1	08	026	Cadenet	4085	117	4202
93	Provence-Alpes-Côte d;Azur	84	2	17	027	Caderousse	2735	60	2795
93	Provence-Alpes-Côte d;Azur	84	3	21	028	Cairanne	983	18	1001
93	Provence-Alpes-Côte d;Azur	84	2	16	029	Camaret-sur-Aigues	4518	87	4605
93	Provence-Alpes-Côte d;Azur	84	3	09	030	Caromb	3179	79	3258
93	Provence-Alpes-Côte d;Azur	84	3	98	031	Carpentras	29278	1082	30360
93	Provence-Alpes-Côte d;Azur	84	1	01	032	Caseneuve	448	3	451
93	Provence-Alpes-Côte d;Azur	84	1	01	033	Castellet	116	2	118
93	Provence-Alpes-Côte d;Azur	84	1	11	034	Caumont-sur-Durance	4635	87	4722
93	Provence-Alpes-Côte d;Azur	84	1	11	035	Cavaillon	24951	489	25440
93	Provence-Alpes-Côte d;Azur	84	2	13	036	Châteauneuf-de-Gadagne	3259	96	3355
93	Provence-Alpes-Côte d;Azur	84	2	17	037	Châteauneuf-du-Pape	2140	39	2179
93	Provence-Alpes-Côte d;Azur	84	1	11	038	Cheval-Blanc	4138	79	4217
93	Provence-Alpes-Côte d;Azur	84	2	05	039	Courthézon	5387	79	5466
93	Provence-Alpes-Côte d;Azur	84	3	21	040	Crestet	458	13	471
93	Provence-Alpes-Côte d;Azur	84	3	15	041	Crillon-le-Brave	448	11	459
93	Provence-Alpes-Côte d;Azur	84	1	08	042	Cucuron	1830	44	1874
93	Provence-Alpes-Côte d;Azur	84	3	10	043	Entraigues-sur-la-Sorgue	7795	123	7918
93	Provence-Alpes-Côte d;Azur	84	3	14	044	Entrechaux	1071	21	1092
93	Provence-Alpes-Côte d;Azur	84	3	21	045	Faucon	416	7	423
93	Provence-Alpes-Côte d;Azur	84	3	15	046	Flassan	412	13	425
93	Provence-Alpes-Côte d;Azur	84	2	13	139	Fontaine-de-Vaucluse	668	12	680
93	Provence-Alpes-Côte d;Azur	84	1	01	047	Gargas	2929	66	2995
93	Provence-Alpes-Côte d;Azur	84	1	01	048	Gignac	56	2	58
93	Provence-Alpes-Côte d;Azur	84	3	04	049	Gigondas	556	11	567
93	Provence-Alpes-Côte d;Azur	84	1	12	050	Gordes	2113	42	2155
93	Provence-Alpes-Côte d;Azur	84	1	12	051	Goult	1161	51	1212
93	Provence-Alpes-Côte d;Azur	84	1	19	052	Grambois	1110	25	1135
93	Provence-Alpes-Côte d;Azur	84	2	22	053	Grillon	1705	43	1748
93	Provence-Alpes-Côte d;Azur	84	2	13	054	L; Isle-sur-la-Sorgue	19048	477	19525
93	Provence-Alpes-Côte d;Azur	84	2	13	055	Jonquerettes	1358	23	1381
93	Provence-Alpes-Côte d;Azur	84	2	16	056	Jonquières	4576	67	4643
93	Provence-Alpes-Côte d;Azur	84	1	12	057	Joucas	326	8	334
93	Provence-Alpes-Côte d;Azur	84	1	07	058	Lacoste	413	16	429
93	Provence-Alpes-Côte d;Azur	84	3	04	059	Lafare	113	0	113
93	Provence-Alpes-Côte d;Azur	84	1	01	060	Lagarde-d;Apt	37	0	37
93	Provence-Alpes-Côte d;Azur	84	2	06	061	Lagarde-Paréol	304	15	319
93	Provence-Alpes-Côte d;Azur	84	2	13	062	Lagnes	1681	42	1723
93	Provence-Alpes-Côte d;Azur	84	2	06	063	Lamotte-du-Rhône	407	13	420
93	Provence-Alpes-Côte d;Azur	84	2	06	064	Lapalud	3832	83	3915
93	Provence-Alpes-Côte d;Azur	84	1	08	065	Lauris	3655	77	3732
93	Provence-Alpes-Côte d;Azur	84	1	12	066	Lioux	252	6	258
93	Provence-Alpes-Côte d;Azur	84	3	09	067	Loriol-du-Comtat	2390	27	2417
93	Provence-Alpes-Côte d;Azur	84	1	08	068	Lourmarin	1005	35	1040
93	Provence-Alpes-Côte d;Azur	84	3	14	069	Malaucène	2665	59	2724
93	Provence-Alpes-Côte d;Azur	84	3	15	070	Malemort-du-Comtat	1510	25	1535
93	Provence-Alpes-Côte d;Azur	84	1	11	071	Maubec	1874	42	1916
93	Provence-Alpes-Côte d;Azur	84	3	10	072	Mazan	5792	114	5906
93	Provence-Alpes-Côte d;Azur	84	1	07	073	Ménerbes	1104	30	1134
93	Provence-Alpes-Côte d;Azur	84	1	08	074	Mérindol	1966	37	2003
93	Provence-Alpes-Côte d;Azur	84	3	15	075	Méthamis	396	5	401
93	Provence-Alpes-Côte d;Azur	84	1	19	076	Mirabeau	1184	22	1206
93	Provence-Alpes-Côte d;Azur	84	3	15	077	Modène	422	7	429
93	Provence-Alpes-Côte d;Azur	84	2	06	078	Mondragon	3691	63	3754
93	Provence-Alpes-Côte d;Azur	84	3	20	079	Monieux	338	8	346
93	Provence-Alpes-Côte d;Azur	84	3	10	080	Monteux	10989	202	11191
93	Provence-Alpes-Côte d;Azur	84	2	23	081	Morières-lès-Avignon	7676	145	7821
93	Provence-Alpes-Côte d;Azur	84	3	15	082	Mormoiron	1927	41	1968
93	Provence-Alpes-Côte d;Azur	84	2	06	083	Mornas	2305	49	2354
93	Provence-Alpes-Côte d;Azur	84	1	19	084	La Motte-d;Aigues	1350	29	1379
93	Provence-Alpes-Côte d;Azur	84	1	12	085	Murs	422	10	432
93	Provence-Alpes-Côte d;Azur	84	1	07	086	Oppède	1359	34	1393
93	Provence-Alpes-Côte d;Azur	84	2	99	087	Orange	29135	656	29791
93	Provence-Alpes-Côte d;Azur	84	3	18	088	Pernes-les-Fontaines	10405	249	10654
93	Provence-Alpes-Côte d;Azur	84	1	19	089	Pertuis	18931	334	19265
93	Provence-Alpes-Côte d;Azur	84	1	19	090	Peypin-d;Aigues	599	20	619
93	Provence-Alpes-Côte d;Azur	84	2	17	091	Piolenc	5006	101	5107
93	Provence-Alpes-Côte d;Azur	84	2	02	092	Le Pontet	16731	199	16930
93	Provence-Alpes-Côte d;Azur	84	1	08	093	Puget	674	14	688
93	Provence-Alpes-Côte d;Azur	84	3	21	094	Puyméras	648	14	662
93	Provence-Alpes-Côte d;Azur	84	1	08	095	Puyvert	757	15	772
93	Provence-Alpes-Côte d;Azur	84	3	21	096	Rasteau	798	15	813
93	Provence-Alpes-Côte d;Azur	84	2	22	097	Richerenches	696	66	762
93	Provence-Alpes-Côte d;Azur	84	3	21	098	Roaix	647	14	661
93	Provence-Alpes-Côte d;Azur	84	1	11	099	Robion	4120	107	4227
93	Provence-Alpes-Côte d;Azur	84	3	04	100	La Roque-Alric	64	1	65
93	Provence-Alpes-Côte d;Azur	84	3	18	101	La Roque-sur-Pernes	431	10	441
93	Provence-Alpes-Côte d;Azur	84	1	12	102	Roussillon	1305	30	1335
93	Provence-Alpes-Côte d;Azur	84	1	01	103	Rustrel	749	11	760
93	Provence-Alpes-Côte d;Azur	84	3	04	104	Sablet	1219	32	1251
93	Provence-Alpes-Côte d;Azur	84	1	01	105	Saignon	1024	36	1060
93	Provence-Alpes-Côte d;Azur	84	3	20	107	Saint-Christol	1350	11	1361
93	Provence-Alpes-Côte d;Azur	84	3	18	108	Saint-Didier	2128	49	2177
93	Provence-Alpes-Côte d;Azur	84	3	09	109	Saint-Hippolyte-le-Graveyron	164	5	169
93	Provence-Alpes-Côte d;Azur	84	3	14	110	Saint-Léger-du-Ventoux	33	2	35
93	Provence-Alpes-Côte d;Azur	84	3	21	111	Saint-Marcellin-lès-Vaison	340	9	349
93	Provence-Alpes-Côte d;Azur	84	1	01	112	Saint-Martin-de-Castillon	751	24	775
93	Provence-Alpes-Côte d;Azur	84	1	19	113	Saint-Martin-de-la-Brasque	748	13	761
93	Provence-Alpes-Côte d;Azur	84	1	12	114	Saint-Pantaléon	186	2	188
93	Provence-Alpes-Côte d;Azur	84	3	15	115	Saint-Pierre-de-Vassols	493	15	508
93	Provence-Alpes-Côte d;Azur	84	3	21	116	Saint-Romain-en-Viennois	856	16	872
93	Provence-Alpes-Côte d;Azur	84	3	21	117	Saint-Roman-de-Malegarde	326	6	332
93	Provence-Alpes-Côte d;Azur	84	1	01	118	Saint-Saturnin-lès-Apt	2658	75	2733
93	Provence-Alpes-Côte d;Azur	84	2	13	119	Saint-Saturnin-lès-Avignon	4894	85	4979
93	Provence-Alpes-Côte d;Azur	84	3	20	120	Saint-Trinit	123	4	127
93	Provence-Alpes-Côte d;Azur	84	2	06	106	Sainte-Cécile-les-Vignes	2295	85	2380
93	Provence-Alpes-Côte d;Azur	84	1	19	121	Sannes	173	4	177
93	Provence-Alpes-Côte d;Azur	84	3	09	122	Sarrians	5809	90	5899
93	Provence-Alpes-Côte d;Azur	84	3	20	123	Sault	1362	25	1387
93	Provence-Alpes-Côte d;Azur	84	2	13	124	Saumane-de-Vaucluse	856	19	875
93	Provence-Alpes-Côte d;Azur	84	3	14	125	Savoillan	94	1	95
93	Provence-Alpes-Côte d;Azur	84	3	21	126	Séguret	869	36	905
93	Provence-Alpes-Côte d;Azur	84	2	16	127	Sérignan-du-Comtat	2403	74	2477
93	Provence-Alpes-Côte d;Azur	84	1	07	128	Sivergues	49	1	50
93	Provence-Alpes-Côte d;Azur	84	2	05	129	Sorgues	18046	174	18220
93	Provence-Alpes-Côte d;Azur	84	3	04	130	Suzette	119	4	123
93	Provence-Alpes-Côte d;Azur	84	1	11	131	Taillades	1959	50	2009
93	Provence-Alpes-Côte d;Azur	84	2	13	132	Le Thor	8281	181	8462
93	Provence-Alpes-Côte d;Azur	84	1	19	133	La Tour-d;Aigues	3947	149	4096
93	Provence-Alpes-Côte d;Azur	84	2	16	134	Travaillan	665	14	679
93	Provence-Alpes-Côte d;Azur	84	2	16	135	Uchaux	1386	62	1448
93	Provence-Alpes-Côte d;Azur	84	3	04	136	Vacqueyras	1050	21	1071
93	Provence-Alpes-Côte d;Azur	84	3	21	137	Vaison-la-Romaine	6169	143	6312
93	Provence-Alpes-Côte d;Azur	84	2	22	138	Valréas	9800	277	10077
93	Provence-Alpes-Côte d;Azur	84	1	08	140	Vaugines	526	14	540
93	Provence-Alpes-Côte d;Azur	84	2	05	141	Vedène	10580	325	10905
93	Provence-Alpes-Côte d;Azur	84	3	18	142	Velleron	2958	39	2997
93	Provence-Alpes-Côte d;Azur	84	3	18	143	Venasque	1156	24	1180
93	Provence-Alpes-Côte d;Azur	84	1	01	144	Viens	606	15	621
93	Provence-Alpes-Côte d;Azur	84	1	01	145	Villars	786	18	804
93	Provence-Alpes-Côte d;Azur	84	3	21	146	Villedieu	514	15	529
93	Provence-Alpes-Côte d;Azur	84	1	08	147	Villelaure	3223	78	3301
93	Provence-Alpes-Côte d;Azur	84	3	15	148	Villes-sur-Auzon	1296	36	1332
93	Provence-Alpes-Côte d;Azur	84	2	16	149	Violès	1553	31	1584
93	Provence-Alpes-Côte d;Azur	84	2	22	150	Visan	1932	47	1979
93	Provence-Alpes-Côte d;Azur	84	1	19	151	Vitrolles-en-Lubéron	186	6	192
52	Pays de la Loire	85	1	11	001	L; Aiguillon-sur-Mer	2312	31	2343
52	Pays de la Loire	85	3	26	002	L; Aiguillon-sur-Vie	1693	15	1708
52	Pays de la Loire	85	2	20	003	Aizenay	8107	164	8271
52	Pays de la Loire	85	3	17	004	Angles	2433	41	2474
52	Pays de la Loire	85	1	05	005	Antigny	1029	26	1055
52	Pays de la Loire	85	3	19	006	Apremont	1597	27	1624
52	Pays de la Loire	85	2	31	008	Aubigny	3046	69	3115
52	Pays de la Loire	85	1	07	009	Auzay	614	18	632
52	Pays de la Loire	85	3	30	010	Avrillé	1238	15	1253
52	Pays de la Loire	85	3	18	011	Barbâtre	1793	42	1835
52	Pays de la Loire	85	3	29	012	La Barre-de-Monts	2157	35	2192
52	Pays de la Loire	85	2	25	013	Bazoges-en-Paillers	1118	9	1127
52	Pays de la Loire	85	1	05	014	Bazoges-en-Pareds	1167	27	1194
52	Pays de la Loire	85	2	20	015	Beaufou	1177	28	1205
52	Pays de la Loire	85	3	16	016	Beaulieu-sous-la-Roche	2053	33	2086
52	Pays de la Loire	85	2	08	017	Beaurepaire	2185	46	2231
52	Pays de la Loire	85	3	01	018	Beauvoir-sur-Mer	3904	65	3969
52	Pays de la Loire	85	2	20	019	Belleville-sur-Vie	3859	85	3944
52	Pays de la Loire	85	1	12	020	Benet	3696	98	3794
52	Pays de la Loire	85	3	30	022	Le Bernard	1055	11	1066
52	Pays de la Loire	85	2	14	021	La Bernardière	1672	30	1702
52	Pays de la Loire	85	2	13	023	Bessay	412	9	421
52	Pays de la Loire	85	3	03	024	Bois-de-Céné	1669	20	1689
52	Pays de la Loire	85	2	14	025	La Boissière-de-Montaigu	2093	37	2130
52	Pays de la Loire	85	3	17	026	La Boissière-des-Landes	1300	33	1333
52	Pays de la Loire	85	2	14	027	Boufféré	2922	74	2996
52	Pays de la Loire	85	1	12	028	Bouillé-Courdault	481	3	484
52	Pays de la Loire	85	3	01	029	Bouin	2200	30	2230
52	Pays de la Loire	85	2	06	030	Boulogne	765	12	777
52	Pays de la Loire	85	1	21	031	Le Boupère	2956	52	3008
52	Pays de la Loire	85	1	09	033	Bourneau	787	15	802
52	Pays de la Loire	85	2	04	034	Bournezeau	3071	101	3172
52	Pays de la Loire	85	3	26	243	Brem-sur-Mer	2582	42	2624
52	Pays de la Loire	85	3	26	035	Bretignolles-sur-Mer	4157	58	4215
52	Pays de la Loire	85	2	13	036	La Bretonnière-la-Claye	619	10	629
52	Pays de la Loire	85	1	05	037	Breuil-Barret	645	17	662
52	Pays de la Loire	85	2	25	038	Les Brouzils	2595	36	2631
52	Pays de la Loire	85	2	14	039	La Bruffière	3640	72	3712
52	Pays de la Loire	85	1	27	040	La Caillère-Saint-Hilaire	1071	24	1095
52	Pays de la Loire	85	1	05	041	Cezais	318	7	325
52	Pays de la Loire	85	1	02	042	Chaillé-les-Marais	1946	36	1982
52	Pays de la Loire	85	2	31	043	Chaillé-sous-les-Ormeaux	1269	20	1289
52	Pays de la Loire	85	1	07	044	Chaix	433	16	449
52	Pays de la Loire	85	3	26	045	La Chaize-Giraud	939	16	955
52	Pays de la Loire	85	2	31	046	La Chaize-le-Vicomte	3414	67	3481
52	Pays de la Loire	85	3	03	047	Challans	18686	655	19341
52	Pays de la Loire	85	2	15	048	Chambretaud	1457	34	1491
52	Pays de la Loire	85	3	17	050	Le Champ-Saint-Père	1674	25	1699
52	Pays de la Loire	85	1	02	049	Champagné-les-Marais	1700	17	1717
52	Pays de la Loire	85	2	04	051	Chantonnay	8248	382	8630
52	Pays de la Loire	85	3	16	052	La Chapelle-Achard	1745	28	1773
52	Pays de la Loire	85	1	05	053	La Chapelle-aux-Lys	250	1	251
52	Pays de la Loire	85	3	16	054	La Chapelle-Hermier	847	7	854
52	Pays de la Loire	85	3	19	055	La Chapelle-Palluau	921	21	942
52	Pays de la Loire	85	1	27	056	La Chapelle-Thémer	355	7	362
52	Pays de la Loire	85	1	11	058	Chasnais	651	15	666
52	Pays de la Loire	85	1	05	059	La Châtaigneraie	2691	50	2741
52	Pays de la Loire	85	3	24	060	Château-d;Olonne	13353	449	13802
52	Pays de la Loire	85	2	13	061	Château-Guibert	1461	28	1489
52	Pays de la Loire	85	3	03	062	Châteauneuf	892	18	910
52	Pays de la Loire	85	1	21	063	Les Châtelliers-Châteaumur	705	16	721
52	Pays de la Loire	85	2	25	064	Chauché	2249	35	2284
52	Pays de la Loire	85	2	25	065	Chavagnes-en-Paillers	3335	84	3419
52	Pays de la Loire	85	1	21	066	Chavagnes-les-Redoux	793	17	810
52	Pays de la Loire	85	1	05	067	Cheffois	964	21	985
52	Pays de la Loire	85	2	31	069	Les Clouzeaux	2529	75	2604
52	Pays de la Loire	85	3	26	070	Coëx	3025	49	3074
52	Pays de la Loire	85	3	26	071	Commequiers	3021	76	3097
52	Pays de la Loire	85	2	25	072	La Copechagnière	901	11	912
52	Pays de la Loire	85	2	13	073	Corpe	912	9	921
52	Pays de la Loire	85	2	13	074	La Couture	197	5	202
52	Pays de la Loire	85	2	14	076	Cugand	3269	84	3353
52	Pays de la Loire	85	3	17	077	Curzon	459	8	467
52	Pays de la Loire	85	1	12	078	Damvix	801	16	817
52	Pays de la Loire	85	1	12	080	Doix	883	13	896
52	Pays de la Loire	85	2	06	081	Dompierre-sur-Yon	4066	88	4154
52	Pays de la Loire	85	2	08	082	Les Epesses	2644	65	2709
52	Pays de la Loire	85	3	18	083	L; Épine	1743	56	1799
52	Pays de la Loire	85	2	06	084	Les Essarts	5063	79	5142
52	Pays de la Loire	85	3	19	086	Falleron	1511	25	1536
52	Pays de la Loire	85	3	17	307	La Faute-sur-Mer	828	11	839
52	Pays de la Loire	85	1	28	087	Faymoreau	232	5	237
52	Pays de la Loire	85	3	26	088	Le Fenouiller	4328	134	4462
52	Pays de la Loire	85	2	06	089	La Ferrière	4858	134	4992
52	Pays de la Loire	85	1	21	090	La Flocellière	2445	59	2504
52	Pays de la Loire	85	1	07	091	Fontaines	820	37	857
52	Pays de la Loire	85	1	07	092	Fontenay-le-Comte	14339	704	15043
52	Pays de la Loire	85	2	31	093	Fougeré	1072	19	1091
52	Pays de la Loire	85	1	28	094	Foussais-Payré	1211	23	1234
52	Pays de la Loire	85	3	03	095	Froidfond	1514	21	1535
52	Pays de la Loire	85	3	03	096	La Garnache	4493	95	4588
52	Pays de la Loire	85	2	15	097	La Gaubretière	2969	65	3034
52	Pays de la Loire	85	2	20	098	La Génétouze	1735	27	1762
52	Pays de la Loire	85	3	16	099	Le Girouard	873	10	883
52	Pays de la Loire	85	3	26	100	Givrand	1957	48	2005
52	Pays de la Loire	85	3	17	101	Le Givre	428	9	437
52	Pays de la Loire	85	3	19	102	Grand;Landes	517	3	520
52	Pays de la Loire	85	3	30	103	Grosbreuil	2052	26	2078
52	Pays de la Loire	85	1	11	104	Grues	811	12	823
52	Pays de la Loire	85	1	02	105	Le Gué-de-Velluire	556	4	560
52	Pays de la Loire	85	3	18	106	La Guérinière	1478	55	1533
52	Pays de la Loire	85	2	14	107	La Guyonnière	2706	180	2886
52	Pays de la Loire	85	2	22	108	L; Herbergement	2733	68	2801
52	Pays de la Loire	85	2	08	109	Les Herbiers	15229	498	15727
52	Pays de la Loire	85	1	09	110	L; Hermenault	849	23	872
52	Pays de la Loire	85	1	02	111	L; Île-d;Elle	1447	37	1484
52	Pays de la Loire	85	3	24	112	L; Île-d;Olonne	2710	52	2762
52	Pays de la Loire	85	3	10	113	L; Île-d;Yeu	4591	151	4742
52	Pays de la Loire	85	3	30	114	Jard-sur-Mer	2543	37	2580
52	Pays de la Loire	85	1	27	115	La Jaudonnière	592	5	597
52	Pays de la Loire	85	3	17	116	La Jonchère	387	7	394
52	Pays de la Loire	85	1	11	117	Lairoux	603	13	616
52	Pays de la Loire	85	3	16	118	Landeronde	2172	62	2234
52	Pays de la Loire	85	2	15	119	Les Landes-Genusson	2290	45	2335
52	Pays de la Loire	85	3	26	120	Landevieille	1228	16	1244
52	Pays de la Loire	85	1	07	121	Le Langon	1102	12	1114
52	Pays de la Loire	85	1	12	123	Liez	268	8	276
52	Pays de la Loire	85	1	05	125	Loge-Fougereuse	363	5	368
52	Pays de la Loire	85	1	07	126	Longèves	1226	46	1272
52	Pays de la Loire	85	3	30	127	Longeville-sur-Mer	2377	34	2411
52	Pays de la Loire	85	2	20	129	Les Lucs-sur-Boulogne	3264	44	3308
52	Pays de la Loire	85	1	11	128	Luçon	9636	458	10094
52	Pays de la Loire	85	3	19	130	Maché	1354	23	1377
52	Pays de la Loire	85	1	11	131	Les Magnils-Reigniers	1504	45	1549
52	Pays de la Loire	85	1	12	132	Maillé	764	14	778
52	Pays de la Loire	85	1	12	133	Maillezais	968	33	1001
52	Pays de la Loire	85	2	15	134	Mallièvre	241	9	250
52	Pays de la Loire	85	2	13	135	Mareuil-sur-Lay-Dissais	2737	118	2855
52	Pays de la Loire	85	1	05	136	Marillet	115	2	117
52	Pays de la Loire	85	1	09	137	Marsais-Sainte-Radégonde	519	10	529
52	Pays de la Loire	85	3	16	138	Martinet	870	10	880
52	Pays de la Loire	85	1	12	139	Le Mazeau	422	22	444
52	Pays de la Loire	85	1	21	140	La Meilleraie-Tillay	1539	33	1572
52	Pays de la Loire	85	1	05	141	Menomblet	639	25	664
52	Pays de la Loire	85	2	06	142	La Merlatière	908	16	924
52	Pays de la Loire	85	1	28	143	Mervent	1068	25	1093
52	Pays de la Loire	85	2	08	144	Mesnard-la-Barotière	1248	23	1271
52	Pays de la Loire	85	1	21	145	Monsireigne	913	13	926
52	Pays de la Loire	85	2	14	146	Montaigu	5050	165	5215
52	Pays de la Loire	85	1	21	147	Montournais	1717	45	1762
52	Pays de la Loire	85	1	07	148	Montreuil	807	30	837
52	Pays de la Loire	85	1	02	149	Moreilles	360	9	369
52	Pays de la Loire	85	2	22	150	Mormaison	1053	15	1068
52	Pays de la Loire	85	2	15	151	Mortagne-sur-Sèvre	6028	185	6213
52	Pays de la Loire	85	3	16	152	La Mothe-Achard	2631	75	2706
52	Pays de la Loire	85	2	08	153	Mouchamps	2676	54	2730
52	Pays de la Loire	85	1	05	154	Mouilleron-en-Pareds	1314	83	1397
52	Pays de la Loire	85	2	23	155	Mouilleron-le-Captif	4647	122	4769
52	Pays de la Loire	85	3	17	156	Moutiers-les-Mauxfaits	1856	31	1887
52	Pays de la Loire	85	2	13	157	Moutiers-sur-le-Lay	658	6	664
52	Pays de la Loire	85	1	09	158	Mouzeuil-Saint-Martin	1141	21	1162
52	Pays de la Loire	85	1	09	159	Nalliers	2209	26	2235
52	Pays de la Loire	85	2	31	160	Nesmy	2615	64	2679
52	Pays de la Loire	85	3	16	161	Nieul-le-Dolent	2278	36	2314
52	Pays de la Loire	85	1	28	162	Nieul-sur-l;Autise	1243	25	1268
52	Pays de la Loire	85	3	18	163	Noirmoutier-en-l;Île	4567	142	4709
52	Pays de la Loire	85	3	29	164	Notre-Dame-de-Monts	1876	22	1898
52	Pays de la Loire	85	3	26	189	Notre-Dame-de-Riez	1927	27	1954
52	Pays de la Loire	85	2	06	165	L; Oie	1143	20	1163
52	Pays de la Loire	85	3	24	166	Olonne-sur-Mer	13618	698	14316
52	Pays de la Loire	85	1	07	167	L; Orbrie	833	37	870
52	Pays de la Loire	85	1	28	168	Oulmes	738	27	765
52	Pays de la Loire	85	3	19	169	Palluau	1020	19	1039
52	Pays de la Loire	85	2	13	171	Péault	531	11	542
52	Pays de la Loire	85	3	29	172	Le Perrier	1859	39	1898
52	Pays de la Loire	85	1	09	174	Petosse	606	12	618
52	Pays de la Loire	85	2	13	175	Les Pineaux	587	8	595
52	Pays de la Loire	85	1	07	176	Pissotte	1219	27	1246
52	Pays de la Loire	85	1	07	177	Le Poiré-sur-Velluire	627	13	640
52	Pays de la Loire	85	2	20	178	Le Poiré-sur-Vie	7837	166	8003
52	Pays de la Loire	85	3	30	179	Poiroux	902	21	923
52	Pays de la Loire	85	1	21	180	La Pommeraie-sur-Sèvre	1058	23	1081
52	Pays de la Loire	85	1	09	181	Pouillé	647	5	652
52	Pays de la Loire	85	1	21	182	Pouzauges	5460	172	5632
52	Pays de la Loire	85	1	28	184	Puy-de-Serre	303	7	310
52	Pays de la Loire	85	1	02	185	Puyravault	657	8	665
52	Pays de la Loire	85	2	25	186	La Rabatelière	860	8	868
52	Pays de la Loire	85	1	21	187	Réaumur	814	20	834
52	Pays de la Loire	85	1	27	188	La Réorthe	1029	16	1045
52	Pays de la Loire	85	2	98	191	La Roche-sur-Yon	52664	3437	56101
52	Pays de la Loire	85	2	22	190	Rocheservière	2970	58	3028
52	Pays de la Loire	85	2	04	192	Rochetrejoux	869	13	882
52	Pays de la Loire	85	2	13	193	Rosnay	558	4	562
52	Pays de la Loire	85	3	24	194	Les Sables-d;Olonne	14603	285	14888
52	Pays de la Loire	85	2	25	196	Saint-André-Goule-d;Oie	1672	24	1696
52	Pays de la Loire	85	2	22	197	Saint-André-Treize-Voies	1333	33	1366
52	Pays de la Loire	85	2	15	198	Saint-Aubin-des-Ormeaux	1299	43	1342
52	Pays de la Loire	85	1	27	199	Saint-Aubin-la-Plaine	480	5	485
52	Pays de la Loire	85	3	17	200	Saint-Avaugourd-des-Landes	941	8	949
52	Pays de la Loire	85	3	17	201	Saint-Benoist-sur-Mer	349	5	354
52	Pays de la Loire	85	3	19	204	Saint-Christophe-du-Ligneron	2478	22	2500
52	Pays de la Loire	85	1	09	205	Saint-Cyr-des-Gâts	521	11	532
52	Pays de la Loire	85	3	17	206	Saint-Cyr-en-Talmondais	349	6	355
52	Pays de la Loire	85	1	11	207	Saint-Denis-du-Payré	378	9	387
52	Pays de la Loire	85	2	20	208	Saint-Denis-la-Chevasse	2132	35	2167
52	Pays de la Loire	85	1	27	209	Saint-Étienne-de-Brillouet	516	6	522
52	Pays de la Loire	85	3	19	210	Saint-Étienne-du-Bois	1940	29	1969
52	Pays de la Loire	85	2	31	213	Saint-Florent-des-Bois	2574	101	2675
52	Pays de la Loire	85	2	25	215	Saint-Fulgent	3590	146	3736
52	Pays de la Loire	85	2	14	217	Saint-Georges-de-Montaigu	3877	69	3946
52	Pays de la Loire	85	3	16	218	Saint-Georges-de-Pointindoux	1545	21	1566
52	Pays de la Loire	85	2	04	220	Saint-Germain-de-Prinçay	1495	36	1531
52	Pays de la Loire	85	1	05	219	Saint-Germain-l;Aiguiller	408	10	418
52	Pays de la Loire	85	3	01	221	Saint-Gervais	2289	25	2314
52	Pays de la Loire	85	3	26	222	Saint-Gilles-Croix-de-Vie	7250	160	7410
52	Pays de la Loire	85	2	14	224	Saint-Hilaire-de-Loulay	4235	123	4358
52	Pays de la Loire	85	3	26	226	Saint-Hilaire-de-Riez	10488	209	10697
52	Pays de la Loire	85	1	05	229	Saint-Hilaire-de-Voust	647	7	654
52	Pays de la Loire	85	1	28	227	Saint-Hilaire-des-Loges	1957	35	1992
52	Pays de la Loire	85	3	30	231	Saint-Hilaire-la-Forêt	636	7	643
52	Pays de la Loire	85	2	04	232	Saint-Hilaire-le-Vouhis	980	16	996
52	Pays de la Loire	85	1	27	233	Saint-Jean-de-Beugné	571	7	578
52	Pays de la Loire	85	3	29	234	Saint-Jean-de-Monts	8192	229	8421
52	Pays de la Loire	85	1	27	235	Saint-Juire-Champgillon	418	9	427
52	Pays de la Loire	85	3	16	236	Saint-Julien-des-Landes	1364	17	1381
52	Pays de la Loire	85	1	09	237	Saint-Laurent-de-la-Salle	371	12	383
52	Pays de la Loire	85	2	15	238	Saint-Laurent-sur-Sèvre	3446	873	4319
52	Pays de la Loire	85	3	26	239	Saint-Maixent-sur-Vie	929	11	940
52	Pays de la Loire	85	2	15	240	Saint-Malô-du-Bois	1476	64	1540
52	Pays de la Loire	85	2	08	242	Saint-Mars-la-Réorthe	895	26	921
52	Pays de la Loire	85	1	28	244	Saint-Martin-de-Fraigneau	835	58	893
52	Pays de la Loire	85	1	09	245	Saint-Martin-des-Fontaines	162	2	164
52	Pays de la Loire	85	2	06	246	Saint-Martin-des-Noyers	2228	24	2252
52	Pays de la Loire	85	2	15	247	Saint-Martin-des-Tilleuls	953	19	972
52	Pays de la Loire	85	1	27	248	Saint-Martin-Lars-en-Sainte-Hermine	396	6	402
52	Pays de la Loire	85	3	16	250	Saint-Mathurin	1936	49	1985
52	Pays de la Loire	85	1	05	251	Saint-Maurice-des-Noues	640	17	657
52	Pays de la Loire	85	1	05	252	Saint-Maurice-le-Girard	603	17	620
52	Pays de la Loire	85	1	21	254	Saint-Mesmin	1788	40	1828
52	Pays de la Loire	85	1	11	255	Saint-Michel-en-l;Herm	2186	73	2259
52	Pays de la Loire	85	1	28	256	Saint-Michel-le-Cloucq	1260	31	1291
52	Pays de la Loire	85	1	21	257	Saint-Michel-Mont-Mercure	1984	149	2133
52	Pays de la Loire	85	2	08	259	Saint-Paul-en-Pareds	1204	24	1228
52	Pays de la Loire	85	3	19	260	Saint-Paul-Mont-Penit	689	16	705
52	Pays de la Loire	85	2	22	262	Saint-Philbert-de-Bouaine	2976	56	3032
52	Pays de la Loire	85	1	05	264	Saint-Pierre-du-Chemin	1355	39	1394
52	Pays de la Loire	85	1	12	265	Saint-Pierre-le-Vieux	966	30	996
52	Pays de la Loire	85	2	04	266	Saint-Prouant	1479	19	1498
52	Pays de la Loire	85	3	26	268	Saint-Révérend	1332	20	1352
52	Pays de la Loire	85	1	12	269	Saint-Sigismond	415	3	418
52	Pays de la Loire	85	1	05	271	Saint-Sulpice-en-Pareds	392	6	398
52	Pays de la Loire	85	2	22	272	Saint-Sulpice-le-Verdon	901	20	921
52	Pays de la Loire	85	3	01	273	Saint-Urbain	1663	18	1681
52	Pays de la Loire	85	1	09	274	Saint-Valérien	493	13	506
52	Pays de la Loire	85	2	04	276	Saint-Vincent-Sterlanges	718	15	733
52	Pays de la Loire	85	3	17	277	Saint-Vincent-sur-Graon	1320	25	1345
52	Pays de la Loire	85	3	30	278	Saint-Vincent-sur-Jard	1229	16	1245
52	Pays de la Loire	85	2	06	202	Sainte-Cécile	1497	123	1620
52	Pays de la Loire	85	3	16	211	Sainte-Flaive-des-Loups	2135	41	2176
52	Pays de la Loire	85	2	06	212	Sainte-Florence	1123	16	1139
52	Pays de la Loire	85	3	24	214	Sainte-Foy	1816	43	1859
52	Pays de la Loire	85	1	11	216	Sainte-Gemme-la-Plaine	1951	190	2141
52	Pays de la Loire	85	1	27	223	Sainte-Hermine	2612	67	2679
52	Pays de la Loire	85	2	13	261	Sainte-Pexine	240	1	241
52	Pays de la Loire	85	1	02	267	Sainte-Radégonde-des-Noyers	804	22	826
52	Pays de la Loire	85	2	20	279	Saligny	1754	30	1784
52	Pays de la Loire	85	3	03	280	Sallertaine	2770	58	2828
52	Pays de la Loire	85	1	09	281	Sérigné	1021	27	1048
52	Pays de la Loire	85	2	04	282	Sigournais	835	16	851
52	Pays de la Loire	85	3	29	284	Soullans	4088	109	4197
52	Pays de la Loire	85	2	31	285	Le Tablier	640	13	653
52	Pays de la Loire	85	1	02	286	La Taillée	551	6	557
52	Pays de la Loire	85	1	21	287	Tallud-Sainte-Gemme	472	16	488
52	Pays de la Loire	85	3	30	288	Talmont-Saint-Hilaire	6991	182	7173
52	Pays de la Loire	85	1	05	289	La Tardière	1298	23	1321
52	Pays de la Loire	85	1	27	290	Thiré	563	6	569
52	Pays de la Loire	85	2	31	291	Thorigny	1112	28	1140
52	Pays de la Loire	85	1	05	292	Thouarsais-Bouildroux	715	12	727
52	Pays de la Loire	85	2	15	293	Tiffauges	1489	32	1521
52	Pays de la Loire	85	3	17	294	La Tranche-sur-Mer	2728	63	2791
52	Pays de la Loire	85	2	14	295	Treize-Septiers	2956	71	3027
52	Pays de la Loire	85	2	15	296	Treize-Vents	1144	30	1174
52	Pays de la Loire	85	1	11	297	Triaize	1039	19	1058
52	Pays de la Loire	85	3	24	298	Vairé	1504	30	1534
52	Pays de la Loire	85	1	07	299	Velluire	555	16	571
52	Pays de la Loire	85	2	23	300	Venansault	4490	171	4661
52	Pays de la Loire	85	2	08	301	Vendrennes	1492	26	1518
52	Pays de la Loire	85	2	15	302	La Verrie	3747	96	3843
52	Pays de la Loire	85	1	12	303	Vix	1760	39	1799
52	Pays de la Loire	85	1	02	304	Vouillé-les-Marais	690	7	697
52	Pays de la Loire	85	1	05	305	Vouvant	852	67	919
52	Pays de la Loire	85	1	28	306	Xanton-Chassenon	724	17	741
54	Poitou-Charentes	86	2	09	001	Adriers	728	26	754
54	Poitou-Charentes	86	3	15	002	Amberre	525	12	537
54	Poitou-Charentes	86	2	06	003	Anché	326	11	337
54	Poitou-Charentes	86	2	25	004	Angles-sur-l;Anglin	385	4	389
54	Poitou-Charentes	86	1	16	005	Angliers	651	11	662
54	Poitou-Charentes	86	2	25	006	Antigny	604	9	613
54	Poitou-Charentes	86	1	10	007	Antran	1155	35	1190
54	Poitou-Charentes	86	1	31	009	Archigny	1054	16	1070
54	Poitou-Charentes	86	1	12	008	Arçay	401	8	409
54	Poitou-Charentes	86	3	28	010	Aslonnes	1033	24	1057
54	Poitou-Charentes	86	2	09	011	Asnières-sur-Blour	201	4	205
54	Poitou-Charentes	86	2	02	012	Asnois	143	6	149
54	Poitou-Charentes	86	1	16	013	Aulnay	104	2	106
54	Poitou-Charentes	86	1	31	014	Availles-en-Châtellerault	1619	58	1677
54	Poitou-Charentes	86	2	01	015	Availles-Limouzine	1306	29	1335
54	Poitou-Charentes	86	3	19	016	Avanton	1815	29	1844
54	Poitou-Charentes	86	3	30	017	Ayron	1112	18	1130
54	Poitou-Charentes	86	1	12	018	Basses	342	13	355
54	Poitou-Charentes	86	1	31	019	Beaumont	1846	36	1882
54	Poitou-Charentes	86	1	31	020	Bellefonds	233	4	237
54	Poitou-Charentes	86	3	30	021	Benassay	887	12	899
54	Poitou-Charentes	86	1	27	022	Berrie	267	3	270
54	Poitou-Charentes	86	1	18	023	Berthegon	279	5	284
54	Poitou-Charentes	86	3	30	024	Béruges	1307	50	1357
54	Poitou-Charentes	86	2	25	025	Béthines	481	14	495
54	Poitou-Charentes	86	1	12	026	Beuxes	530	10	540
54	Poitou-Charentes	86	3	36	027	Biard	1659	60	1719
54	Poitou-Charentes	86	3	24	028	Bignoux	1046	21	1067
54	Poitou-Charentes	86	2	05	029	Blanzay	815	13	828
54	Poitou-Charentes	86	3	19	030	Blaslay	537	11	548
54	Poitou-Charentes	86	3	24	031	Bonnes	1702	34	1736
54	Poitou-Charentes	86	1	31	032	Bonneuil-Matours	2040	45	2085
54	Poitou-Charentes	86	2	14	034	Bouresse	570	20	590
54	Poitou-Charentes	86	2	17	035	Bourg-Archambault	196	6	202
54	Poitou-Charentes	86	1	27	036	Bournand	706	19	725
54	Poitou-Charentes	86	2	26	037	Brigueil-le-Chantre	507	1	508
54	Poitou-Charentes	86	2	08	038	Brion	246	3	249
54	Poitou-Charentes	86	2	06	039	Brux	692	15	707
54	Poitou-Charentes	86	2	25	040	La Bussière	350	11	361
54	Poitou-Charentes	86	3	22	041	Buxerolles	10047	222	10269
54	Poitou-Charentes	86	1	07	042	Buxeuil	931	19	950
54	Poitou-Charentes	86	2	06	043	Ceaux-en-Couhé	510	10	520
54	Poitou-Charentes	86	1	12	044	Ceaux-en-Loudun	599	17	616
54	Poitou-Charentes	86	3	13	045	Celle-Lévescault	1350	24	1374
54	Poitou-Charentes	86	1	31	046	Cenon-sur-Vienne	1836	53	1889
54	Poitou-Charentes	86	1	11	047	Cernay	443	11	454
54	Poitou-Charentes	86	3	19	048	Chabournay	924	14	938
54	Poitou-Charentes	86	1	12	049	Chalais	520	15	535
54	Poitou-Charentes	86	3	30	050	Chalandray	781	10	791
54	Poitou-Charentes	86	2	05	051	Champagné-le-Sec	217	1	218
54	Poitou-Charentes	86	2	08	052	Champagné-Saint-Hilaire	945	22	967
54	Poitou-Charentes	86	3	15	053	Champigny-le-Sec	1085	15	1100
54	Poitou-Charentes	86	2	05	054	Champniers	359	10	369
54	Poitou-Charentes	86	2	02	055	La Chapelle-Bâton	353	8	361
54	Poitou-Charentes	86	3	30	056	La Chapelle-Montreuil	662	8	670
54	Poitou-Charentes	86	3	24	058	La Chapelle-Moulière	645	19	664
54	Poitou-Charentes	86	2	04	059	Chapelle-Viviers	453	54	507
54	Poitou-Charentes	86	3	19	060	Charrais	1005	15	1020
54	Poitou-Charentes	86	2	02	061	Charroux	1169	21	1190
54	Poitou-Charentes	86	3	37	062	Chasseneuil-du-Poitou	4492	48	4540
54	Poitou-Charentes	86	2	02	063	Chatain	289	7	296
54	Poitou-Charentes	86	2	08	064	Château-Garnier	631	7	638
54	Poitou-Charentes	86	3	29	065	Château-Larcher	955	30	985
54	Poitou-Charentes	86	1	97	066	Châtellerault	32459	961	33420
54	Poitou-Charentes	86	2	06	067	Châtillon	231	3	234
54	Poitou-Charentes	86	2	06	068	Chaunay	1191	13	1204
54	Poitou-Charentes	86	1	16	069	La Chaussée	177	2	179
54	Poitou-Charentes	86	2	04	070	Chauvigny	6754	138	6892
54	Poitou-Charentes	86	3	19	071	Cheneché	338	5	343
54	Poitou-Charentes	86	1	20	072	Chenevelles	487	4	491
54	Poitou-Charentes	86	3	15	073	Cherves	560	17	577
54	Poitou-Charentes	86	3	30	074	Chiré-en-Montreuil	880	24	904
54	Poitou-Charentes	86	1	18	075	Chouppes	750	15	765
54	Poitou-Charentes	86	3	19	076	Cissé	2571	43	2614
54	Poitou-Charentes	86	2	14	077	Civaux	964	14	978
54	Poitou-Charentes	86	2	05	078	Civray	2866	142	3008
54	Poitou-Charentes	86	3	13	080	Cloué	444	5	449
54	Poitou-Charentes	86	1	38	081	Colombiers	1503	28	1531
54	Poitou-Charentes	86	2	06	082	Couhé	1855	88	1943
54	Poitou-Charentes	86	3	13	083	Coulombiers	1083	14	1097
54	Poitou-Charentes	86	2	26	084	Coulonges	268	3	271
54	Poitou-Charentes	86	1	18	085	Coussay	264	6	270
54	Poitou-Charentes	86	1	20	086	Coussay-les-Bois	903	12	915
54	Poitou-Charentes	86	1	16	087	Craon	199	4	203
54	Poitou-Charentes	86	3	35	088	Croutelle	819	20	839
54	Poitou-Charentes	86	3	15	089	Cuhon	404	6	410
54	Poitou-Charentes	86	3	13	091	Curzay-sur-Vonne	468	7	475
54	Poitou-Charentes	86	1	27	090	Curçay-sur-Dive	227	2	229
54	Poitou-Charentes	86	1	07	092	Dangé-Saint-Romain	3145	54	3199
54	Poitou-Charentes	86	1	18	093	Dercé	162	5	167
54	Poitou-Charentes	86	3	28	094	Dienné	519	9	528
54	Poitou-Charentes	86	3	23	095	Dissay	3013	54	3067
54	Poitou-Charentes	86	1	11	096	Doussay	633	7	640
54	Poitou-Charentes	86	2	08	097	La Ferrière-Airoux	350	4	354
54	Poitou-Charentes	86	2	04	098	Fleix	156	3	159
54	Poitou-Charentes	86	3	28	099	Fleuré	1008	11	1019
54	Poitou-Charentes	86	3	35	100	Fontaine-le-Comte	3661	90	3751
54	Poitou-Charentes	86	3	30	102	Frozes	504	11	515
54	Poitou-Charentes	86	2	02	104	Genouillé	542	7	549
54	Poitou-Charentes	86	2	08	103	Gençay	1773	71	1844
54	Poitou-Charentes	86	3	28	105	Gizay	384	10	394
54	Poitou-Charentes	86	1	27	106	Glénouze	120	0	120
54	Poitou-Charentes	86	2	14	107	Gouex	477	13	490
54	Poitou-Charentes	86	1	16	108	La Grimaudière	384	10	394
54	Poitou-Charentes	86	1	18	109	Guesnes	232	6	238
54	Poitou-Charentes	86	2	26	110	Haims	241	5	246
54	Poitou-Charentes	86	1	07	111	Ingrandes	1774	103	1877
54	Poitou-Charentes	86	2	09	112	L; Isle-Jourdain	1215	26	1241
54	Poitou-Charentes	86	3	29	113	Iteuil	2860	61	2921
54	Poitou-Charentes	86	3	24	114	Jardres	1124	81	1205
54	Poitou-Charentes	86	3	23	115	Jaunay-Clan	5811	174	5985
54	Poitou-Charentes	86	3	13	116	Jazeneuil	835	18	853
54	Poitou-Charentes	86	2	17	117	Jouhet	507	7	514
54	Poitou-Charentes	86	2	26	118	Journet	368	8	376
54	Poitou-Charentes	86	2	02	119	Joussé	342	2	344
54	Poitou-Charentes	86	2	17	120	Lathus-Saint-Rémy	1237	24	1261
54	Poitou-Charentes	86	3	30	121	Latillé	1480	28	1508
54	Poitou-Charentes	86	2	04	122	Lauthiers	77	2	79
54	Poitou-Charentes	86	3	30	123	Lavausseau	798	12	810
54	Poitou-Charentes	86	3	24	124	Lavoux	1116	18	1134
54	Poitou-Charentes	86	1	20	125	Leigné-les-Bois	582	16	598
54	Poitou-Charentes	86	1	10	127	Leigné-sur-Usseau	457	15	472
54	Poitou-Charentes	86	2	04	126	Leignes-sur-Fontaine	580	8	588
54	Poitou-Charentes	86	1	11	128	Lencloître	2477	40	2517
54	Poitou-Charentes	86	1	20	129	Lésigny	529	3	532
54	Poitou-Charentes	86	1	07	130	Leugny	448	4	452
54	Poitou-Charentes	86	2	14	131	Lhommaizé	829	15	844
54	Poitou-Charentes	86	2	26	132	Liglet	298	7	305
54	Poitou-Charentes	86	3	35	133	Ligugé	3062	68	3130
54	Poitou-Charentes	86	2	05	134	Linazay	211	4	215
54	Poitou-Charentes	86	3	24	135	Liniers	531	15	546
54	Poitou-Charentes	86	2	05	136	Lizant	469	5	474
54	Poitou-Charentes	86	1	12	137	Loudun	6989	311	7300
54	Poitou-Charentes	86	2	09	138	Luchapt	284	6	290
54	Poitou-Charentes	86	3	13	139	Lusignan	2625	45	2670
54	Poitou-Charentes	86	2	14	140	Lussac-les-Châteaux	2346	79	2425
54	Poitou-Charentes	86	2	08	141	Magné	631	12	643
54	Poitou-Charentes	86	3	30	142	Maillé	590	7	597
54	Poitou-Charentes	86	1	20	143	Mairé	171	5	176
54	Poitou-Charentes	86	3	15	144	Maisonneuve	299	5	304
54	Poitou-Charentes	86	3	19	146	Marigny-Brizay	1173	17	1190
54	Poitou-Charentes	86	3	29	147	Marigny-Chemereau	553	13	566
54	Poitou-Charentes	86	3	29	148	Marnay	631	16	647
54	Poitou-Charentes	86	1	16	149	Martaizé	386	9	395
54	Poitou-Charentes	86	3	29	145	Marçay	935	24	959
54	Poitou-Charentes	86	3	15	150	Massognes	283	4	287
54	Poitou-Charentes	86	1	12	151	Maulay	195	3	198
54	Poitou-Charentes	86	2	01	152	Mauprévoir	678	14	692
54	Poitou-Charentes	86	2	14	153	Mazerolles	785	27	812
54	Poitou-Charentes	86	1	16	154	Mazeuil	233	8	241
54	Poitou-Charentes	86	1	12	156	Messemé	222	1	223
54	Poitou-Charentes	86	3	33	157	Mignaloux-Beauvoir	3973	214	4187
54	Poitou-Charentes	86	3	21	158	Migné-Auxances	6053	118	6171
54	Poitou-Charentes	86	2	09	159	Millac	508	16	524
54	Poitou-Charentes	86	3	15	160	Mirebeau	2175	40	2215
54	Poitou-Charentes	86	1	16	161	Moncontour	1012	21	1033
54	Poitou-Charentes	86	1	10	162	Mondion	133	3	136
54	Poitou-Charentes	86	3	37	163	Montamisé	3217	57	3274
54	Poitou-Charentes	86	1	31	164	Monthoiron	679	6	685
54	Poitou-Charentes	86	2	17	165	Montmorillon	6387	408	6795
54	Poitou-Charentes	86	3	30	166	Montreuil-Bonnin	651	17	668
54	Poitou-Charentes	86	1	18	167	Monts-sur-Guesnes	704	12	716
54	Poitou-Charentes	86	1	27	169	Morton	372	4	376
54	Poitou-Charentes	86	2	17	170	Moulismes	413	10	423
54	Poitou-Charentes	86	2	09	171	Moussac	484	21	505
54	Poitou-Charentes	86	1	12	173	Mouterre-Silly	712	17	729
54	Poitou-Charentes	86	2	09	172	Mouterre-sur-Blourde	177	2	179
54	Poitou-Charentes	86	1	32	174	Naintré	5830	149	5979
54	Poitou-Charentes	86	2	25	175	Nalliers	300	3	303
54	Poitou-Charentes	86	2	09	176	Nérignac	146	3	149
54	Poitou-Charentes	86	3	19	177	Neuville-de-Poitou	5119	88	5207
54	Poitou-Charentes	86	3	28	178	Nieuil-l;Espoir	2354	47	2401
54	Poitou-Charentes	86	3	28	180	Nouaillé-Maupertuis	2761	75	2836
54	Poitou-Charentes	86	1	18	181	Nueil-sous-Faye	252	8	260
54	Poitou-Charentes	86	1	11	182	Orches	394	5	399
54	Poitou-Charentes	86	1	07	183	Les Ormes	1640	32	1672
54	Poitou-Charentes	86	1	11	184	Ouzilly	871	13	884
54	Poitou-Charentes	86	1	07	186	Oyré	979	24	1003
54	Poitou-Charentes	86	2	04	187	Paizay-le-Sec	455	8	463
54	Poitou-Charentes	86	2	06	188	Payré	1008	52	1060
54	Poitou-Charentes	86	2	02	189	Payroux	502	12	514
54	Poitou-Charentes	86	2	14	190	Persac	860	38	898
54	Poitou-Charentes	86	2	17	191	Pindray	255	6	261
54	Poitou-Charentes	86	2	17	192	Plaisance	184	2	186
54	Poitou-Charentes	86	1	20	193	Pleumartin	1211	13	1224
54	Poitou-Charentes	86	3	99	194	Poitiers	87697	2689	90386
54	Poitou-Charentes	86	1	07	195	Port-de-Piles	545	9	554
54	Poitou-Charentes	86	1	18	197	Pouant	403	14	417
54	Poitou-Charentes	86	1	27	196	Pouançay	241	5	246
54	Poitou-Charentes	86	3	24	198	Pouillé	629	8	637
54	Poitou-Charentes	86	2	01	200	Pressac	629	5	634
54	Poitou-Charentes	86	1	18	201	Prinçay	236	3	239
54	Poitou-Charentes	86	1	20	202	La Puye	583	6	589
54	Poitou-Charentes	86	2	09	203	Queaux	588	20	608
54	Poitou-Charentes	86	3	30	204	Quinçay	2138	56	2194
54	Poitou-Charentes	86	1	27	205	Ranton	189	3	192
54	Poitou-Charentes	86	1	27	206	Raslay	118	2	120
54	Poitou-Charentes	86	1	20	207	La Roche-Posay	1559	49	1608
54	Poitou-Charentes	86	1	12	079	La Roche-Rigault	535	39	574
54	Poitou-Charentes	86	3	30	208	Le Rochereau	730	17	747
54	Poitou-Charentes	86	3	28	209	Roches-Prémarie-Andillé	1816	32	1848
54	Poitou-Charentes	86	1	27	210	Roiffé	693	4	697
54	Poitou-Charentes	86	2	06	211	Romagne	855	128	983
54	Poitou-Charentes	86	3	13	213	Rouillé	2530	181	2711
54	Poitou-Charentes	86	3	34	214	Saint-Benoît	6991	253	7244
54	Poitou-Charentes	86	1	10	217	Saint-Christophe	356	6	362
54	Poitou-Charentes	86	1	16	218	Saint-Clair	204	4	208
54	Poitou-Charentes	86	3	23	219	Saint-Cyr	1026	9	1035
54	Poitou-Charentes	86	2	05	220	Saint-Gaudent	297	12	309
54	Poitou-Charentes	86	1	11	221	Saint-Genest-d;Ambière	1236	21	1257
54	Poitou-Charentes	86	3	23	222	Saint-Georges-lès-Baillargeaux	3993	58	4051
54	Poitou-Charentes	86	2	25	223	Saint-Germain	1002	22	1024
54	Poitou-Charentes	86	1	10	224	Saint-Gervais-les-Trois-Clochers	1315	21	1336
54	Poitou-Charentes	86	1	16	225	Saint-Jean-de-Sauves	1329	20	1349
54	Poitou-Charentes	86	3	24	226	Saint-Julien-l;Ars	2395	43	2438
54	Poitou-Charentes	86	1	12	227	Saint-Laon	125	6	131
54	Poitou-Charentes	86	2	14	228	Saint-Laurent-de-Jourdes	170	1	171
54	Poitou-Charentes	86	1	27	229	Saint-Léger-de-Montbrillais	389	6	395
54	Poitou-Charentes	86	2	26	230	Saint-Léomer	182	4	186
54	Poitou-Charentes	86	2	05	231	Saint-Macoux	485	11	496
54	Poitou-Charentes	86	2	01	234	Saint-Martin-l;Ars	402	4	406
54	Poitou-Charentes	86	2	08	235	Saint-Maurice-la-Clouère	1200	34	1234
54	Poitou-Charentes	86	2	05	237	Saint-Pierre-d;Exideuil	812	39	851
54	Poitou-Charentes	86	2	25	236	Saint-Pierre-de-Maillé	909	14	923
54	Poitou-Charentes	86	1	07	241	Saint-Rémy-sur-Creuse	403	8	411
54	Poitou-Charentes	86	2	02	242	Saint-Romain	422	6	428
54	Poitou-Charentes	86	3	13	244	Saint-Sauvant	1316	21	1337
54	Poitou-Charentes	86	1	03	245	Saint-Sauveur	1063	17	1080
54	Poitou-Charentes	86	2	25	246	Saint-Savin	893	22	915
54	Poitou-Charentes	86	2	05	247	Saint-Saviol	497	6	503
54	Poitou-Charentes	86	2	08	248	Saint-Secondin	552	7	559
54	Poitou-Charentes	86	2	04	239	Sainte-Radégonde	148	0	148
54	Poitou-Charentes	86	1	18	249	Saires	142	3	145
54	Poitou-Charentes	86	1	27	250	Saix	248	3	251
54	Poitou-Charentes	86	1	12	252	Sammarçolles	625	14	639
54	Poitou-Charentes	86	3	13	253	Sanxay	541	16	557
54	Poitou-Charentes	86	2	17	254	Saulgé	965	25	990
54	Poitou-Charentes	86	2	05	255	Savigné	1329	35	1364
54	Poitou-Charentes	86	3	24	256	Savigny-Lévescault	1066	30	1096
54	Poitou-Charentes	86	1	11	257	Savigny-sous-Faye	343	6	349
54	Poitou-Charentes	86	1	11	258	Scorbé-Clairvaux	2346	40	2386
54	Poitou-Charentes	86	1	32	259	Senillé	701	16	717
54	Poitou-Charentes	86	1	10	260	Sérigny	289	3	292
54	Poitou-Charentes	86	3	24	261	Sèvres-Anxaumont	1907	104	2011
54	Poitou-Charentes	86	2	14	262	Sillars	625	22	647
54	Poitou-Charentes	86	3	28	263	Smarves	2535	41	2576
54	Poitou-Charentes	86	2	08	264	Sommières-du-Clain	804	14	818
54	Poitou-Charentes	86	1	11	265	Sossais	446	7	453
54	Poitou-Charentes	86	2	02	266	Surin	123	1	124
54	Poitou-Charentes	86	3	24	268	Tercé	1073	20	1093
54	Poitou-Charentes	86	1	27	269	Ternay	180	6	186
54	Poitou-Charentes	86	2	26	270	Thollet	170	3	173
54	Poitou-Charentes	86	3	15	271	Thurageau	823	17	840
54	Poitou-Charentes	86	1	38	272	Thuré	2870	142	3012
54	Poitou-Charentes	86	2	26	273	La Trimouille	971	12	983
54	Poitou-Charentes	86	1	27	274	Les Trois-Moutiers	1067	16	1083
54	Poitou-Charentes	86	1	10	275	Usseau	652	14	666
54	Poitou-Charentes	86	2	08	276	Usson-du-Poitou	1309	22	1331
54	Poitou-Charentes	86	2	04	233	Valdivienne	2562	36	2598
54	Poitou-Charentes	86	3	15	277	Varennes	367	8	375
54	Poitou-Charentes	86	2	06	278	Vaux	738	9	747
54	Poitou-Charentes	86	1	10	279	Vaux-sur-Vienne	600	13	613
54	Poitou-Charentes	86	1	10	280	Vellèches	388	13	401
54	Poitou-Charentes	86	3	19	281	Vendeuvre-du-Poitou	3019	50	3069
54	Poitou-Charentes	86	3	28	284	Vernon	623	9	632
54	Poitou-Charentes	86	2	14	285	Verrières	928	30	958
54	Poitou-Charentes	86	1	18	286	Verrue	377	3	380
54	Poitou-Charentes	86	1	27	287	Vézières	353	12	365
54	Poitou-Charentes	86	1	20	288	Vicq-sur-Gartempe	696	7	703
54	Poitou-Charentes	86	2	09	289	Le Vigeant	669	30	699
54	Poitou-Charentes	86	3	28	290	La Villedieu-du-Clain	1542	25	1567
54	Poitou-Charentes	86	2	25	291	Villemort	111	1	112
54	Poitou-Charentes	86	3	19	292	Villiers	824	6	830
54	Poitou-Charentes	86	3	29	293	Vivonne	3776	55	3831
54	Poitou-Charentes	86	3	30	294	Vouillé	3581	56	3637
54	Poitou-Charentes	86	2	05	295	Voulême	376	7	383
54	Poitou-Charentes	86	2	06	296	Voulon	399	6	405
54	Poitou-Charentes	86	3	35	297	Vouneuil-sous-Biard	5095	126	5221
54	Poitou-Charentes	86	1	31	298	Vouneuil-sur-Vienne	1988	54	2042
54	Poitou-Charentes	86	3	15	299	Vouzailles	551	7	558
54	Poitou-Charentes	86	3	19	300	Yversay	287	5	292
74	Limousin	87	2	01	001	Aixe-sur-Vienne	5472	72	5544
74	Limousin	87	2	02	002	Ambazac	5542	74	5616
74	Limousin	87	1	28	003	Arnac-la-Poste	1021	14	1035
74	Limousin	87	2	09	004	Augne	109	3	112
74	Limousin	87	2	37	005	Aureil	927	12	939
74	Limousin	87	1	08	006	Azat-le-Ris	263	0	263
74	Limousin	87	1	07	007	Balledent	211	0	211
74	Limousin	87	1	08	008	La Bazeuge	154	0	154
74	Limousin	87	2	09	009	Beaumont-du-Lac	160	2	162
74	Limousin	87	1	03	011	Bellac	4317	226	4543
74	Limousin	87	1	17	012	Berneuil	420	7	427
74	Limousin	87	2	10	013	Bersac-sur-Rivalier	622	13	635
74	Limousin	87	1	04	014	Bessines-sur-Gartempe	2818	48	2866
74	Limousin	87	2	01	015	Beynac	626	76	702
74	Limousin	87	2	02	016	Les Billanges	307	3	310
74	Limousin	87	1	03	017	Blanzac	485	12	497
74	Limousin	87	1	03	018	Blond	747	40	787
74	Limousin	87	2	21	019	Boisseuil	2688	94	2782
74	Limousin	87	2	02	020	Bonnac-la-Côte	1566	24	1590
74	Limousin	87	2	01	021	Bosmie-l;Aiguille	2335	49	2384
74	Limousin	87	1	17	022	Breuilaufa	151	3	154
74	Limousin	87	1	17	023	Le Buis	198	3	201
74	Limousin	87	2	09	024	Bujaleuf	874	24	898
74	Limousin	87	2	01	025	Burgnac	781	10	791
74	Limousin	87	1	16	026	Bussière-Boffy	357	8	365
74	Limousin	87	2	05	027	Bussière-Galant	1395	27	1422
74	Limousin	87	1	16	028	Bussière-Poitevine	928	12	940
74	Limousin	87	2	05	029	Les Cars	598	6	604
74	Limousin	87	3	38	030	Chaillac-sur-Vienne	1133	27	1160
74	Limousin	87	2	29	031	Le Chalard	305	4	309
74	Limousin	87	2	05	032	Châlus	1628	75	1703
74	Limousin	87	1	17	033	Chamboret	772	20	792
74	Limousin	87	3	20	034	Champagnac-la-Rivière	560	12	572
74	Limousin	87	2	26	035	Champnétery	562	11	573
74	Limousin	87	3	20	036	Champsac	614	9	623
74	Limousin	87	3	27	037	La Chapelle-Montbrandeix	249	5	254
74	Limousin	87	2	19	038	Chaptelat	1817	34	1851
74	Limousin	87	2	23	039	Château-Chervix	785	19	804
74	Limousin	87	2	06	040	Châteauneuf-la-Forêt	1640	37	1677
74	Limousin	87	1	07	041	Châteauponsac	2160	45	2205
74	Limousin	87	2	26	042	Le Châtenet-en-Dognon	420	18	438
74	Limousin	87	2	09	043	Cheissoux	188	10	198
74	Limousin	87	3	22	044	Chéronnac	325	10	335
74	Limousin	87	1	17	045	Cieux	962	15	977
74	Limousin	87	3	25	046	Cognac-la-Forêt	1026	61	1087
74	Limousin	87	1	17	047	Compreignac	1730	28	1758
74	Limousin	87	2	36	048	Condat-sur-Vienne	4692	89	4781
74	Limousin	87	2	29	049	Coussac-Bonneval	1338	41	1379
74	Limousin	87	2	33	050	Couzeix	8259	214	8473
74	Limousin	87	2	06	051	La Croisille-sur-Briance	708	19	727
74	Limousin	87	1	08	052	La Croix-sur-Gartempe	184	3	187
74	Limousin	87	1	28	053	Cromac	264	2	266
74	Limousin	87	3	20	054	Cussac	1203	68	1271
74	Limousin	87	1	08	055	Darnac	376	5	381
74	Limousin	87	1	08	056	Dinsac	258	4	262
74	Limousin	87	1	15	057	Dompierre-les-Églises	373	9	382
74	Limousin	87	2	09	058	Domps	122	2	124
74	Limousin	87	1	08	059	Le Dorat	1757	141	1898
74	Limousin	87	3	27	060	Dournazac	665	9	674
74	Limousin	87	1	15	061	Droux	444	10	454
74	Limousin	87	2	26	062	Eybouleuf	408	4	412
74	Limousin	87	2	21	063	Eyjeaux	1193	33	1226
74	Limousin	87	2	09	064	Eymoutiers	2041	35	2076
74	Limousin	87	2	37	065	Feytiat	5981	118	6099
74	Limousin	87	2	05	066	Flavignac	1040	16	1056
74	Limousin	87	1	04	067	Folles	524	6	530
74	Limousin	87	1	04	068	Fromental	518	6	524
74	Limousin	87	1	16	069	Gajoubert	172	1	173
74	Limousin	87	2	26	070	La Geneytouse	815	30	845
74	Limousin	87	2	29	071	Glandon	803	15	818
74	Limousin	87	2	23	072	Glanges	527	9	536
74	Limousin	87	3	25	073	Gorre	395	17	412
74	Limousin	87	1	28	074	Les Grands-Chézeaux	254	9	263
74	Limousin	87	2	31	075	Isle	7534	169	7703
74	Limousin	87	2	10	076	Jabreilles-les-Bordes	270	3	273
74	Limousin	87	2	18	077	Janailhac	477	12	489
74	Limousin	87	3	24	078	Javerdat	644	6	650
74	Limousin	87	2	10	079	La Jonchère-Saint-Maurice	802	16	818
74	Limousin	87	1	28	080	Jouac	200	5	205
74	Limousin	87	2	01	081	Jourgnac	1030	24	1054
74	Limousin	87	2	29	082	Ladignac-le-Long	1128	12	1140
74	Limousin	87	2	10	083	Laurière	573	3	576
74	Limousin	87	2	05	084	Lavignac	149	4	153
74	Limousin	87	2	99	085	Limoges	139150	2390	141540
74	Limousin	87	2	06	086	Linards	1094	75	1169
74	Limousin	87	1	28	087	Lussac-les-Églises	490	15	505
74	Limousin	87	2	23	088	Magnac-Bourg	1086	17	1103
74	Limousin	87	1	15	089	Magnac-Laval	1810	156	1966
74	Limousin	87	1	28	090	Mailhac-sur-Benaize	310	2	312
74	Limousin	87	3	27	091	Maisonnais-sur-Tardoire	442	8	450
74	Limousin	87	3	27	092	Marval	584	12	596
74	Limousin	87	2	06	093	Masléon	349	4	353
74	Limousin	87	2	18	094	Meilhac	512	8	520
74	Limousin	87	2	23	095	Meuzac	739	16	755
74	Limousin	87	2	18	096	La Meyze	846	20	866
74	Limousin	87	1	16	097	Mézières-sur-Issoire	860	27	887
74	Limousin	87	2	26	099	Moissannes	361	13	374
74	Limousin	87	1	16	100	Montrol-Sénard	246	6	252
74	Limousin	87	1	16	101	Mortemart	116	3	119
74	Limousin	87	1	17	103	Nantiat	1595	52	1647
74	Limousin	87	2	09	104	Nedde	522	15	537
74	Limousin	87	2	06	105	Neuvic-Entier	939	15	954
74	Limousin	87	2	18	106	Nexon	2474	27	2501
74	Limousin	87	2	19	107	Nieul	1608	18	1626
74	Limousin	87	1	16	108	Nouic	526	11	537
74	Limousin	87	1	08	109	Oradour-Saint-Genest	387	52	439
74	Limousin	87	3	24	110	Oradour-sur-Glane	2246	31	2277
74	Limousin	87	3	20	111	Oradour-sur-Vayres	1518	38	1556
74	Limousin	87	2	05	112	Pageas	603	17	620
74	Limousin	87	2	35	113	Le Palais-sur-Vienne	5986	123	6109
74	Limousin	87	2	37	114	Panazol	10392	235	10627
74	Limousin	87	3	27	115	Pensol	184	0	184
74	Limousin	87	1	03	116	Peyrat-de-Bellac	1124	35	1159
74	Limousin	87	2	09	117	Peyrat-le-Château	983	14	997
74	Limousin	87	2	19	118	Peyrilhac	1200	18	1218
74	Limousin	87	2	21	119	Pierre-Buffière	1150	14	1164
74	Limousin	87	2	23	120	La Porcherie	605	16	621
74	Limousin	87	1	07	121	Rancon	528	12	540
74	Limousin	87	1	04	122	Razès	1108	14	1122
74	Limousin	87	2	09	123	Rempnat	151	3	154
74	Limousin	87	2	18	124	Rilhac-Lastours	353	5	358
74	Limousin	87	2	02	125	Rilhac-Rancon	4227	71	4298
74	Limousin	87	2	18	127	La Roche-l;Abeille	607	7	614
74	Limousin	87	3	22	126	Rochechouart	3796	134	3930
74	Limousin	87	1	17	128	Roussac	475	17	492
74	Limousin	87	2	26	129	Royères	826	18	844
74	Limousin	87	2	06	130	Roziers-Saint-Georges	187	3	190
74	Limousin	87	3	38	131	Saillat-sur-Vienne	807	15	822
74	Limousin	87	2	09	132	Saint-Amand-le-Petit	113	4	117
74	Limousin	87	1	07	133	Saint-Amand-Magnazeix	547	14	561
74	Limousin	87	3	25	135	Saint-Auvent	939	17	956
74	Limousin	87	1	16	136	Saint-Barbant	363	8	371
74	Limousin	87	3	20	137	Saint-Bazile	142	8	150
74	Limousin	87	2	21	138	Saint-Bonnet-Briance	561	15	576
74	Limousin	87	1	03	139	Saint-Bonnet-de-Bellac	535	10	545
74	Limousin	87	3	24	140	Saint-Brice-sur-Vienne	1565	34	1599
74	Limousin	87	3	25	141	Saint-Cyr	722	13	735
74	Limousin	87	2	26	142	Saint-Denis-des-Murs	525	9	534
74	Limousin	87	2	19	143	Saint-Gence	2019	43	2062
74	Limousin	87	2	21	144	Saint-Genest-sur-Roselle	474	11	485
74	Limousin	87	1	28	145	Saint-Georges-les-Landes	249	7	256
74	Limousin	87	2	23	146	Saint-Germain-les-Belles	1157	26	1183
74	Limousin	87	2	06	147	Saint-Gilles-les-Forêts	54	3	57
74	Limousin	87	2	21	148	Saint-Hilaire-Bonneval	894	30	924
74	Limousin	87	1	15	149	Saint-Hilaire-la-Treille	409	11	420
74	Limousin	87	2	18	150	Saint-Hilaire-les-Places	878	11	889
74	Limousin	87	2	21	151	Saint-Jean-Ligoure	418	4	422
74	Limousin	87	2	19	152	Saint-Jouvent	1633	28	1661
74	Limousin	87	2	09	153	Saint-Julien-le-Petit	299	5	304
74	Limousin	87	3	98	154	Saint-Junien	11455	376	11831
74	Limousin	87	1	03	155	Saint-Junien-les-Combes	186	9	195
74	Limousin	87	2	37	156	Saint-Just-le-Martel	2487	50	2537
74	Limousin	87	2	02	157	Saint-Laurent-les-Églises	851	36	887
74	Limousin	87	3	25	158	Saint-Laurent-sur-Gorre	1393	93	1486
74	Limousin	87	2	10	159	Saint-Léger-la-Montagne	306	7	313
74	Limousin	87	1	15	160	Saint-Léger-Magnazeix	515	9	524
74	Limousin	87	2	26	161	Saint-Léonard-de-Noblat	4640	110	4750
74	Limousin	87	1	16	163	Saint-Martial-sur-Isop	138	2	140
74	Limousin	87	3	24	164	Saint-Martin-de-Jussac	518	9	527
74	Limousin	87	1	28	165	Saint-Martin-le-Mault	114	0	114
74	Limousin	87	2	01	166	Saint-Martin-le-Vieux	870	16	886
74	Limousin	87	2	26	167	Saint-Martin-Terressus	552	8	560
74	Limousin	87	3	27	168	Saint-Mathieu	1160	16	1176
74	Limousin	87	2	18	169	Saint-Maurice-les-Brousses	965	10	975
74	Limousin	87	2	06	170	Saint-Méard	382	3	385
74	Limousin	87	1	08	172	Saint-Ouen-sur-Gartempe	225	7	232
74	Limousin	87	1	04	173	Saint-Pardoux	540	16	556
74	Limousin	87	2	21	174	Saint-Paul	1251	22	1273
74	Limousin	87	2	18	176	Saint-Priest-Ligoure	658	6	664
74	Limousin	87	2	01	177	Saint-Priest-sous-Aixe	1591	32	1623
74	Limousin	87	2	02	178	Saint-Priest-Taurion	2784	67	2851
74	Limousin	87	1	08	179	Saint-Sornin-la-Marche	270	7	277
74	Limousin	87	1	07	180	Saint-Sornin-Leulac	652	10	662
74	Limousin	87	2	10	181	Saint-Sulpice-Laurière	866	23	889
74	Limousin	87	1	28	182	Saint-Sulpice-les-Feuilles	1213	26	1239
74	Limousin	87	2	02	183	Saint-Sylvestre	898	8	906
74	Limousin	87	1	17	184	Saint-Symphorien-sur-Couze	227	3	230
74	Limousin	87	3	24	185	Saint-Victurnien	1686	87	1773
74	Limousin	87	2	23	186	Saint-Vitte-sur-Briance	347	3	350
74	Limousin	87	2	29	187	Saint-Yrieix-la-Perche	6910	400	7310
74	Limousin	87	2	01	188	Saint-Yrieix-sous-Aixe	408	8	416
74	Limousin	87	2	09	134	Sainte-Anne-Saint-Priest	143	2	145
74	Limousin	87	3	25	162	Sainte-Marie-de-Vaux	191	3	194
74	Limousin	87	3	22	189	Les Salles-Lavauguyon	173	3	176
74	Limousin	87	2	26	190	Sauviat-sur-Vige	935	25	960
74	Limousin	87	2	01	191	Séreilhac	1836	22	1858
74	Limousin	87	2	36	192	Solignac	1506	30	1536
74	Limousin	87	2	06	193	Surdoux	42	0	42
74	Limousin	87	2	06	194	Sussac	352	6	358
74	Limousin	87	1	08	195	Tersannes	157	3	160
74	Limousin	87	1	08	196	Thiat	170	5	175
74	Limousin	87	1	17	197	Thouron	510	1	511
74	Limousin	87	1	17	198	Vaulry	406	6	412
74	Limousin	87	3	22	199	Vayres	827	83	910
74	Limousin	87	1	08	200	Verneuil-Moustiers	147	3	150
74	Limousin	87	2	01	201	Verneuil-sur-Vienne	4347	223	4570
74	Limousin	87	2	19	202	Veyrac	1992	36	2028
74	Limousin	87	2	23	203	Vicq-sur-Breuilh	1303	28	1331
74	Limousin	87	3	22	204	Videix	225	2	227
74	Limousin	87	2	36	205	Le Vigen	2049	38	2087
74	Limousin	87	1	15	206	Villefavard	155	8	163
41	Lorraine	88	1	11	001	Les Ableuvenettes	67	0	67
41	Lorraine	88	1	11	002	Ahéville	59	1	60
41	Lorraine	88	2	04	003	Aingeville	74	1	75
41	Lorraine	88	2	15	004	Ainvelle	163	4	167
41	Lorraine	88	3	22	005	Allarmont	234	7	241
41	Lorraine	88	2	16	006	Ambacourt	290	11	301
41	Lorraine	88	1	17	007	Ameuvelle	59	0	59
41	Lorraine	88	1	21	008	Anglemont	168	5	173
41	Lorraine	88	3	13	009	Anould	3349	94	3443
41	Lorraine	88	2	07	010	Aouze	200	5	205
41	Lorraine	88	1	12	011	Arches	1690	96	1786
41	Lorraine	88	1	12	012	Archettes	1080	18	1098
41	Lorraine	88	2	07	013	Aroffe	99	0	99
41	Lorraine	88	3	08	014	Arrentès-de-Corcieux	166	4	170
41	Lorraine	88	2	18	015	Attignéville	213	10	223
41	Lorraine	88	1	10	016	Attigny	259	5	264
41	Lorraine	88	2	04	017	Aulnois	150	4	154
41	Lorraine	88	3	08	018	Aumontzey	506	3	509
41	Lorraine	88	2	09	019	Autigny-la-Tour	186	2	188
41	Lorraine	88	2	09	020	Autreville	162	2	164
41	Lorraine	88	1	21	021	Autrey	306	9	315
41	Lorraine	88	2	04	022	Auzainvilliers	216	9	225
41	Lorraine	88	1	05	023	Avillers	90	2	92
41	Lorraine	88	1	05	024	Avrainville	101	2	103
41	Lorraine	88	2	09	025	Avranville	89	2	91
41	Lorraine	88	1	03	026	Aydoilles	1065	38	1103
41	Lorraine	88	1	06	027	Badménil-aux-Bois	132	4	136
41	Lorraine	88	1	12	028	La Baffe	633	79	712
41	Lorraine	88	1	01	029	Bains-les-Bains	1277	119	1396
41	Lorraine	88	1	11	030	Bainville-aux-Saules	126	7	133
41	Lorraine	88	2	07	031	Balléville	114	2	116
41	Lorraine	88	3	24	032	Ban-de-Laveline	1305	20	1325
41	Lorraine	88	3	26	033	Ban-de-Sapt	346	9	355
41	Lorraine	88	3	13	106	Ban-sur-Meurthe-Clefcy	952	36	988
41	Lorraine	88	3	08	035	Barbey-Seroux	141	3	144
41	Lorraine	88	2	18	036	Barville	89	3	92
41	Lorraine	88	1	25	037	Basse-sur-le-Rupt	884	30	914
41	Lorraine	88	1	05	038	Battexey	31	2	33
41	Lorraine	88	2	16	039	Baudricourt	311	7	318
41	Lorraine	88	1	06	040	Bayecourt	286	4	290
41	Lorraine	88	1	11	041	Bazegney	109	2	111
41	Lorraine	88	1	21	042	Bazien	92	1	93
41	Lorraine	88	2	28	043	Bazoilles-et-Ménil	111	4	115
41	Lorraine	88	2	18	044	Bazoilles-sur-Meuse	595	22	617
41	Lorraine	88	2	18	045	Beaufremont	70	1	71
41	Lorraine	88	1	03	046	Beauménil	125	1	126
41	Lorraine	88	1	11	047	Begnécourt	172	9	181
41	Lorraine	88	1	19	048	Bellefontaine	1012	25	1037
41	Lorraine	88	1	10	049	Belmont-lès-Darney	122	2	124
41	Lorraine	88	3	02	050	Belmont-sur-Buttant	284	4	288
41	Lorraine	88	2	04	051	Belmont-sur-Vair	115	2	117
41	Lorraine	88	1	10	052	Belrupt	107	4	111
41	Lorraine	88	3	26	053	Belval	180	3	183
41	Lorraine	88	3	24	054	Bertrimoutier	358	12	370
41	Lorraine	88	1	11	055	Bettegney-Saint-Brice	141	0	141
41	Lorraine	88	1	05	056	Bettoncourt	91	1	92
41	Lorraine	88	3	20	057	Le Beulay	112	0	112
41	Lorraine	88	2	16	058	Biécourt	87	2	89
41	Lorraine	88	3	02	059	Biffontaine	446	4	450
41	Lorraine	88	2	16	060	Blémerey	17	1	18
41	Lorraine	88	1	17	061	Bleurville	349	6	355
41	Lorraine	88	2	15	062	Blevaincourt	104	4	108
41	Lorraine	88	1	11	063	Bocquegney	129	3	132
41	Lorraine	88	3	02	064	Bois-de-Champ	115	1	116
41	Lorraine	88	1	10	065	Bonvillet	341	8	349
41	Lorraine	88	2	16	066	Boulaincourt	70	1	71
41	Lorraine	88	3	31	068	La Bourgonce	858	13	871
41	Lorraine	88	1	11	069	Bouxières-aux-Bois	123	2	125
41	Lorraine	88	1	05	070	Bouxurulles	149	6	155
41	Lorraine	88	1	11	071	Bouzemont	57	0	57
41	Lorraine	88	1	05	073	Brantigny	192	1	193
41	Lorraine	88	2	18	074	Brechainville	46	1	47
41	Lorraine	88	1	25	075	La Bresse	4605	201	4806
41	Lorraine	88	3	02	076	Brouvelieures	489	13	502
41	Lorraine	88	1	21	077	Brû	585	13	598
41	Lorraine	88	1	03	078	Bruyères	3248	47	3295
41	Lorraine	88	2	04	079	Bulgnéville	1436	95	1531
41	Lorraine	88	1	21	080	Bult	312	10	322
41	Lorraine	88	1	27	081	Bussang	1565	30	1595
41	Lorraine	88	3	22	082	Celles-sur-Plaine	857	18	875
41	Lorraine	88	2	18	083	Certilleux	226	8	234
41	Lorraine	88	1	05	084	Chamagne	464	6	470
41	Lorraine	88	1	03	086	Champ-le-Duc	525	11	536
41	Lorraine	88	3	08	085	Champdray	158	5	163
41	Lorraine	88	1	30	087	Chantraine	3143	134	3277
41	Lorraine	88	1	29	088	La Chapelle-aux-Bois	668	18	686
41	Lorraine	88	3	08	089	La Chapelle-devant-Bruyères	620	10	630
41	Lorraine	88	1	05	090	Charmes	4627	77	4704
41	Lorraine	88	1	03	091	Charmois-devant-Bruyères	414	16	430
41	Lorraine	88	1	29	092	Charmois-l;Orgueilleux	600	9	609
41	Lorraine	88	3	26	093	Châtas	55	2	57
41	Lorraine	88	1	06	094	Châtel-sur-Moselle	1645	64	1709
41	Lorraine	88	2	07	095	Châtenois	1774	38	1812
41	Lorraine	88	2	15	096	Châtillon-sur-Saône	145	2	147
41	Lorraine	88	2	16	097	Chauffecourt	36	0	36
41	Lorraine	88	1	30	098	Chaumousey	864	28	892
41	Lorraine	88	1	06	099	Chavelot	1500	48	1548
41	Lorraine	88	2	16	100	Chef-Haut	46	3	49
41	Lorraine	88	1	03	101	Cheniménil	1135	34	1169
41	Lorraine	88	2	09	102	Chermisey	97	1	98
41	Lorraine	88	1	11	103	Circourt	86	1	87
41	Lorraine	88	2	18	104	Circourt-sur-Mouzon	220	7	227
41	Lorraine	88	1	17	105	Claudon	199	6	205
41	Lorraine	88	2	09	107	Clérey-la-Côte	35	2	37
41	Lorraine	88	1	29	108	Le Clerjus	582	14	596
41	Lorraine	88	1	23	109	Cleurie	629	22	651
41	Lorraine	88	1	21	110	Clézentaine	220	9	229
41	Lorraine	88	3	24	111	Coinches	350	10	360
41	Lorraine	88	3	20	112	Colroy-la-Grande	551	10	561
41	Lorraine	88	3	24	113	Combrimont	166	7	173
41	Lorraine	88	2	28	114	Contrexéville	3389	219	3608
41	Lorraine	88	3	08	115	Corcieux	1666	27	1693
41	Lorraine	88	1	25	116	Cornimont	3546	69	3615
41	Lorraine	88	2	07	117	Courcelles-sous-Châtenois	86	2	88
41	Lorraine	88	2	09	118	Coussey	718	21	739
41	Lorraine	88	2	04	119	Crainvilliers	182	0	182
41	Lorraine	88	3	13	120	La Croix-aux-Mines	547	9	556
41	Lorraine	88	1	06	121	Damas-aux-Bois	268	3	271
41	Lorraine	88	1	11	122	Damas-et-Bettegney	366	9	375
41	Lorraine	88	2	15	123	Damblain	263	6	269
41	Lorraine	88	1	10	124	Darney	1221	72	1293
41	Lorraine	88	2	07	125	Darney-aux-Chênes	68	3	71
41	Lorraine	88	1	30	126	Darnieulles	1478	24	1502
41	Lorraine	88	1	21	127	Deinvillers	64	2	66
41	Lorraine	88	3	26	128	Denipaire	258	6	264
41	Lorraine	88	1	11	129	Derbamont	91	3	94
41	Lorraine	88	1	03	130	Destord	227	6	233
41	Lorraine	88	1	03	131	Deycimont	294	3	297
41	Lorraine	88	1	12	132	Deyvillers	1511	47	1558
41	Lorraine	88	1	12	133	Dignonville	184	6	190
41	Lorraine	88	1	12	134	Dinozé	544	16	560
41	Lorraine	88	1	03	135	Docelles	970	27	997
41	Lorraine	88	1	12	136	Dogneville	1424	49	1473
41	Lorraine	88	2	07	137	Dolaincourt	85	4	89
41	Lorraine	88	1	10	138	Dombasle-devant-Darney	89	3	92
41	Lorraine	88	2	16	139	Dombasle-en-Xaintois	120	2	122
41	Lorraine	88	2	28	140	Dombrot-le-Sec	382	9	391
41	Lorraine	88	2	04	141	Dombrot-sur-Vair	253	5	258
41	Lorraine	88	2	28	144	Domèvre-sous-Montfort	63	3	66
41	Lorraine	88	1	30	142	Domèvre-sur-Avière	428	17	445
41	Lorraine	88	1	06	143	Domèvre-sur-Durbion	266	14	280
41	Lorraine	88	3	02	145	Domfaing	244	2	246
41	Lorraine	88	2	28	146	Domjulien	194	5	199
41	Lorraine	88	1	30	147	Dommartin-aux-Bois	421	9	430
41	Lorraine	88	1	23	148	Dommartin-lès-Remiremont	1836	65	1901
41	Lorraine	88	1	10	149	Dommartin-lès-Vallois	55	5	60
41	Lorraine	88	2	07	150	Dommartin-sur-Vraine	320	5	325
41	Lorraine	88	1	11	151	Dompaire	1101	27	1128
41	Lorraine	88	1	03	152	Dompierre	282	4	286
41	Lorraine	88	1	21	153	Domptail	336	11	347
41	Lorraine	88	2	09	154	Domrémy-la-Pucelle	150	2	152
41	Lorraine	88	2	16	155	Domvallier	125	2	127
41	Lorraine	88	1	21	156	Doncières	148	1	149
41	Lorraine	88	1	29	157	Dounoux	830	15	845
41	Lorraine	88	1	23	158	Éloyes	3272	85	3357
41	Lorraine	88	3	13	159	Entre-deux-Eaux	501	15	516
41	Lorraine	88	1	99	160	Épinal	32842	1733	34575
41	Lorraine	88	1	10	161	Escles	443	8	451
41	Lorraine	88	1	10	162	Esley	172	8	180
41	Lorraine	88	1	05	163	Essegney	691	8	699
41	Lorraine	88	2	28	164	Estrennes	92	3	95
41	Lorraine	88	3	22	165	Étival-Clairefontaine	2515	53	2568
41	Lorraine	88	1	05	166	Évaux-et-Ménil	351	3	354
41	Lorraine	88	1	23	167	Faucompierre	231	7	238
41	Lorraine	88	1	21	168	Fauconcourt	122	1	123
41	Lorraine	88	1	03	169	Fays	242	10	252
41	Lorraine	88	1	27	170	Ferdrupt	763	21	784
41	Lorraine	88	1	17	171	Fignévelle	59	1	60
41	Lorraine	88	1	03	172	Fiménil	263	6	269
41	Lorraine	88	1	05	173	Florémont	427	5	432
41	Lorraine	88	1	30	174	Fomerey	152	5	157
41	Lorraine	88	1	03	175	Fontenay	503	8	511
41	Lorraine	88	1	01	176	Fontenoy-le-Château	623	45	668
41	Lorraine	88	1	23	177	La Forge	568	13	581
41	Lorraine	88	1	30	178	Les Forges	1996	67	2063
41	Lorraine	88	2	15	179	Fouchécourt	46	0	46
41	Lorraine	88	2	15	180	Frain	144	3	147
41	Lorraine	88	3	13	181	Fraize	3059	48	3107
41	Lorraine	88	3	24	182	Frapelle	221	8	229
41	Lorraine	88	2	09	183	Frebécourt	304	14	318
41	Lorraine	88	3	02	184	Fremifontaine	469	8	477
41	Lorraine	88	2	16	185	Frenelle-la-Grande	129	10	139
41	Lorraine	88	2	16	186	Frenelle-la-Petite	51	1	52
41	Lorraine	88	1	10	187	Frénois	44	0	44
41	Lorraine	88	1	27	188	Fresse-sur-Moselle	1839	60	1899
41	Lorraine	88	2	18	189	Fréville	136	5	141
41	Lorraine	88	1	06	190	Frizon	456	4	460
41	Lorraine	88	1	11	192	Gelvécourt-et-Adompt	85	4	89
41	Lorraine	88	3	24	193	Gemaingoutte	119	6	125
41	Lorraine	88	2	28	194	Gemmelaincourt	161	6	167
41	Lorraine	88	2	04	195	Gendreville	116	2	118
41	Lorraine	88	3	14	196	Gérardmer	8755	632	9387
41	Lorraine	88	1	25	197	Gerbamont	373	9	382
41	Lorraine	88	3	08	198	Gerbépal	555	14	569
41	Lorraine	88	1	17	199	Gignéville	69	1	70
41	Lorraine	88	1	06	200	Gigney	60	0	60
41	Lorraine	88	1	30	201	Girancourt	851	26	877
41	Lorraine	88	1	05	202	Gircourt-lès-Viéville	171	4	175
41	Lorraine	88	1	03	203	Girecourt-sur-Durbion	303	5	308
41	Lorraine	88	1	06	204	Girmont	971	33	1004
41	Lorraine	88	1	19	205	Girmont-Val-d;Ajol	231	11	242
41	Lorraine	88	2	07	206	Gironcourt-sur-Vraine	982	22	1004
41	Lorraine	88	1	17	208	Godoncourt	131	6	137
41	Lorraine	88	1	30	209	Golbey	8230	135	8365
41	Lorraine	88	1	11	210	Gorhey	165	0	165
41	Lorraine	88	2	18	212	Grand	441	11	452
41	Lorraine	88	3	20	213	La Grande-Fosse	113	3	116
41	Lorraine	88	3	26	215	Grandrupt	92	5	97
41	Lorraine	88	1	01	214	Grandrupt-de-Bains	86	2	88
41	Lorraine	88	1	03	216	Grandvillers	693	24	717
41	Lorraine	88	3	08	218	Granges-sur-Vologne	2301	45	2346
41	Lorraine	88	2	09	219	Greux	168	7	175
41	Lorraine	88	2	15	220	Grignoncourt	46	0	46
41	Lorraine	88	1	01	221	Gruey-lès-Surance	251	6	257
41	Lorraine	88	1	03	222	Gugnécourt	200	15	215
41	Lorraine	88	1	11	223	Gugney-aux-Aulx	154	7	161
41	Lorraine	88	1	06	224	Hadigny-les-Verrières	383	10	393
41	Lorraine	88	1	29	225	Hadol	2281	141	2422
41	Lorraine	88	1	11	226	Hagécourt	115	3	118
41	Lorraine	88	2	04	227	Hagnéville-et-Roncourt	82	1	83
41	Lorraine	88	1	06	228	Haillainville	171	3	174
41	Lorraine	88	2	18	229	Harchéchamp	101	3	104
41	Lorraine	88	1	21	230	Hardancourt	42	2	44
41	Lorraine	88	2	28	231	Haréville	535	13	548
41	Lorraine	88	2	09	232	Harmonville	226	7	233
41	Lorraine	88	1	11	233	Harol	590	66	656
41	Lorraine	88	1	01	234	Harsault	410	10	420
41	Lorraine	88	1	01	235	Hautmougey	159	5	164
41	Lorraine	88	1	01	236	La Haye	141	3	144
41	Lorraine	88	1	11	237	Hennecourt	348	9	357
41	Lorraine	88	1	10	238	Hennezel	424	10	434
41	Lorraine	88	1	05	239	Hergugney	135	4	139
41	Lorraine	88	3	08	240	Herpelmont	249	3	252
41	Lorraine	88	2	07	241	Houécourt	429	7	436
41	Lorraine	88	2	18	242	Houéville	42	1	43
41	Lorraine	88	1	21	243	Housseras	483	15	498
41	Lorraine	88	3	08	244	La Houssière	571	8	579
41	Lorraine	88	3	26	245	Hurbache	305	8	313
41	Lorraine	88	2	16	246	Hymont	480	16	496
41	Lorraine	88	1	06	247	Igney	1162	32	1194
41	Lorraine	88	2	15	248	Isches	184	8	192
41	Lorraine	88	2	18	249	Jainvillotte	87	1	88
41	Lorraine	88	1	23	250	Jarménil	423	10	433
41	Lorraine	88	1	21	251	Jeanménil	1084	54	1138
41	Lorraine	88	1	10	252	Jésonville	130	5	135
41	Lorraine	88	1	12	253	Jeuxey	675	26	701
41	Lorraine	88	1	11	254	Jorxey	94	2	96
41	Lorraine	88	2	09	255	Jubainville	84	3	87
41	Lorraine	88	3	08	256	Jussarupt	288	8	296
41	Lorraine	88	2	16	257	Juvaincourt	188	0	188
41	Lorraine	88	2	15	258	Lamarche	1037	26	1063
41	Lorraine	88	2	18	259	Landaville	301	12	313
41	Lorraine	88	1	05	260	Langley	192	0	192
41	Lorraine	88	1	03	261	Laval-sur-Vologne	640	17	657
41	Lorraine	88	1	03	262	Laveline-devant-Bruyères	649	5	654
41	Lorraine	88	1	03	263	Laveline-du-Houx	221	6	227
41	Lorraine	88	1	11	264	Légéville-et-Bonfays	54	0	54
41	Lorraine	88	2	18	265	Lemmecourt	29	0	29
41	Lorraine	88	1	03	266	Lépanges-sur-Vologne	925	16	941
41	Lorraine	88	1	10	267	Lerrain	479	17	496
41	Lorraine	88	3	24	268	Lesseux	160	5	165
41	Lorraine	88	3	14	269	Liézey	282	8	290
41	Lorraine	88	2	18	270	Liffol-le-Grand	2384	60	2444
41	Lorraine	88	2	28	271	Lignéville	308	11	319
41	Lorraine	88	2	15	272	Lironcourt	71	5	76
41	Lorraine	88	1	12	273	Longchamp	410	18	428
41	Lorraine	88	2	07	274	Longchamp-sous-Châtenois	92	8	100
41	Lorraine	88	3	20	275	Lubine	244	5	249
41	Lorraine	88	3	20	276	Lusse	451	8	459
41	Lorraine	88	3	22	277	Luvigny	119	2	121
41	Lorraine	88	2	07	278	Maconcourt	91	2	93
41	Lorraine	88	2	16	279	Madecourt	59	1	60
41	Lorraine	88	1	11	280	Madegney	89	2	91
41	Lorraine	88	1	11	281	Madonne-et-Lamerey	397	19	416
41	Lorraine	88	1	01	282	Le Magny	40	2	42
41	Lorraine	88	2	04	283	Malaincourt	91	3	94
41	Lorraine	88	3	13	284	Mandray	627	17	644
41	Lorraine	88	2	04	285	Mandres-sur-Vair	427	54	481
41	Lorraine	88	1	05	286	Marainville-sur-Madon	83	5	88
41	Lorraine	88	2	15	287	Marey	66	1	67
41	Lorraine	88	1	11	288	Maroncourt	10	0	10
41	Lorraine	88	2	15	289	Martigny-les-Bains	845	76	921
41	Lorraine	88	2	09	290	Martigny-les-Gerbonvaux	120	1	121
41	Lorraine	88	1	17	291	Martinvelle	126	7	133
41	Lorraine	88	2	16	292	Mattaincourt	850	21	871
41	Lorraine	88	2	09	293	Maxey-sur-Meuse	258	10	268
41	Lorraine	88	1	06	294	Mazeley	261	4	265
41	Lorraine	88	2	16	295	Mazirot	221	5	226
41	Lorraine	88	2	04	296	Médonville	68	5	73
41	Lorraine	88	1	03	297	Méménil	155	3	158
41	Lorraine	88	1	21	298	Ménarmont	54	0	54
41	Lorraine	88	1	27	302	Le Ménil	1149	33	1182
41	Lorraine	88	3	26	300	Ménil-de-Senones	149	1	150
41	Lorraine	88	2	16	299	Ménil-en-Xaintois	169	3	172
41	Lorraine	88	1	21	301	Ménil-sur-Belvitte	310	12	322
41	Lorraine	88	2	09	303	Midrevaux	205	3	208
41	Lorraine	88	2	16	304	Mirecourt	5848	486	6334
41	Lorraine	88	2	09	305	Moncel-sur-Vair	218	16	234
41	Lorraine	88	3	26	306	Le Mont	52	1	53
41	Lorraine	88	2	15	307	Mont-lès-Lamarche	101	5	106
41	Lorraine	88	2	18	308	Mont-lès-Neufchâteau	281	10	291
41	Lorraine	88	2	28	309	Monthureux-le-Sec	165	3	168
41	Lorraine	88	1	17	310	Monthureux-sur-Saône	936	17	953
41	Lorraine	88	1	01	311	Montmotier	55	1	56
41	Lorraine	88	2	07	312	Morelmaison	197	8	205
41	Lorraine	88	1	06	313	Moriville	433	6	439
41	Lorraine	88	2	15	314	Morizécourt	123	4	127
41	Lorraine	88	3	02	315	Mortagne	165	6	171
41	Lorraine	88	2	04	316	Morville	54	4	58
41	Lorraine	88	3	26	317	Moussey	669	14	683
41	Lorraine	88	1	21	318	Moyemont	222	5	227
41	Lorraine	88	3	26	319	Moyenmoutier	3284	63	3347
41	Lorraine	88	3	24	320	Nayemont-les-Fosses	891	41	932
41	Lorraine	88	2	18	321	Neufchâteau	6881	321	7202
41	Lorraine	88	1	03	322	La Neuveville-devant-Lépanges	459	4	463
41	Lorraine	88	2	07	324	La Neuveville-sous-Châtenois	374	8	382
41	Lorraine	88	2	28	325	La Neuveville-sous-Montfort	175	3	178
41	Lorraine	88	3	24	326	Neuvillers-sur-Fave	337	7	344
41	Lorraine	88	1	06	327	Nomexy	2220	26	2246
41	Lorraine	88	3	22	328	Nompatelize	563	16	579
41	Lorraine	88	1	17	330	Nonville	223	6	229
41	Lorraine	88	1	03	331	Nonzeville	44	1	45
41	Lorraine	88	2	04	332	Norroy	236	5	241
41	Lorraine	88	1	21	333	Nossoncourt	97	2	99
41	Lorraine	88	2	16	334	Oëlleville	286	6	292
41	Lorraine	88	2	28	335	Offroicourt	155	3	158
41	Lorraine	88	2	07	336	Ollainville	69	2	71
41	Lorraine	88	1	06	337	Oncourt	175	8	183
41	Lorraine	88	1	21	338	Ortoncourt	82	2	84
41	Lorraine	88	1	03	340	Padoux	502	14	516
41	Lorraine	88	3	24	341	Pair-et-Grandrupt	517	13	530
41	Lorraine	88	1	06	342	Pallegney	160	3	163
41	Lorraine	88	2	04	343	Parey-sous-Montfort	137	13	150
41	Lorraine	88	2	18	344	Pargny-sous-Mureau	192	5	197
41	Lorraine	88	3	20	345	La Petite-Fosse	91	5	96
41	Lorraine	88	3	26	346	La Petite-Raon	844	20	864
41	Lorraine	88	1	10	347	Pierrefitte	99	3	102
41	Lorraine	88	1	03	348	Pierrepont-sur-l;Arentèle	155	4	159
41	Lorraine	88	3	13	349	Plainfaing	1835	35	1870
41	Lorraine	88	2	07	350	Pleuvezain	84	0	84
41	Lorraine	88	1	19	351	Plombières-les-Bains	1824	40	1864
41	Lorraine	88	2	18	352	Pompierre	243	12	255
41	Lorraine	88	1	10	353	Pont-lès-Bonfays	88	3	91
41	Lorraine	88	1	05	354	Pont-sur-Madon	159	4	163
41	Lorraine	88	1	05	355	Portieux	1334	11	1345
41	Lorraine	88	3	02	356	Les Poulières	252	1	253
41	Lorraine	88	2	16	357	Poussay	715	16	731
41	Lorraine	88	1	23	358	Pouxeux	1980	46	2026
41	Lorraine	88	1	03	359	Prey	94	4	98
41	Lorraine	88	1	10	360	Provenchères-lès-Darney	172	3	175
41	Lorraine	88	3	20	361	Provenchères-sur-Fave	896	25	921
41	Lorraine	88	3	26	362	Le Puid	97	6	103
41	Lorraine	88	2	09	363	Punerot	190	7	197
41	Lorraine	88	2	16	364	Puzieux	161	1	162
41	Lorraine	88	1	11	365	Racécourt	145	4	149
41	Lorraine	88	2	07	366	Rainville	291	10	301
41	Lorraine	88	1	21	367	Rambervillers	5595	192	5787
41	Lorraine	88	2	16	368	Ramecourt	166	7	173
41	Lorraine	88	1	27	369	Ramonchamp	1989	133	2122
41	Lorraine	88	2	28	370	Rancourt	61	4	65
41	Lorraine	88	1	23	371	Raon-aux-Bois	1212	26	1238
41	Lorraine	88	3	22	372	Raon-l;Étape	6528	193	6721
41	Lorraine	88	3	22	373	Raon-sur-Plaine	159	5	164
41	Lorraine	88	1	05	374	Rapey	16	2	18
41	Lorraine	88	3	24	375	Raves	442	10	452
41	Lorraine	88	2	18	376	Rebeuville	247	14	261
41	Lorraine	88	1	17	377	Regnévelle	144	2	146
41	Lorraine	88	1	11	378	Regney	94	0	94
41	Lorraine	88	1	06	379	Rehaincourt	338	9	347
41	Lorraine	88	3	08	380	Rehaupal	195	6	201
41	Lorraine	88	1	10	381	Relanges	216	7	223
41	Lorraine	88	2	16	382	Remicourt	75	0	75
41	Lorraine	88	1	23	383	Remiremont	8024	355	8379
41	Lorraine	88	3	24	386	Remomeix	458	15	473
41	Lorraine	88	2	28	385	Remoncourt	596	10	606
41	Lorraine	88	2	07	387	Removille	201	9	210
41	Lorraine	88	1	30	388	Renauvoid	120	5	125
41	Lorraine	88	2	16	389	Repel	63	2	65
41	Lorraine	88	2	15	390	Robécourt	117	4	121
41	Lorraine	88	1	25	391	Rochesson	702	18	720
41	Lorraine	88	2	15	392	Rocourt	27	0	27
41	Lorraine	88	2	18	393	Rollainville	322	13	335
41	Lorraine	88	2	15	394	Romain-aux-Bois	46	0	46
41	Lorraine	88	1	21	395	Romont	343	14	357
41	Lorraine	88	3	02	398	Les Rouges-Eaux	81	0	81
41	Lorraine	88	1	03	399	Le Roulier	202	6	208
41	Lorraine	88	2	16	400	Rouvres-en-Xaintois	289	5	294
41	Lorraine	88	2	07	401	Rouvres-la-Chétive	439	17	456
41	Lorraine	88	1	21	402	Roville-aux-Chênes	418	201	619
41	Lorraine	88	2	28	403	Rozerotte	197	7	204
41	Lorraine	88	2	15	404	Rozières-sur-Mouzon	85	0	85
41	Lorraine	88	1	05	406	Rugney	109	2	111
41	Lorraine	88	2	09	407	Ruppes	121	11	132
41	Lorraine	88	1	27	408	Rupt-sur-Moselle	3543	82	3625
41	Lorraine	88	1	23	409	Saint-Amé	2156	61	2217
41	Lorraine	88	1	10	411	Saint-Baslemont	86	1	87
41	Lorraine	88	1	21	412	Saint-Benoît-la-Chipotte	429	10	439
41	Lorraine	88	3	98	413	Saint-Dié-des-Vosges	21447	778	22225
41	Lorraine	88	1	23	415	Saint-Étienne-lès-Remiremont	3891	99	3990
41	Lorraine	88	1	21	416	Saint-Genest	123	4	127
41	Lorraine	88	1	21	417	Saint-Gorgon	390	10	400
41	Lorraine	88	3	26	419	Saint-Jean-d;Ormont	148	1	149
41	Lorraine	88	2	15	421	Saint-Julien	133	5	138
41	Lorraine	88	3	13	423	Saint-Léonard	1383	26	1409
41	Lorraine	88	1	21	425	Saint-Maurice-sur-Mortagne	183	11	194
41	Lorraine	88	1	27	426	Saint-Maurice-sur-Moselle	1492	29	1521
41	Lorraine	88	2	16	427	Saint-Menge	120	2	122
41	Lorraine	88	3	31	428	Saint-Michel-sur-Meurthe	2023	68	2091
41	Lorraine	88	1	23	429	Saint-Nabord	4090	231	4321
41	Lorraine	88	2	04	430	Saint-Ouen-lès-Parey	490	3	493
41	Lorraine	88	2	07	431	Saint-Paul	134	4	138
41	Lorraine	88	1	21	432	Saint-Pierremont	158	1	159
41	Lorraine	88	2	16	433	Saint-Prancher	75	2	77
41	Lorraine	88	2	04	434	Saint-Remimont	218	8	226
41	Lorraine	88	3	22	435	Saint-Remy	516	14	530
41	Lorraine	88	3	26	436	Saint-Stail	72	3	75
41	Lorraine	88	1	11	437	Saint-Vallier	105	1	106
41	Lorraine	88	1	21	410	Sainte-Barbe	278	7	285
41	Lorraine	88	1	03	418	Sainte-Hélène	470	15	485
41	Lorraine	88	3	24	424	Sainte-Marguerite	2447	63	2510
41	Lorraine	88	3	31	438	La Salle	437	8	445
41	Lorraine	88	1	30	439	Sanchey	804	25	829
41	Lorraine	88	2	07	440	Sandaucourt	207	2	209
41	Lorraine	88	1	10	441	Sans-Vallois	122	6	128
41	Lorraine	88	1	25	442	Sapois	648	16	664
41	Lorraine	88	2	18	443	Sartes	99	4	103
41	Lorraine	88	3	26	444	Le Saulcy	321	15	336
41	Lorraine	88	3	24	445	Saulcy-sur-Meurthe	2406	64	2470
41	Lorraine	88	2	04	446	Saulxures-lès-Bulgnéville	256	4	260
41	Lorraine	88	1	25	447	Saulxures-sur-Moselotte	2748	140	2888
41	Lorraine	88	2	04	448	Sauville	195	5	200
41	Lorraine	88	1	05	449	Savigny	190	8	198
41	Lorraine	88	2	15	450	Senaide	188	8	196
41	Lorraine	88	3	26	451	Senones	2627	56	2683
41	Lorraine	88	1	10	452	Senonges	142	3	145
41	Lorraine	88	2	09	453	Seraumont	49	0	49
41	Lorraine	88	1	06	454	Sercoeur	262	3	265
41	Lorraine	88	2	15	455	Serécourt	118	3	121
41	Lorraine	88	2	15	456	Serocourt	101	1	102
41	Lorraine	88	2	09	457	Sionne	141	6	147
41	Lorraine	88	1	05	458	Socourt	251	3	254
41	Lorraine	88	2	07	459	Soncourt	54	1	55
41	Lorraine	88	2	09	460	Soulosse-sous-Saint-Élophe	617	10	627
41	Lorraine	88	2	04	461	Suriauville	207	2	209
41	Lorraine	88	1	23	462	Le Syndicat	1907	64	1971
41	Lorraine	88	3	31	463	Taintrux	1572	38	1610
41	Lorraine	88	1	23	464	Tendon	517	18	535
41	Lorraine	88	1	06	465	Thaon-les-Vosges	7989	210	8199
41	Lorraine	88	2	28	466	They-sous-Montfort	150	2	152
41	Lorraine	88	1	25	467	Thiéfosse	576	24	600
41	Lorraine	88	1	27	468	Le Thillot	3664	76	3740
41	Lorraine	88	2	16	469	Thiraucourt	104	4	108
41	Lorraine	88	1	23	470	Le Tholy	1581	32	1613
41	Lorraine	88	2	15	471	Les Thons	122	3	125
41	Lorraine	88	2	28	472	Thuillières	149	1	150
41	Lorraine	88	2	15	473	Tignécourt	115	3	118
41	Lorraine	88	2	18	474	Tilleux	79	2	81
41	Lorraine	88	2	15	475	Tollaincourt	100	2	102
41	Lorraine	88	2	16	476	Totainville	132	3	135
41	Lorraine	88	2	18	477	Trampot	104	1	105
41	Lorraine	88	2	09	478	Tranqueville-Graux	84	1	85
41	Lorraine	88	1	01	479	Trémonzey	223	3	226
41	Lorraine	88	1	05	480	Ubexy	168	4	172
41	Lorraine	88	1	29	481	Uriménil	1362	28	1390
41	Lorraine	88	2	04	482	Urville	66	1	67
41	Lorraine	88	1	30	483	Uxegney	2186	72	2258
41	Lorraine	88	1	29	484	Uzemain	1133	30	1163
41	Lorraine	88	2	04	485	La Vacheresse-et-la-Rouillie	126	3	129
41	Lorraine	88	1	25	486	Vagney	4011	133	4144
41	Lorraine	88	1	19	487	Le Val-d;Ajol	4032	158	4190
41	Lorraine	88	2	28	488	Valfroicourt	247	13	260
41	Lorraine	88	2	16	489	Valleroy-aux-Saules	271	2	273
41	Lorraine	88	2	28	490	Valleroy-le-Sec	157	6	163
41	Lorraine	88	1	10	491	Les Vallois	111	3	114
41	Lorraine	88	3	13	492	Le Valtin	90	1	91
41	Lorraine	88	1	05	493	Varmonzey	27	2	29
41	Lorraine	88	1	11	494	Vaubexy	129	7	136
41	Lorraine	88	1	12	495	Vaudéville	167	7	174
41	Lorraine	88	2	04	496	Vaudoncourt	143	1	144
41	Lorraine	88	1	06	497	Vaxoncourt	506	6	512
41	Lorraine	88	1	23	498	Vecoux	958	30	988
41	Lorraine	88	1	11	499	Velotte-et-Tatignécourt	164	5	169
41	Lorraine	88	1	25	500	Ventron	927	20	947
41	Lorraine	88	3	26	501	Le Vermont	52	1	53
41	Lorraine	88	3	02	502	Vervezelle	143	12	155
41	Lorraine	88	3	22	503	Vexaincourt	193	2	195
41	Lorraine	88	2	07	504	Vicherey	168	7	175
41	Lorraine	88	3	08	505	Vienville	126	2	128
41	Lorraine	88	3	26	506	Vieux-Moulin	322	7	329
41	Lorraine	88	1	11	508	Ville-sur-Illon	516	9	525
41	Lorraine	88	2	16	507	Villers	224	12	236
41	Lorraine	88	1	06	509	Villoncourt	113	5	118
41	Lorraine	88	2	15	510	Villotte	164	7	171
41	Lorraine	88	2	18	511	Villouxel	85	0	85
41	Lorraine	88	1	03	512	Viménil	214	4	218
41	Lorraine	88	1	05	513	Vincey	2264	36	2300
41	Lorraine	88	2	07	514	Viocourt	149	1	150
41	Lorraine	88	1	01	515	Vioménil	138	5	143
41	Lorraine	88	2	28	516	Vittel	5452	162	5614
41	Lorraine	88	1	17	517	Viviers-le-Gras	178	2	180
41	Lorraine	88	2	28	518	Viviers-lès-Offroicourt	28	0	28
41	Lorraine	88	3	31	519	La Voivre	747	15	762
41	Lorraine	88	1	01	520	Les Voivres	347	9	356
41	Lorraine	88	1	21	521	Vomécourt	256	7	263
41	Lorraine	88	1	05	522	Vomécourt-sur-Madon	68	4	72
41	Lorraine	88	2	07	523	Vouxey	162	6	168
41	Lorraine	88	2	04	524	Vrécourt	346	6	352
41	Lorraine	88	2	16	525	Vroville	137	4	141
41	Lorraine	88	3	24	526	Wisembach	406	10	416
41	Lorraine	88	1	21	527	Xaffévillers	166	2	168
41	Lorraine	88	1	03	528	Xamontarupt	152	9	161
41	Lorraine	88	1	05	529	Xaronval	91	2	93
41	Lorraine	88	1	29	530	Xertigny	2770	48	2818
41	Lorraine	88	3	14	531	Xonrupt-Longemer	1569	55	1624
41	Lorraine	88	1	06	532	Zincourt	90	2	92
26	Bourgogne	89	1	34	001	Accolay	438	6	444
26	Bourgogne	89	1	09	002	Aigremont	72	3	75
26	Bourgogne	89	1	01	003	Aillant-sur-Tholon	1403	36	1439
26	Bourgogne	89	2	02	004	Aisy-sur-Armançon	265	3	268
26	Bourgogne	89	2	02	005	Ancy-le-Franc	994	28	1022
26	Bourgogne	89	2	02	006	Ancy-le-Libre	185	12	197
26	Bourgogne	89	1	13	007	Andryes	466	5	471
26	Bourgogne	89	2	18	008	Angely	147	2	149
26	Bourgogne	89	2	05	009	Annay-la-Côte	360	9	369
26	Bourgogne	89	2	21	010	Annay-sur-Serein	241	7	248
26	Bourgogne	89	2	05	011	Annéot	147	7	154
26	Bourgogne	89	2	18	012	Annoux	95	4	99
26	Bourgogne	89	1	41	013	Appoigny	3135	69	3204
26	Bourgogne	89	3	08	014	Arces-Dilo	610	9	619
26	Bourgogne	89	1	34	015	Arcy-sur-Cure	503	17	520
26	Bourgogne	89	2	02	016	Argentenay	99	3	102
26	Bourgogne	89	2	02	017	Argenteuil-sur-Armançon	245	6	251
26	Bourgogne	89	3	37	018	Armeau	753	22	775
26	Bourgogne	89	2	15	019	Arthonnay	163	4	167
26	Bourgogne	89	2	35	020	Asnières-sous-Bois	162	1	163
26	Bourgogne	89	2	35	021	Asquins	327	9	336
26	Bourgogne	89	2	18	022	Athie	147	2	149
26	Bourgogne	89	1	03	023	Augy	1050	98	1148
26	Bourgogne	89	1	98	024	Auxerre	36200	2048	38248
26	Bourgogne	89	2	05	025	Avallon	7248	347	7595
26	Bourgogne	89	3	36	027	Bagneaux	230	2	232
26	Bourgogne	89	2	15	028	Baon	83	2	85
26	Bourgogne	89	1	39	029	Bassou	780	30	810
26	Bourgogne	89	1	34	030	Bazarnes	407	10	417
26	Bourgogne	89	1	28	031	Beaumont	588	12	600
26	Bourgogne	89	2	23	032	Beauvilliers	97	4	101
26	Bourgogne	89	1	33	033	Beauvoir	344	19	363
26	Bourgogne	89	1	09	034	Beine	519	11	530
26	Bourgogne	89	1	07	035	Bellechaume	453	20	473
26	Bourgogne	89	3	11	036	La Belliole	256	6	262
26	Bourgogne	89	1	19	037	Béon	521	18	539
26	Bourgogne	89	2	16	038	Bernouil	122	2	124
26	Bourgogne	89	2	32	039	Béru	75	0	75
26	Bourgogne	89	1	34	040	Bessy-sur-Cure	176	3	179
26	Bourgogne	89	2	16	041	Beugnon	317	11	328
26	Bourgogne	89	2	17	042	Bierry-les-Belles-Fontaines	200	7	207
26	Bourgogne	89	2	18	043	Blacy	109	3	112
26	Bourgogne	89	2	35	044	Blannay	132	6	138
26	Bourgogne	89	1	03	045	Bleigny-le-Carreau	306	5	311
26	Bourgogne	89	1	06	046	Bléneau	1441	28	1469
26	Bourgogne	89	3	08	048	Boeurs-en-Othe	327	10	337
26	Bourgogne	89	1	34	049	Bois-d;Arcy	30	0	30
26	Bourgogne	89	1	39	050	Bonnard	933	12	945
26	Bourgogne	89	3	37	051	Les Bordes	531	8	539
26	Bourgogne	89	1	01	053	Branches	438	1	439
26	Bourgogne	89	3	11	054	Brannay	728	8	736
26	Bourgogne	89	1	07	055	Brienon-sur-Armançon	3140	70	3210
26	Bourgogne	89	1	39	056	Brion	602	22	624
26	Bourgogne	89	2	35	057	Brosses	292	2	294
26	Bourgogne	89	2	23	058	Bussières	129	8	137
26	Bourgogne	89	1	07	059	Bussy-en-Othe	758	17	775
26	Bourgogne	89	3	37	060	Bussy-le-Repos	406	11	417
26	Bourgogne	89	2	16	061	Butteaux	266	9	275
26	Bourgogne	89	2	16	062	Carisey	372	3	375
26	Bourgogne	89	3	26	063	La Celle-Saint-Cyr	804	13	817
26	Bourgogne	89	2	21	064	Censy	57	0	57
26	Bourgogne	89	3	08	065	Cérilly	40	2	42
26	Bourgogne	89	3	08	066	Cerisiers	994	24	1018
26	Bourgogne	89	1	19	067	Cézy	1125	17	1142
26	Bourgogne	89	1	09	068	Chablis	2338	94	2432
26	Bourgogne	89	1	07	069	Chailley	576	10	586
26	Bourgogne	89	1	10	070	Chambeugle	58	0	58
26	Bourgogne	89	2	35	071	Chamoux	88	1	89
26	Bourgogne	89	1	06	072	Champcevrais	336	2	338
26	Bourgogne	89	1	06	073	Champignelles	1039	48	1087
26	Bourgogne	89	3	22	074	Champigny	2188	33	2221
26	Bourgogne	89	1	19	075	Champlay	700	13	713
26	Bourgogne	89	1	07	076	Champlost	804	20	824
26	Bourgogne	89	1	03	077	Champs-sur-Yonne	1573	151	1724
26	Bourgogne	89	1	01	078	Champvallon	607	8	615
26	Bourgogne	89	1	19	079	Chamvres	676	23	699
26	Bourgogne	89	3	31	080	La Chapelle-sur-Oreuse	561	6	567
26	Bourgogne	89	1	20	081	La Chapelle-Vaupelteigne	97	7	104
26	Bourgogne	89	1	41	083	Charbuy	1746	46	1792
26	Bourgogne	89	1	12	084	Charentenay	309	4	313
26	Bourgogne	89	1	39	085	Charmoy	1173	19	1192
26	Bourgogne	89	1	10	086	Charny	1676	21	1697
26	Bourgogne	89	2	02	087	Chassignelles	323	14	337
26	Bourgogne	89	1	01	088	Chassy	473	14	487
26	Bourgogne	89	2	23	089	Chastellux-sur-Cure	154	2	156
26	Bourgogne	89	2	35	091	Châtel-Censoir	663	7	670
26	Bourgogne	89	2	21	092	Châtel-Gérard	251	13	264
26	Bourgogne	89	3	22	093	Chaumont	607	15	622
26	Bourgogne	89	3	37	094	Chaumot	693	10	703
26	Bourgogne	89	1	09	095	Chemilly-sur-Serein	175	3	178
26	Bourgogne	89	1	28	096	Chemilly-sur-Yonne	947	26	973
26	Bourgogne	89	1	10	097	Chêne-Arnoult	123	1	124
26	Bourgogne	89	2	32	098	Cheney	265	8	273
26	Bourgogne	89	1	28	099	Cheny	2469	53	2522
26	Bourgogne	89	3	11	100	Chéroy	1607	25	1632
26	Bourgogne	89	1	25	101	Chéu	542	17	559
26	Bourgogne	89	1	42	102	Chevannes	2314	88	2402
26	Bourgogne	89	1	10	103	Chevillon	309	6	315
26	Bourgogne	89	1	09	104	Chichée	349	18	367
26	Bourgogne	89	1	39	105	Chichery	470	13	483
26	Bourgogne	89	3	36	107	Chigy	286	4	290
26	Bourgogne	89	1	09	108	Chitry	359	8	367
26	Bourgogne	89	2	17	109	Cisery	53	2	55
26	Bourgogne	89	3	36	111	Les Clérimois	265	6	271
26	Bourgogne	89	2	32	112	Collan	189	1	190
26	Bourgogne	89	3	30	113	Collemiers	573	14	587
26	Bourgogne	89	3	31	115	Compigny	161	7	168
26	Bourgogne	89	3	30	116	Cornant	351	13	364
26	Bourgogne	89	1	12	117	Coulangeron	197	3	200
26	Bourgogne	89	1	12	118	Coulanges-la-Vineuse	932	18	950
26	Bourgogne	89	1	13	119	Coulanges-sur-Yonne	556	6	562
26	Bourgogne	89	3	08	120	Coulours	149	5	154
26	Bourgogne	89	3	36	122	Courgenay	562	9	571
26	Bourgogne	89	1	09	123	Courgis	260	13	273
26	Bourgogne	89	3	31	124	Courlon-sur-Yonne	1164	31	1195
26	Bourgogne	89	1	14	125	Courson-les-Carrières	859	15	874
26	Bourgogne	89	3	11	126	Courtoin	39	1	40
26	Bourgogne	89	3	30	127	Courtois-sur-Yonne	799	14	813
26	Bourgogne	89	2	18	128	Coutarnoux	100	4	104
26	Bourgogne	89	1	13	129	Crain	395	9	404
26	Bourgogne	89	1	34	130	Cravant	801	14	815
26	Bourgogne	89	2	15	131	Cruzy-le-Châtel	255	6	261
26	Bourgogne	89	2	02	132	Cry	185	4	189
26	Bourgogne	89	3	26	133	Cudot	351	7	358
26	Bourgogne	89	2	17	134	Cussy-les-Forges	337	7	344
26	Bourgogne	89	3	22	136	Cuy	767	16	783
26	Bourgogne	89	2	32	137	Dannemoine	422	28	450
26	Bourgogne	89	1	10	138	Dicy	328	6	334
26	Bourgogne	89	1	33	139	Diges	1151	33	1184
26	Bourgogne	89	2	18	141	Dissangis	143	4	147
26	Bourgogne	89	3	37	142	Dixmont	888	19	907
26	Bourgogne	89	3	11	143	Dollot	315	6	321
26	Bourgogne	89	3	11	144	Domats	837	15	852
26	Bourgogne	89	2	35	145	Domecy-sur-Cure	394	13	407
26	Bourgogne	89	2	05	146	Domecy-sur-le-Vault	99	1	100
26	Bourgogne	89	1	33	147	Dracy	238	7	245
26	Bourgogne	89	1	14	148	Druyes-les-Belles-Fontaines	299	4	303
26	Bourgogne	89	2	16	149	Dyé	195	6	201
26	Bourgogne	89	1	33	150	Égleny	456	8	464
26	Bourgogne	89	3	30	151	Égriselles-le-Bocage	1239	27	1266
26	Bourgogne	89	1	39	152	Épineau-les-Voves	702	20	722
26	Bourgogne	89	2	32	153	Épineuil	621	45	666
26	Bourgogne	89	1	12	154	Escamps	855	22	877
26	Bourgogne	89	1	12	155	Escolives-Sainte-Camille	731	22	753
26	Bourgogne	89	1	07	156	Esnon	407	8	415
26	Bourgogne	89	1	13	158	Étais-la-Sauvin	684	23	707
26	Bourgogne	89	2	05	159	Étaule	413	17	430
26	Bourgogne	89	3	30	160	Étigny	760	13	773
26	Bourgogne	89	2	21	161	Étivey	239	8	247
26	Bourgogne	89	3	22	162	Évry	367	10	377
26	Bourgogne	89	1	10	163	La Ferté-Loupière	557	10	567
26	Bourgogne	89	1	13	164	Festigny	79	4	83
26	Bourgogne	89	3	36	165	Flacy	125	3	128
26	Bourgogne	89	1	01	167	Fleury-la-Vallée	1117	37	1154
26	Bourgogne	89	2	32	168	Fleys	171	4	175
26	Bourgogne	89	2	16	169	Flogny-la-Chapelle	1033	31	1064
26	Bourgogne	89	2	35	170	Foissy-lès-Vézelay	144	2	146
26	Bourgogne	89	3	36	171	Foissy-sur-Vanne	291	9	300
26	Bourgogne	89	3	29	172	Fontaine-la-Gaillarde	505	16	521
26	Bourgogne	89	1	33	173	Fontaines	470	11	481
26	Bourgogne	89	1	14	174	Fontenailles	70	0	70
26	Bourgogne	89	1	09	175	Fontenay-près-Chablis	135	8	143
26	Bourgogne	89	2	35	176	Fontenay-près-Vézelay	150	1	151
26	Bourgogne	89	1	13	177	Fontenay-sous-Fouronnes	73	1	74
26	Bourgogne	89	1	10	178	Fontenouilles	221	3	224
26	Bourgogne	89	1	27	179	Fontenoy	317	7	324
26	Bourgogne	89	3	11	180	Fouchères	406	20	426
26	Bourgogne	89	3	08	181	Fournaudin	116	2	118
26	Bourgogne	89	1	14	182	Fouronnes	154	3	157
26	Bourgogne	89	2	21	183	Fresnes	73	2	75
26	Bourgogne	89	2	02	184	Fulvy	136	3	139
26	Bourgogne	89	1	25	186	Germigny	560	20	580
26	Bourgogne	89	2	15	187	Gigny	94	8	102
26	Bourgogne	89	2	05	188	Girolles	186	8	194
26	Bourgogne	89	3	22	189	Gisy-les-Nobles	603	15	618
26	Bourgogne	89	2	35	190	Givry	177	3	180
26	Bourgogne	89	2	15	191	Gland	51	2	53
26	Bourgogne	89	1	10	192	Grandchamp	369	9	378
26	Bourgogne	89	2	21	194	Grimault	117	1	118
26	Bourgogne	89	3	30	195	Gron	1206	92	1298
26	Bourgogne	89	1	01	196	Guerchy	634	40	674
26	Bourgogne	89	2	17	197	Guillon	464	5	469
26	Bourgogne	89	1	28	198	Gurgy	1646	44	1690
26	Bourgogne	89	1	12	199	Gy-l;Évêque	465	14	479
26	Bourgogne	89	1	28	200	Hauterive	418	11	429
26	Bourgogne	89	1	28	201	Héry	1883	64	1947
26	Bourgogne	89	1	12	202	Irancy	305	9	314
26	Bourgogne	89	2	05	203	Island	188	11	199
26	Bourgogne	89	2	18	204	L; Isle-sur-Serein	738	20	758
26	Bourgogne	89	1	25	205	Jaulges	452	9	461
26	Bourgogne	89	1	19	206	Joigny	10249	427	10676
26	Bourgogne	89	2	21	207	Jouancy	31	0	31
26	Bourgogne	89	2	18	208	Joux-la-Ville	1221	16	1237
26	Bourgogne	89	3	11	209	Jouy	487	15	502
26	Bourgogne	89	2	02	210	Jully	143	5	148
26	Bourgogne	89	2	32	211	Junay	99	2	101
26	Bourgogne	89	1	12	212	Jussy	437	19	456
26	Bourgogne	89	1	01	213	Laduz	310	2	312
26	Bourgogne	89	3	36	214	Lailly	207	5	212
26	Bourgogne	89	1	14	215	Lain	163	6	169
26	Bourgogne	89	1	27	216	Lainsecq	375	15	390
26	Bourgogne	89	1	33	217	Lalande	131	1	132
26	Bourgogne	89	1	39	218	Laroche-Saint-Cydroine	1348	51	1399
26	Bourgogne	89	2	16	219	Lasson	122	5	127
26	Bourgogne	89	1	24	220	Lavau	509	8	517
26	Bourgogne	89	1	33	221	Leugny	381	11	392
26	Bourgogne	89	1	33	222	Levis	246	3	249
26	Bourgogne	89	2	02	223	Lézinnes	745	15	760
26	Bourgogne	89	1	09	224	Lichères-près-Aigremont	173	6	179
26	Bourgogne	89	2	35	225	Lichères-sur-Yonne	58	1	59
26	Bourgogne	89	1	20	226	Lignorelles	184	8	192
26	Bourgogne	89	1	20	227	Ligny-le-Châtel	1344	29	1373
26	Bourgogne	89	1	33	228	Lindry	1301	41	1342
26	Bourgogne	89	3	22	229	Lixy	437	5	442
26	Bourgogne	89	1	19	230	Looze	469	10	479
26	Bourgogne	89	2	05	232	Lucy-le-Bois	307	22	329
26	Bourgogne	89	1	34	233	Lucy-sur-Cure	218	3	221
26	Bourgogne	89	1	13	234	Lucy-sur-Yonne	151	1	152
26	Bourgogne	89	2	05	235	Magny	820	35	855
26	Bourgogne	89	3	40	236	Maillot	1079	51	1130
26	Bourgogne	89	1	34	237	Mailly-la-Ville	558	10	568
26	Bourgogne	89	1	13	238	Mailly-le-Château	581	11	592
26	Bourgogne	89	3	40	239	Malay-le-Grand	1510	35	1545
26	Bourgogne	89	3	40	240	Malay-le-Petit	361	5	366
26	Bourgogne	89	1	10	241	Malicorne	161	5	166
26	Bourgogne	89	1	20	242	Maligny	772	24	796
26	Bourgogne	89	1	10	243	Marchais-Beton	120	3	123
26	Bourgogne	89	2	17	244	Marmeaux	81	1	82
26	Bourgogne	89	3	30	245	Marsangy	832	25	857
26	Bourgogne	89	2	18	246	Massangis	410	11	421
26	Bourgogne	89	2	15	247	Mélisey	301	6	307
26	Bourgogne	89	2	05	248	Menades	49	1	50
26	Bourgogne	89	1	07	249	Mercy	76	3	79
26	Bourgogne	89	1	20	250	Méré	180	9	189
26	Bourgogne	89	1	01	251	Merry-la-Vallée	411	17	428
26	Bourgogne	89	1	14	252	Merry-Sec	170	2	172
26	Bourgogne	89	1	13	253	Merry-sur-Yonne	214	0	214
26	Bourgogne	89	1	24	254	Mézilles	573	8	581
26	Bourgogne	89	3	22	255	Michery	1036	11	1047
26	Bourgogne	89	1	12	256	Migé	447	5	452
26	Bourgogne	89	1	39	257	Migennes	7243	136	7379
26	Bourgogne	89	2	21	259	Môlay	111	1	112
26	Bourgogne	89	1	14	260	Molesmes	185	4	189
26	Bourgogne	89	3	36	261	Molinons	262	11	273
26	Bourgogne	89	2	32	262	Molosmes	213	2	215
26	Bourgogne	89	1	95	263	Monéteau	3820	111	3931
26	Bourgogne	89	1	28	268	Mont-Saint-Sulpice	788	19	807
26	Bourgogne	89	3	11	264	Montacher-Villegardin	781	19	800
26	Bourgogne	89	1	20	265	Montigny-la-Resle	601	20	621
26	Bourgogne	89	2	35	266	Montillot	280	2	282
26	Bourgogne	89	2	17	267	Montréal	194	8	202
26	Bourgogne	89	1	14	270	Mouffy	125	0	125
26	Bourgogne	89	2	21	271	Moulins-en-Tonnerrois	112	5	117
26	Bourgogne	89	1	33	272	Moulins-sur-Ouanne	309	4	313
26	Bourgogne	89	1	27	273	Moutiers-en-Puisaye	282	5	287
26	Bourgogne	89	3	30	274	Nailly	1258	32	1290
26	Bourgogne	89	1	01	275	Neuilly	419	11	430
26	Bourgogne	89	2	16	276	Neuvy-Sautour	999	27	1026
26	Bourgogne	89	2	21	277	Nitry	367	9	376
26	Bourgogne	89	3	40	278	Noé	456	5	461
26	Bourgogne	89	2	21	279	Noyers	676	14	690
26	Bourgogne	89	2	02	280	Nuits	415	7	422
26	Bourgogne	89	1	01	281	Les Ormes	288	7	295
26	Bourgogne	89	1	28	282	Ormoy	680	30	710
26	Bourgogne	89	1	14	283	Ouanne	678	21	699
26	Bourgogne	89	2	02	284	Pacy-sur-Armançon	206	7	213
26	Bourgogne	89	3	31	285	Pailly	245	7	252
26	Bourgogne	89	1	33	286	Parly	798	14	812
26	Bourgogne	89	3	30	287	Paron	4404	134	4538
26	Bourgogne	89	1	07	288	Paroy-en-Othe	208	6	214
26	Bourgogne	89	1	19	289	Paroy-sur-Tholon	315	9	324
26	Bourgogne	89	2	21	290	Pasilly	51	0	51
26	Bourgogne	89	3	40	291	Passy	316	5	321
26	Bourgogne	89	3	31	469	Perceneige	945	20	965
26	Bourgogne	89	2	16	292	Percey	258	5	263
26	Bourgogne	89	1	10	294	Perreux	329	15	344
26	Bourgogne	89	1	41	295	Perrigny	1151	44	1195
26	Bourgogne	89	2	02	296	Perrigny-sur-Armançon	120	6	126
26	Bourgogne	89	2	35	297	Pierre-Perthuis	127	2	129
26	Bourgogne	89	3	37	298	Piffonds	591	9	600
26	Bourgogne	89	2	15	299	Pimelles	65	1	66
26	Bourgogne	89	2	17	300	Pisy	64	0	64
26	Bourgogne	89	3	31	302	Plessis-Saint-Jean	218	1	219
26	Bourgogne	89	2	21	303	Poilly-sur-Serein	281	5	286
26	Bourgogne	89	1	01	304	Poilly-sur-Tholon	708	12	720
26	Bourgogne	89	3	36	308	Pont-sur-Vanne	195	5	200
26	Bourgogne	89	3	22	309	Pont-sur-Yonne	3232	55	3287
26	Bourgogne	89	2	05	306	Pontaubert	389	10	399
26	Bourgogne	89	1	20	307	Pontigny	727	23	750
26	Bourgogne	89	3	36	310	La Postolle	152	4	156
26	Bourgogne	89	1	33	311	Pourrain	1447	47	1494
26	Bourgogne	89	2	18	312	Précy-le-Sec	285	3	288
26	Bourgogne	89	3	26	313	Précy-sur-Vrin	476	10	486
26	Bourgogne	89	1	34	314	Prégilbert	195	8	203
26	Bourgogne	89	1	09	315	Préhy	134	5	139
26	Bourgogne	89	2	18	316	Provency	217	10	227
26	Bourgogne	89	1	10	317	Prunoy	311	4	315
26	Bourgogne	89	2	23	318	Quarré-les-Tombes	723	14	737
26	Bourgogne	89	1	03	319	Quenne	458	10	468
26	Bourgogne	89	2	15	320	Quincerot	70	2	72
26	Bourgogne	89	2	02	321	Ravières	854	17	871
26	Bourgogne	89	2	16	323	Roffey	146	1	147
26	Bourgogne	89	1	06	324	Rogny-les-Sept-Écluses	736	22	758
26	Bourgogne	89	1	24	325	Ronchères	114	1	115
26	Bourgogne	89	3	40	326	Rosoy	1042	29	1071
26	Bourgogne	89	3	37	327	Rousson	410	12	422
26	Bourgogne	89	1	20	328	Rouvray	380	15	395
26	Bourgogne	89	2	15	329	Rugny	102	3	105
26	Bourgogne	89	1	34	330	Sacy	205	2	207
26	Bourgogne	89	1	27	331	Sainpuits	335	5	340
26	Bourgogne	89	3	22	332	Saint-Agnan	913	11	924
26	Bourgogne	89	2	17	333	Saint-André-en-Terre-Plaine	184	13	197
26	Bourgogne	89	1	01	334	Saint-Aubin-Château-Neuf	535	18	553
26	Bourgogne	89	1	19	335	Saint-Aubin-sur-Yonne	452	6	458
26	Bourgogne	89	2	23	336	Saint-Brancher	326	6	332
26	Bourgogne	89	1	03	337	Saint-Bris-le-Vineux	1107	29	1136
26	Bourgogne	89	3	29	338	Saint-Clément	2809	90	2899
26	Bourgogne	89	1	09	341	Saint-Cyr-les-Colons	421	5	426
26	Bourgogne	89	3	30	342	Saint-Denis	679	40	719
26	Bourgogne	89	1	10	343	Saint-Denis-sur-Ouanne	126	2	128
26	Bourgogne	89	1	24	344	Saint-Fargeau	1793	27	1820
26	Bourgogne	89	1	25	345	Saint-Florentin	4771	89	4860
26	Bourgogne	89	1	38	346	Saint-Georges-sur-Baulche	3447	138	3585
26	Bourgogne	89	2	23	347	Saint-Germain-des-Champs	390	9	399
26	Bourgogne	89	3	26	348	Saint-Julien-du-Sault	2364	63	2427
26	Bourgogne	89	2	23	349	Saint-Léger-Vauban	402	10	412
26	Bourgogne	89	3	26	350	Saint-Loup-d;Ordon	239	5	244
26	Bourgogne	89	3	26	353	Saint-Martin-d;Ordon	337	6	343
26	Bourgogne	89	1	24	352	Saint-Martin-des-Champs	272	7	279
26	Bourgogne	89	3	30	354	Saint-Martin-du-Tertre	1558	44	1602
26	Bourgogne	89	2	15	355	Saint-Martin-sur-Armançon	139	2	141
26	Bourgogne	89	1	01	356	Saint-Martin-sur-Ocre	58	1	59
26	Bourgogne	89	1	10	358	Saint-Martin-sur-Ouanne	444	12	456
26	Bourgogne	89	3	36	359	Saint-Maurice-aux-Riches-Hommes	455	1	456
26	Bourgogne	89	1	01	360	Saint-Maurice-le-Vieil	317	6	323
26	Bourgogne	89	1	01	361	Saint-Maurice-Thizouaille	248	3	251
26	Bourgogne	89	2	35	362	Saint-Moré	183	9	192
26	Bourgogne	89	2	35	364	Saint-Père	371	8	379
26	Bourgogne	89	1	06	365	Saint-Privé	559	9	568
26	Bourgogne	89	3	26	366	Saint-Romain-le-Preux	187	7	194
26	Bourgogne	89	1	27	368	Saint-Sauveur-en-Puisaye	941	9	950
26	Bourgogne	89	3	22	369	Saint-Sérotin	541	15	556
26	Bourgogne	89	3	11	370	Saint-Valérien	1668	23	1691
26	Bourgogne	89	2	18	339	Sainte-Colombe	193	3	196
26	Bourgogne	89	1	27	340	Sainte-Colombe-sur-Loing	179	7	186
26	Bourgogne	89	2	17	351	Sainte-Magnance	443	4	447
26	Bourgogne	89	1	34	363	Sainte-Pallaye	121	2	123
26	Bourgogne	89	2	21	371	Sainte-Vertu	105	2	107
26	Bourgogne	89	1	27	367	Saints	593	21	614
26	Bourgogne	89	3	29	373	Saligny	666	15	681
26	Bourgogne	89	2	02	374	Sambourg	92	8	100
26	Bourgogne	89	2	17	375	Santigny	108	2	110
26	Bourgogne	89	2	21	376	Sarry	164	9	173
26	Bourgogne	89	2	17	377	Sauvigny-le-Beuréal	62	0	62
26	Bourgogne	89	2	05	378	Sauvigny-le-Bois	778	18	796
26	Bourgogne	89	2	17	379	Savigny-en-Terre-Plaine	148	19	167
26	Bourgogne	89	3	11	380	Savigny-sur-Clairis	392	12	404
26	Bourgogne	89	2	17	381	Sceaux	135	3	138
26	Bourgogne	89	1	28	382	Seignelay	1587	34	1621
26	Bourgogne	89	1	14	383	Sementron	117	2	119
26	Bourgogne	89	1	01	384	Senan	756	18	774
26	Bourgogne	89	2	15	385	Sennevoy-le-Bas	104	14	118
26	Bourgogne	89	2	15	386	Sennevoy-le-Haut	107	2	109
26	Bourgogne	89	3	99	387	Sens	24883	793	25676
26	Bourgogne	89	3	26	388	Sépeaux	422	15	437
26	Bourgogne	89	3	31	390	Serbonnes	557	8	565
26	Bourgogne	89	3	31	391	Sergines	1231	26	1257
26	Bourgogne	89	2	05	392	Sermizelles	286	2	288
26	Bourgogne	89	2	32	393	Serrigny	130	4	134
26	Bourgogne	89	1	34	394	Sery	114	0	114
26	Bourgogne	89	3	36	395	Les Sièges	440	19	459
26	Bourgogne	89	1	01	397	Sommecaise	347	4	351
26	Bourgogne	89	2	16	398	Sormery	372	13	385
26	Bourgogne	89	3	29	399	Soucy	1479	38	1517
26	Bourgogne	89	1	27	400	Sougères-en-Puisaye	341	8	349
26	Bourgogne	89	2	16	402	Soumaintrain	199	7	206
26	Bourgogne	89	2	02	403	Stigny	124	3	127
26	Bourgogne	89	3	30	404	Subligny	491	15	506
26	Bourgogne	89	1	14	405	Taingy	297	6	303
26	Bourgogne	89	2	18	406	Talcy	87	2	89
26	Bourgogne	89	2	15	407	Tanlay	1119	32	1151
26	Bourgogne	89	1	06	408	Tannerre-en-Puisaye	299	8	307
26	Bourgogne	89	2	35	409	Tharoiseau	66	1	67
26	Bourgogne	89	2	05	410	Tharot	92	5	97
26	Bourgogne	89	3	36	411	Theil-sur-Vanne	517	23	540
26	Bourgogne	89	2	17	412	Thizy	171	1	172
26	Bourgogne	89	2	15	413	Thorey	45	0	45
26	Bourgogne	89	3	31	414	Thorigny-sur-Oreuse	1499	18	1517
26	Bourgogne	89	2	05	415	Thory	197	6	203
26	Bourgogne	89	1	27	416	Thury	454	12	466
26	Bourgogne	89	2	32	417	Tissey	105	7	112
26	Bourgogne	89	2	32	418	Tonnerre	5243	249	5492
26	Bourgogne	89	1	33	419	Toucy	2628	104	2732
26	Bourgogne	89	1	27	420	Treigny	897	19	916
26	Bourgogne	89	2	17	421	Trévilly	61	1	62
26	Bourgogne	89	2	15	422	Trichey	43	0	43
26	Bourgogne	89	2	16	423	Tronchoy	148	8	156
26	Bourgogne	89	1	13	424	Trucy-sur-Yonne	141	2	143
26	Bourgogne	89	1	07	425	Turny	726	29	755
26	Bourgogne	89	1	12	426	Val-de-Mercy	371	8	379
26	Bourgogne	89	1	42	427	Vallan	708	19	727
26	Bourgogne	89	3	11	428	Vallery	555	16	571
26	Bourgogne	89	3	36	429	Vareilles	219	6	225
26	Bourgogne	89	1	20	430	Varennes	295	10	305
26	Bourgogne	89	2	17	431	Vassy-sous-Pisy	79	3	82
26	Bourgogne	89	3	08	432	Vaudeurs	512	8	520
26	Bourgogne	89	2	05	433	Vault-de-Lugny	325	8	333
26	Bourgogne	89	3	40	434	Vaumort	347	15	362
26	Bourgogne	89	1	07	436	Venizy	890	16	906
26	Bourgogne	89	1	20	437	Venouse	299	13	312
26	Bourgogne	89	1	03	438	Venoy	1767	220	1987
26	Bourgogne	89	1	25	439	Vergigny	1541	25	1566
26	Bourgogne	89	3	26	440	Verlin	437	5	442
26	Bourgogne	89	1	34	441	Vermenton	1182	19	1201
26	Bourgogne	89	3	11	442	Vernoy	214	5	219
26	Bourgogne	89	3	40	443	Véron	1954	41	1995
26	Bourgogne	89	2	32	445	Vézannes	46	3	49
26	Bourgogne	89	2	35	446	Vézelay	447	10	457
26	Bourgogne	89	2	32	447	Vézinnes	174	3	177
26	Bourgogne	89	2	17	448	Vignes	96	2	98
26	Bourgogne	89	3	22	449	Villeblevin	1822	31	1853
26	Bourgogne	89	3	11	450	Villebougis	610	27	637
26	Bourgogne	89	3	08	451	Villechétive	223	3	226
26	Bourgogne	89	1	19	452	Villecien	404	10	414
26	Bourgogne	89	1	38	453	Villefargeau	956	33	989
26	Bourgogne	89	1	10	454	Villefranche	621	9	630
26	Bourgogne	89	3	22	456	Villemanoche	663	10	673
26	Bourgogne	89	1	01	457	Villemer	245	9	254
26	Bourgogne	89	3	22	458	Villenavotte	167	7	174
26	Bourgogne	89	3	36	461	Villeneuve-l;Archevêque	1217	40	1257
26	Bourgogne	89	3	11	459	Villeneuve-la-Dondagre	241	9	250
26	Bourgogne	89	3	22	460	Villeneuve-la-Guyard	3166	52	3218
26	Bourgogne	89	1	06	462	Villeneuve-les-Genêts	308	9	317
26	Bourgogne	89	1	20	463	Villeneuve-Saint-Salves	253	8	261
26	Bourgogne	89	3	37	464	Villeneuve-sur-Yonne	5295	94	5389
26	Bourgogne	89	3	22	465	Villeperrot	323	2	325
26	Bourgogne	89	3	11	466	Villeroy	337	8	345
26	Bourgogne	89	3	22	467	Villethierry	811	18	829
26	Bourgogne	89	1	19	468	Villevallier	414	40	454
26	Bourgogne	89	2	02	470	Villiers-les-Hauts	151	2	153
26	Bourgogne	89	3	36	471	Villiers-Louis	469	14	483
26	Bourgogne	89	1	33	472	Villiers-Saint-Benoît	513	30	543
26	Bourgogne	89	1	01	473	Villiers-sur-Tholon	486	18	504
26	Bourgogne	89	2	16	474	Villiers-Vineux	297	6	303
26	Bourgogne	89	2	15	475	Villon	95	1	96
26	Bourgogne	89	1	20	477	Villy	109	1	110
26	Bourgogne	89	1	12	478	Vincelles	989	86	1075
26	Bourgogne	89	1	12	479	Vincelottes	338	18	356
26	Bourgogne	89	3	31	480	Vinneuf	1337	34	1371
26	Bourgogne	89	2	02	481	Vireaux	150	0	150
26	Bourgogne	89	2	32	482	Viviers	145	2	147
26	Bourgogne	89	3	36	483	Voisines	461	10	471
26	Bourgogne	89	1	01	484	Volgré	330	7	337
26	Bourgogne	89	2	35	485	Voutenay-sur-Cure	230	7	237
26	Bourgogne	89	2	32	486	Yrouerre	185	5	190
43	Franche-Comté	90	1	11	001	Andelnans	1267	16	1283
43	Franche-Comté	90	1	03	002	Angeot	316	10	326
43	Franche-Comté	90	1	05	003	Anjoutey	684	11	695
43	Franche-Comté	90	1	10	004	Argiésans	418	12	430
43	Franche-Comté	90	1	11	082	Autrechêne	312	4	316
43	Franche-Comté	90	1	04	005	Auxelles-Bas	477	12	489
43	Franche-Comté	90	1	04	006	Auxelles-Haut	310	11	321
43	Franche-Comté	90	1	10	007	Banvillars	274	13	287
43	Franche-Comté	90	1	10	008	Bavilliers	4923	163	5086
43	Franche-Comté	90	1	12	009	Beaucourt	5060	56	5116
43	Franche-Comté	90	1	99	010	Belfort	50078	1155	51233
43	Franche-Comté	90	1	10	011	Bermont	356	12	368
43	Franche-Comté	90	1	03	012	Bessoncourt	926	40	966
43	Franche-Comté	90	1	03	013	Bethonvilliers	246	6	252
43	Franche-Comté	90	1	13	014	Boron	428	11	439
43	Franche-Comté	90	1	10	015	Botans	286	10	296
43	Franche-Comté	90	1	05	016	Bourg-sous-Châtelet	128	2	130
43	Franche-Comté	90	1	13	017	Bourogne	1971	22	1993
43	Franche-Comté	90	1	13	018	Brebotte	337	11	348
43	Franche-Comté	90	1	13	019	Bretagne	248	5	253
43	Franche-Comté	90	1	10	020	Buc	306	9	315
43	Franche-Comté	90	1	11	021	Charmois	293	13	306
43	Franche-Comté	90	1	10	022	Châtenois-les-Forges	2696	51	2747
43	Franche-Comté	90	1	04	023	Chaux	1080	32	1112
43	Franche-Comté	90	1	13	024	Chavanatte	164	0	164
43	Franche-Comté	90	1	13	025	Chavannes-les-Grands	318	4	322
43	Franche-Comté	90	1	11	026	Chèvremont	1519	47	1566
43	Franche-Comté	90	1	02	027	Courcelles	125	1	126
43	Franche-Comté	90	1	02	028	Courtelevant	432	6	438
43	Franche-Comté	90	1	06	029	Cravanche	2002	76	2078
43	Franche-Comté	90	1	12	030	Croix	162	4	166
43	Franche-Comté	90	1	03	031	Cunelières	285	7	292
43	Franche-Comté	90	1	11	032	Danjoutin	3486	85	3571
43	Franche-Comté	90	1	02	033	Delle	5916	110	6026
43	Franche-Comté	90	1	03	034	Denney	792	28	820
43	Franche-Comté	90	1	10	035	Dorans	555	19	574
43	Franche-Comté	90	1	03	036	Eguenigue	264	11	275
43	Franche-Comté	90	1	15	037	Éloie	997	23	1020
43	Franche-Comté	90	1	06	039	Essert	3169	114	3283
43	Franche-Comté	90	1	05	041	Étueffont	1469	60	1529
43	Franche-Comté	90	1	04	042	Évette-Salbert	2080	89	2169
43	Franche-Comté	90	1	02	043	Faverois	516	7	523
43	Franche-Comté	90	1	12	045	Fêche-l;Église	789	13	802
43	Franche-Comté	90	1	05	044	Felon	256	5	261
43	Franche-Comté	90	1	02	046	Florimont	430	4	434
43	Franche-Comté	90	1	03	047	Fontaine	611	16	627
43	Franche-Comté	90	1	11	048	Fontenelle	146	0	146
43	Franche-Comté	90	1	03	049	Foussemagne	970	11	981
43	Franche-Comté	90	1	03	050	Frais	246	5	251
43	Franche-Comté	90	1	13	051	Froidefontaine	472	7	479
43	Franche-Comté	90	1	04	052	Giromagny	3187	76	3263
43	Franche-Comté	90	1	13	053	Grandvillars	3049	57	3106
43	Franche-Comté	90	1	04	054	Grosmagny	548	12	560
43	Franche-Comté	90	1	13	055	Grosne	323	4	327
43	Franche-Comté	90	1	02	056	Joncherey	1328	36	1364
43	Franche-Comté	90	1	04	057	Lachapelle-sous-Chaux	691	31	722
43	Franche-Comté	90	1	05	058	Lachapelle-sous-Rougemont	560	6	566
43	Franche-Comté	90	1	03	059	Lacollonge	256	3	259
43	Franche-Comté	90	1	03	060	Lagrange	106	2	108
43	Franche-Comté	90	1	05	061	Lamadeleine-Val-des-Anges	33	1	34
43	Franche-Comté	90	1	03	062	Larivière	307	7	314
43	Franche-Comté	90	1	02	063	Lebetain	451	4	455
43	Franche-Comté	90	1	04	065	Lepuix	1155	30	1185
43	Franche-Comté	90	1	02	064	Lepuix-Neuf	285	4	289
43	Franche-Comté	90	1	05	066	Leval	196	2	198
43	Franche-Comté	90	1	03	067	Menoncourt	426	15	441
43	Franche-Comté	90	1	11	068	Meroux	819	25	844
43	Franche-Comté	90	1	13	069	Méziré	1407	19	1426
43	Franche-Comté	90	1	12	070	Montbouton	410	9	419
43	Franche-Comté	90	1	03	071	Montreux-Château	1111	13	1124
43	Franche-Comté	90	1	13	072	Morvillars	1139	17	1156
43	Franche-Comté	90	1	11	073	Moval	322	6	328
43	Franche-Comté	90	1	11	074	Novillard	256	3	259
43	Franche-Comté	90	1	15	075	Offemont	3395	106	3501
43	Franche-Comté	90	1	11	076	Pérouse	1084	40	1124
43	Franche-Comté	90	1	03	077	Petit-Croix	327	9	336
43	Franche-Comté	90	1	05	078	Petitefontaine	193	4	197
43	Franche-Comté	90	1	04	079	Petitmagny	279	11	290
43	Franche-Comté	90	1	03	080	Phaffans	319	11	330
43	Franche-Comté	90	1	02	081	Réchésy	814	14	828
43	Franche-Comté	90	1	13	083	Recouvrance	75	1	76
43	Franche-Comté	90	1	03	084	Reppe	317	8	325
43	Franche-Comté	90	1	04	085	Riervescemont	93	2	95
43	Franche-Comté	90	1	05	086	Romagny-sous-Rougemont	209	6	215
43	Franche-Comté	90	1	15	087	Roppe	844	14	858
43	Franche-Comté	90	1	04	088	Rougegoutte	1007	19	1026
43	Franche-Comté	90	1	05	089	Rougemont-le-Château	1392	67	1459
43	Franche-Comté	90	1	12	090	Saint-Dizier-l;Évêque	412	8	420
43	Franche-Comté	90	1	05	091	Saint-Germain-le-Châtelet	607	15	622
43	Franche-Comté	90	1	04	093	Sermamagny	815	15	830
43	Franche-Comté	90	1	11	094	Sevenans	718	21	739
43	Franche-Comté	90	1	13	095	Suarce	449	9	458
43	Franche-Comté	90	1	02	096	Thiancourt	248	5	253
43	Franche-Comté	90	1	10	097	Trévenans	1150	26	1176
43	Franche-Comté	90	1	10	098	Urcerey	217	8	225
43	Franche-Comté	90	1	06	099	Valdoie	5165	246	5411
43	Franche-Comté	90	1	03	100	Vauthiermont	231	9	240
43	Franche-Comté	90	1	13	101	Vellescot	254	3	257
43	Franche-Comté	90	1	04	102	Vescemont	722	24	746
43	Franche-Comté	90	1	15	103	Vétrigne	540	14	554
43	Franche-Comté	90	1	11	104	Vézelois	928	27	955
43	Franche-Comté	90	1	12	105	Villars-le-Sec	151	1	152
11	Île-de-France	91	1	17	001	Abbéville-la-Rivière	283	6	289
11	Île-de-France	91	1	17	016	Angerville	3753	60	3813
11	Île-de-France	91	1	24	017	Angervilliers	1645	13	1658
11	Île-de-France	91	3	01	021	Arpajon	10574	138	10712
11	Île-de-France	91	1	17	022	Arrancourt	128	0	128
11	Île-de-France	91	3	02	027	Athis-Mons	30393	452	30845
11	Île-de-France	91	1	07	035	Authon-la-Plaine	360	4	364
11	Île-de-France	91	2	16	037	Auvernaux	338	6	344
11	Île-de-France	91	1	09	038	Auvers-Saint-Georges	1204	14	1218
11	Île-de-France	91	3	01	041	Avrainville	737	7	744
11	Île-de-France	91	3	35	044	Ballainvilliers	3795	37	3832
11	Île-de-France	91	2	16	045	Ballancourt-sur-Essonne	7399	74	7473
11	Île-de-France	91	1	11	047	Baulne	1316	16	1332
11	Île-de-France	91	3	03	064	Bièvres	4643	104	4747
11	Île-de-France	91	1	17	067	Blandy	115	0	115
11	Île-de-France	91	2	18	069	Boigneville	416	8	424
11	Île-de-France	91	1	17	075	Bois-Herpin	75	0	75
11	Île-de-France	91	1	17	079	Boissy-la-Rivière	551	8	559
11	Île-de-France	91	1	11	080	Boissy-le-Cutté	1324	9	1333
11	Île-de-France	91	1	08	081	Boissy-le-Sec	671	12	683
11	Île-de-France	91	1	24	085	Boissy-sous-Saint-Yon	3731	49	3780
11	Île-de-France	91	2	10	086	Bondoufle	9298	117	9415
11	Île-de-France	91	3	13	093	Boullay-les-Troux	649	23	672
11	Île-de-France	91	1	09	095	Bouray-sur-Juine	1962	19	1981
11	Île-de-France	91	2	38	097	Boussy-Saint-Antoine	6292	48	6340
11	Île-de-France	91	1	08	098	Boutervilliers	366	11	377
11	Île-de-France	91	1	11	099	Boutigny-sur-Essonne	3103	38	3141
11	Île-de-France	91	1	08	100	Bouville	616	12	628
11	Île-de-France	91	3	04	103	Brétigny-sur-Orge	23334	478	23812
11	Île-de-France	91	1	24	105	Breuillet	8319	121	8440
11	Île-de-France	91	1	24	106	Breux-Jouy	1216	18	1234
11	Île-de-France	91	1	08	109	Brières-les-Scellés	1026	15	1041
11	Île-de-France	91	3	13	111	Briis-sous-Forges	3364	57	3421
11	Île-de-France	91	1	17	112	Brouy	125	4	129
11	Île-de-France	91	2	05	114	Brunoy	25377	408	25785
11	Île-de-France	91	3	01	115	Bruyères-le-Châtel	3187	45	3232
11	Île-de-France	91	2	18	121	Buno-Bonnevaux	476	6	482
11	Île-de-France	91	3	21	122	Bures-sur-Yvette	9535	234	9769
11	Île-de-France	91	1	11	129	Cerny	3294	88	3382
11	Île-de-France	91	1	08	130	Chalo-Saint-Mars	1143	21	1164
11	Île-de-France	91	1	17	131	Chalou-Moulineux	418	7	425
11	Île-de-France	91	1	09	132	Chamarande	1091	14	1105
11	Île-de-France	91	2	16	135	Champcueil	2790	57	2847
11	Île-de-France	91	3	35	136	Champlan	2525	41	2566
11	Île-de-France	91	1	17	137	Champmotteux	376	3	379
11	Île-de-France	91	1	07	145	Chatignonville	56	3	59
11	Île-de-France	91	1	09	148	Chauffour-lès-Étréchy	135	2	137
11	Île-de-France	91	3	01	156	Cheptainville	1905	17	1922
11	Île-de-France	91	2	16	159	Chevannes	1641	21	1662
11	Île-de-France	91	3	28	161	Chilly-Mazarin	18484	180	18664
11	Île-de-France	91	1	17	613	Congerville-Thionville	222	8	230
11	Île-de-France	91	2	96	174	Corbeil-Essonnes	43086	661	43747
11	Île-de-France	91	1	07	175	Corbreuse	1703	29	1732
11	Île-de-France	91	2	16	179	Le Coudray-Montceaux	4708	44	4752
11	Île-de-France	91	2	18	180	Courances	352	5	357
11	Île-de-France	91	2	39	182	Courcouronnes	13812	156	13968
11	Île-de-France	91	2	18	184	Courdimanche-sur-Essonne	269	2	271
11	Île-de-France	91	3	13	186	Courson-Monteloup	595	17	612
11	Île-de-France	91	2	36	191	Crosne	9143	82	9225
11	Île-de-France	91	1	11	198	D;Huison-Longueville	1409	18	1427
11	Île-de-France	91	2	18	195	Dannemois	840	14	854
11	Île-de-France	91	1	07	200	Dourdan	9984	167	10151
11	Île-de-France	91	2	29	201	Draveil	28491	311	28802
11	Île-de-France	91	2	16	204	Écharcon	793	13	806
11	Île-de-France	91	3	01	207	Égly	5323	44	5367
11	Île-de-France	91	2	38	215	Épinay-sous-Sénart	12171	75	12246
11	Île-de-France	91	3	14	216	Épinay-sur-Orge	10104	118	10222
11	Île-de-France	91	1	17	222	Estouches	207	1	208
11	Île-de-France	91	1	08	223	Étampes	23158	417	23575
11	Île-de-France	91	2	32	225	Étiolles	3073	96	3169
11	Île-de-France	91	1	09	226	Étréchy	6295	93	6388
11	Île-de-France	91	2	97	228	Évry	52135	884	53019
11	Île-de-France	91	1	11	232	La Ferté-Alais	3985	47	4032
11	Île-de-France	91	2	31	235	Fleury-Mérogis	9121	33	9154
11	Île-de-France	91	1	17	240	Fontaine-la-Rivière	203	0	203
11	Île-de-France	91	2	16	244	Fontenay-le-Vicomte	1273	13	1286
11	Île-de-France	91	3	13	243	Fontenay-lès-Briis	1882	36	1918
11	Île-de-France	91	1	07	247	La Forêt-le-Roi	481	5	486
11	Île-de-France	91	1	17	248	La Forêt-Sainte-Croix	155	2	157
11	Île-de-France	91	3	13	249	Forges-les-Bains	3723	72	3795
11	Île-de-France	91	3	30	272	Gif-sur-Yvette	20654	605	21259
11	Île-de-France	91	2	18	273	Gironville-sur-Essonne	806	11	817
11	Île-de-France	91	3	13	274	Gometz-la-Ville	1374	20	1394
11	Île-de-France	91	3	13	275	Gometz-le-Châtel	2588	35	2623
11	Île-de-France	91	1	07	284	Les Granges-le-Roi	1067	17	1084
11	Île-de-France	91	2	40	286	Grigny	26638	158	26796
11	Île-de-France	91	3	01	292	Guibeville	719	6	725
11	Île-de-France	91	1	11	293	Guigneville-sur-Essonne	926	18	944
11	Île-de-France	91	1	17	294	Guillerval	766	13	779
11	Île-de-France	91	3	22	312	Igny	10336	542	10878
11	Île-de-France	91	1	11	315	Itteville	6575	66	6641
11	Île-de-France	91	1	09	318	Janville-sur-Juine	1863	64	1927
11	Île-de-France	91	3	13	319	Janvry	584	21	605
11	Île-de-France	91	3	41	326	Juvisy-sur-Orge	14634	122	14756
11	Île-de-France	91	1	09	330	Lardy	5528	68	5596
11	Île-de-France	91	3	04	332	Leudeville	1374	26	1400
11	Île-de-France	91	3	01	333	Leuville-sur-Orge	4099	55	4154
11	Île-de-France	91	3	13	338	Limours	6459	146	6605
11	Île-de-France	91	3	20	339	Linas	6479	88	6567
11	Île-de-France	91	2	10	340	Lisses	7173	88	7261
11	Île-de-France	91	3	14	345	Longjumeau	21361	213	21574
11	Île-de-France	91	3	20	347	Longpont-sur-Orge	6561	91	6652
11	Île-de-France	91	2	18	359	Maisse	2661	52	2713
11	Île-de-France	91	3	20	363	Marcoussis	7909	166	8075
11	Île-de-France	91	1	17	374	Marolles-en-Beauce	218	13	231
11	Île-de-France	91	3	04	376	Marolles-en-Hurepoix	4812	54	4866
11	Île-de-France	91	3	98	377	Massy	42258	748	43006
11	Île-de-France	91	1	09	378	Mauchamps	286	2	288
11	Île-de-France	91	2	16	386	Mennecy	13395	315	13710
11	Île-de-France	91	1	17	390	Méréville	3221	64	3285
11	Île-de-France	91	1	07	393	Mérobert	547	8	555
11	Île-de-France	91	1	17	399	Mespuits	191	4	195
11	Île-de-France	91	2	18	405	Milly-la-Forêt	4741	102	4843
11	Île-de-France	91	2	18	408	Moigny-sur-École	1302	30	1332
11	Île-de-France	91	3	13	411	Les Molières	1961	56	2017
11	Île-de-France	91	1	11	412	Mondeville	680	11	691
11	Île-de-France	91	1	17	414	Monnerville	401	4	405
11	Île-de-France	91	2	19	421	Montgeron	22880	251	23131
11	Île-de-France	91	3	20	425	Montlhéry	6840	280	7120
11	Île-de-France	91	3	28	432	Morangis	12136	112	12248
11	Île-de-France	91	1	08	433	Morigny-Champigny	4311	106	4417
11	Île-de-France	91	2	31	434	Morsang-sur-Orge	20944	169	21113
11	Île-de-France	91	2	32	435	Morsang-sur-Seine	510	44	554
11	Île-de-France	91	2	16	441	Nainville-les-Roches	454	3	457
11	Île-de-France	91	3	01	457	La Norville	4075	86	4161
11	Île-de-France	91	3	20	458	Nozay	4731	59	4790
11	Île-de-France	91	3	01	461	Ollainville	4550	94	4644
11	Île-de-France	91	2	18	463	Oncy-sur-École	958	14	972
11	Île-de-France	91	2	16	468	Ormoy	1858	14	1872
11	Île-de-France	91	1	08	469	Ormoy-la-Rivière	941	56	997
11	Île-de-France	91	3	21	471	Orsay	15966	265	16231
11	Île-de-France	91	1	11	473	Orveau	197	4	201
11	Île-de-France	91	3	22	477	Palaiseau	30285	890	31175
11	Île-de-France	91	3	02	479	Paray-Vieille-Poste	7111	57	7168
11	Île-de-France	91	3	13	482	Pecqueuse	623	9	632
11	Île-de-France	91	3	04	494	Le Plessis-Pâté	4036	32	4068
11	Île-de-France	91	1	07	495	Plessis-Saint-Benoist	308	10	318
11	Île-de-France	91	2	18	507	Prunay-sur-Essonne	310	3	313
11	Île-de-France	91	1	08	508	Puiselet-le-Marais	270	13	283
11	Île-de-France	91	1	17	511	Pussay	1963	28	1991
11	Île-de-France	91	2	38	514	Quincy-sous-Sénart	8048	81	8129
11	Île-de-France	91	1	07	519	Richarville	408	15	423
11	Île-de-France	91	2	23	521	Ris-Orangis	27463	226	27689
11	Île-de-France	91	1	07	525	Roinville	1242	19	1261
11	Île-de-France	91	1	17	526	Roinvilliers	92	0	92
11	Île-de-France	91	1	17	533	Saclas	1806	13	1819
11	Île-de-France	91	3	03	534	Saclay	3241	71	3312
11	Île-de-France	91	3	03	538	Saint-Aubin	690	20	710
11	Île-de-France	91	1	24	540	Saint-Chéron	4799	70	4869
11	Île-de-France	91	1	17	544	Saint-Cyr-la-Rivière	501	8	509
11	Île-de-France	91	1	24	546	Saint-Cyr-sous-Dourdan	1011	15	1026
11	Île-de-France	91	1	07	547	Saint-Escobille	460	11	471
11	Île-de-France	91	3	01	552	Saint-Germain-lès-Arpajon	9338	133	9471
11	Île-de-France	91	2	32	553	Saint-Germain-lès-Corbeil	7174	143	7317
11	Île-de-France	91	1	08	556	Saint-Hilaire	380	16	396
11	Île-de-France	91	3	20	560	Saint-Jean-de-Beauregard	278	3	281
11	Île-de-France	91	1	24	568	Saint-Maurice-Montcouronne	1641	31	1672
11	Île-de-France	91	3	33	570	Saint-Michel-sur-Orge	20046	299	20345
11	Île-de-France	91	2	32	573	Saint-Pierre-du-Perray	8350	79	8429
11	Île-de-France	91	1	24	578	Saint-Sulpice-de-Favières	324	8	332
11	Île-de-France	91	3	04	579	Saint-Vrain	2813	27	2840
11	Île-de-France	91	1	24	581	Saint-Yon	909	13	922
11	Île-de-France	91	3	25	549	Sainte-Geneviève-des-Bois	34195	319	34514
11	Île-de-France	91	2	32	577	Saintry-sur-Seine	5093	65	5158
11	Île-de-France	91	3	35	587	Saulx-les-Chartreux	5048	56	5104
11	Île-de-France	91	3	99	589	Savigny-sur-Orge	36842	361	37203
11	Île-de-France	91	1	24	593	Sermaise	1680	22	1702
11	Île-de-France	91	2	18	599	Soisy-sur-École	1357	21	1378
11	Île-de-France	91	2	32	600	Soisy-sur-Seine	7048	164	7212
11	Île-de-France	91	1	09	602	Souzy-la-Briche	382	2	384
11	Île-de-France	91	2	32	617	Tigery	2757	105	2862
11	Île-de-France	91	1	09	619	Torfou	272	5	277
11	Île-de-France	91	3	43	692	Les Ulis	24792	263	25055
11	Île-de-France	91	1	24	630	Le Val-Saint-Germain	1460	31	1491
11	Île-de-France	91	1	08	629	Valpuiseaux	619	14	633
11	Île-de-France	91	2	38	631	Varennes-Jarcy	2373	28	2401
11	Île-de-France	91	3	13	634	Vaugrigneuse	1269	14	1283
11	Île-de-France	91	3	03	635	Vauhallan	1985	44	2029
11	Île-de-France	91	1	11	639	Vayres-sur-Essonne	893	65	958
11	Île-de-France	91	3	03	645	Verrières-le-Buisson	15418	412	15830
11	Île-de-France	91	2	16	648	Vert-le-Grand	2410	26	2436
11	Île-de-France	91	2	16	649	Vert-le-Petit	2636	27	2663
11	Île-de-France	91	1	11	654	Videlles	660	11	671
11	Île-de-France	91	2	34	657	Vigneux-sur-Seine	27331	215	27546
11	Île-de-France	91	2	06	659	Villabé	4869	65	4934
11	Île-de-France	91	3	20	665	La Ville-du-Bois	7138	87	7225
11	Île-de-France	91	3	35	661	Villebon-sur-Yvette	9625	200	9825
11	Île-de-France	91	1	09	662	Villeconin	728	15	743
11	Île-de-France	91	3	35	666	Villejust	2247	30	2277
11	Île-de-France	91	3	14	667	Villemoisson-sur-Orge	6950	103	7053
11	Île-de-France	91	1	09	671	Villeneuve-sur-Auvers	600	8	608
11	Île-de-France	91	3	03	679	Villiers-le-Bâcle	1204	24	1228
11	Île-de-France	91	3	14	685	Villiers-sur-Orge	3891	60	3951
11	Île-de-France	91	2	27	687	Viry-Châtillon	32045	351	32396
11	Île-de-France	91	3	28	689	Wissous	5805	160	5965
11	Île-de-France	91	2	36	691	Yerres	29050	342	29392
11	Île-de-France	92	1	87	002	Antony	61793	851	62644
11	Île-de-France	92	2	88	004	Asnières-sur-Seine	82327	671	82998
11	Île-de-France	92	1	04	007	Bagneux	38080	304	38384
11	Île-de-France	92	2	05	009	Bois-Colombes	29284	235	29519
11	Île-de-France	92	3	89	012	Boulogne-Billancourt	114205	1059	115264
11	Île-de-France	92	1	09	014	Bourg-la-Reine	19985	318	20303
11	Île-de-France	92	1	85	019	Châtenay-Malabry	32111	462	32573
11	Île-de-France	92	1	10	020	Châtillon	32619	328	32947
11	Île-de-France	92	3	11	022	Chaville	18668	219	18887
11	Île-de-France	92	1	90	023	Clamart	52546	567	53113
11	Île-de-France	92	2	91	024	Clichy	58916	312	59228
11	Île-de-France	92	2	92	025	Colombes	85398	696	86094
11	Île-de-France	92	2	93	026	Courbevoie	87469	700	88169
11	Île-de-France	92	1	43	032	Fontenay-aux-Roses	23351	252	23603
11	Île-de-France	92	2	18	033	Garches	18169	300	18469
11	Île-de-France	92	2	19	035	La Garenne-Colombes	27628	295	27923
11	Île-de-France	92	2	86	036	Gennevilliers	41364	312	41676
11	Île-de-France	92	3	94	040	Issy-les-Moulineaux	64355	823	65178
11	Île-de-France	92	2	95	044	Levallois-Perret	64253	504	64757
11	Île-de-France	92	1	25	046	Malakoff	30982	343	31325
11	Île-de-France	92	3	11	047	Marnes-la-Coquette	1647	36	1683
11	Île-de-France	92	3	96	048	Meudon	45058	776	45834
11	Île-de-France	92	1	27	049	Montrouge	48597	386	48983
11	Île-de-France	92	2	97	050	Nanterre	89185	1929	91114
11	Île-de-France	92	2	98	051	Neuilly-sur-Seine	61754	811	62565
11	Île-de-France	92	1	32	060	Le Plessis-Robinson	27727	204	27931
11	Île-de-France	92	2	33	062	Puteaux	44753	340	45093
11	Île-de-France	92	2	99	063	Rueil-Malmaison	79426	1479	80905
11	Île-de-France	92	3	35	064	Saint-Cloud	29873	543	30416
11	Île-de-France	92	1	36	071	Sceaux	19638	348	19986
11	Île-de-France	92	3	37	072	Sèvres	22978	434	23412
11	Île-de-France	92	2	38	073	Suresnes	46723	398	47121
11	Île-de-France	92	1	39	075	Vanves	27002	312	27314
11	Île-de-France	92	3	11	076	Vaucresson	8615	336	8951
11	Île-de-France	92	3	11	077	Ville-d;Avray	10828	185	11013
11	Île-de-France	92	2	40	078	Villeneuve-la-Garenne	25183	191	25374
11	Île-de-France	93	3	92	001	Aubervilliers	76087	641	76728
11	Île-de-France	93	2	93	005	Aulnay-sous-Bois	82120	658	82778
11	Île-de-France	93	1	05	006	Bagnolet	33883	349	34232
11	Île-de-France	93	2	06	007	Le Blanc-Mesnil	51438	297	51735
11	Île-de-France	93	1	07	008	Bobigny	47492	363	47855
11	Île-de-France	93	1	94	010	Bondy	53530	404	53934
11	Île-de-France	93	1	09	013	Le Bourget	14864	79	14943
11	Île-de-France	93	2	24	014	Clichy-sous-Bois	29750	248	29998
11	Île-de-France	93	2	15	015	Coubron	4733	62	4795
11	Île-de-France	93	3	10	027	La Courneuve	38007	354	38361
11	Île-de-France	93	1	95	029	Drancy	66410	792	67202
11	Île-de-France	93	1	09	030	Dugny	10656	79	10735
11	Île-de-France	93	3	12	031	Épinay-sur-Seine	54518	257	54775
11	Île-de-France	93	2	13	032	Gagny	39056	294	39350
11	Île-de-France	93	2	19	033	Gournay-sur-Marne	6406	51	6457
11	Île-de-France	93	3	29	039	L; Île-Saint-Denis	7025	45	7070
11	Île-de-France	93	1	23	045	Les Lilas	22228	182	22410
11	Île-de-France	93	2	14	046	Livry-Gargan	41808	252	42060
11	Île-de-France	93	2	15	047	Montfermeil	25269	230	25499
11	Île-de-France	93	1	96	048	Montreuil	102770	905	103675
11	Île-de-France	93	2	18	049	Neuilly-Plaisance	20508	175	20683
11	Île-de-France	93	2	37	050	Neuilly-sur-Marne	33498	283	33781
11	Île-de-France	93	2	19	051	Noisy-le-Grand	62964	562	63526
11	Île-de-France	93	1	20	053	Noisy-le-Sec	39733	216	39949
11	Île-de-France	93	1	97	055	Pantin	54136	328	54464
11	Île-de-France	93	1	22	057	Les Pavillons-sous-Bois	21746	226	21972
11	Île-de-France	93	3	39	059	Pierrefitte-sur-Seine	27883	193	28076
11	Île-de-France	93	1	23	061	Le Pré-Saint-Gervais	18045	126	18171
11	Île-de-France	93	2	24	062	Le Raincy	13828	366	14194
11	Île-de-France	93	1	25	063	Romainville	25771	254	26025
11	Île-de-France	93	1	26	064	Rosny-sous-Bois	41050	381	41431
11	Île-de-France	93	3	98	066	Saint-Denis	106785	1174	107959
11	Île-de-France	93	3	99	070	Saint-Ouen	47189	415	47604
11	Île-de-France	93	2	31	071	Sevran	49832	393	50225
11	Île-de-France	93	3	32	072	Stains	33829	219	34048
11	Île-de-France	93	2	33	073	Tremblay-en-France	34493	251	34744
11	Île-de-France	93	2	15	074	Vaujours	6452	149	6601
11	Île-de-France	93	1	34	077	Villemomble	28006	251	28257
11	Île-de-France	93	2	40	078	Villepinte	35658	273	35931
11	Île-de-France	93	3	39	079	Villetaneuse	12592	70	12662
11	Île-de-France	94	1	28	001	Ablon-sur-Seine	5171	27	5198
11	Île-de-France	94	1	86	002	Alfortville	44201	238	44439
11	Île-de-France	94	3	34	003	Arcueil	19775	189	19964
11	Île-de-France	94	1	02	004	Boissy-Saint-Léger	16705	240	16945
11	Île-de-France	94	1	03	011	Bonneuil-sur-Marne	16513	375	16888
11	Île-de-France	94	2	04	015	Bry-sur-Marne	15625	200	15825
11	Île-de-France	94	3	05	016	Cachan	28248	302	28550
11	Île-de-France	94	2	94	017	Champigny-sur-Marne	75510	725	76235
11	Île-de-France	94	1	07	018	Charenton-le-Pont	29348	316	29664
11	Île-de-France	94	2	08	019	Chennevières-sur-Marne	18049	178	18227
11	Île-de-France	94	3	42	021	Chevilly-Larue	18498	161	18659
11	Île-de-France	94	1	09	022	Choisy-le-Roi	40905	370	41275
11	Île-de-France	94	1	90	028	Créteil	89985	794	90779
11	Île-de-France	94	2	91	033	Fontenay-sous-Bois	53145	522	53667
11	Île-de-France	94	3	37	034	Fresnes	26248	198	26446
11	Île-de-France	94	3	87	037	Gentilly	17097	125	17222
11	Île-de-France	94	3	12	038	L; Haÿ-les-Roses	30201	387	30588
11	Île-de-France	94	1	95	041	Ivry-sur-Seine	57732	457	58189
11	Île-de-France	94	2	15	042	Joinville-le-Pont	17802	188	17990
11	Île-de-France	94	3	16	043	Le Kremlin-Bicêtre	26046	221	26267
11	Île-de-France	94	1	02	044	Limeil-Brévannes	19901	211	20112
11	Île-de-France	94	1	96	046	Maisons-Alfort	52943	570	53513
11	Île-de-France	94	1	26	047	Mandres-les-Roses	4413	46	4459
11	Île-de-France	94	1	26	048	Marolles-en-Brie	4968	138	5106
11	Île-de-France	94	2	19	052	Nogent-sur-Marne	31637	338	31975
11	Île-de-France	94	2	44	053	Noiseau	4669	39	4708
11	Île-de-France	94	1	20	054	Orly	21395	296	21691
11	Île-de-France	94	2	44	055	Ormesson-sur-Marne	9904	86	9990
11	Île-de-France	94	1	26	056	Périgny	2311	24	2335
11	Île-de-France	94	2	21	058	Le Perreux-sur-Marne	32520	279	32799
11	Île-de-France	94	2	38	059	Le Plessis-Trévise	19194	110	19304
11	Île-de-France	94	2	44	060	La Queue-en-Brie	11381	113	11494
11	Île-de-France	94	3	42	065	Rungis	5662	67	5729
11	Île-de-France	94	2	22	067	Saint-Mandé	22396	270	22666
11	Île-de-France	94	1	97	068	Saint-Maur-des-Fossés	74816	956	75772
11	Île-de-France	94	1	07	069	Saint-Maurice	14512	135	14647
11	Île-de-France	94	1	26	070	Santeny	3724	82	3806
11	Île-de-France	94	1	46	071	Sucy-en-Brie	25820	330	26150
11	Île-de-France	94	3	25	073	Thiais	29653	296	29949
11	Île-de-France	94	1	47	074	Valenton	12081	147	12228
11	Île-de-France	94	1	26	075	Villecresnes	9598	134	9732
11	Île-de-France	94	3	93	076	Villejuif	55490	389	55879
11	Île-de-France	94	1	28	077	Villeneuve-le-Roi	18479	89	18568
11	Île-de-France	94	1	88	078	Villeneuve-Saint-Georges	32239	267	32506
11	Île-de-France	94	2	38	079	Villiers-sur-Marne	27338	230	27568
11	Île-de-France	94	2	98	080	Vincennes	48471	484	48955
11	Île-de-France	94	1	99	081	Vitry-sur-Seine	85413	797	86210
11	Île-de-France	95	3	27	002	Ableiges	943	11	954
11	Île-de-France	95	3	16	008	Aincourt	972	8	980
11	Île-de-France	95	3	16	011	Ambleville	420	8	428
11	Île-de-France	95	3	16	012	Amenucourt	198	5	203
11	Île-de-France	95	2	24	014	Andilly	2524	46	2570
11	Île-de-France	95	1	99	018	Argenteuil	103125	1718	104843
11	Île-de-France	95	2	35	019	Arnouville	13538	118	13656
11	Île-de-France	95	3	17	023	Arronville	664	11	675
11	Île-de-France	95	3	16	024	Arthies	301	3	304
11	Île-de-France	95	2	26	026	Asnières-sur-Oise	2527	55	2582
11	Île-de-France	95	2	06	028	Attainville	1831	11	1842
11	Île-de-France	95	3	34	039	Auvers-sur-Oise	6792	161	6953
11	Île-de-France	95	3	27	040	Avernes	805	12	817
11	Île-de-France	95	2	26	042	Baillet-en-France	1955	17	1972
11	Île-de-France	95	3	16	046	Banthelu	124	2	126
11	Île-de-France	95	3	28	051	Beauchamp	8737	97	8834
11	Île-de-France	95	3	03	052	Beaumont-sur-Oise	8954	165	9119
11	Île-de-France	95	3	17	054	Le Bellay-en-Vexin	244	6	250
11	Île-de-France	95	2	15	055	Bellefontaine	432	3	435
11	Île-de-France	95	2	26	056	Belloy-en-France	1937	14	1951
11	Île-de-France	95	3	03	058	Bernes-sur-Oise	2378	21	2399
11	Île-de-France	95	3	17	059	Berville	332	4	336
11	Île-de-France	95	3	25	060	Bessancourt	6994	96	7090
11	Île-de-France	95	3	25	061	Béthemont-la-Forêt	420	6	426
11	Île-de-France	95	1	04	063	Bezons	27987	290	28277
11	Île-de-France	95	3	39	074	Boisemont	747	10	757
11	Île-de-France	95	3	29	078	Boissy-l;Aillerie	1774	18	1792
11	Île-de-France	95	2	38	088	Bonneuil-en-France	713	2	715
11	Île-de-France	95	2	06	091	Bouffémont	5940	58	5998
11	Île-de-France	95	2	13	094	Bouqueval	329	4	333
11	Île-de-France	95	3	16	101	Bray-et-Lû	977	5	982
11	Île-de-France	95	3	17	102	Bréançon	371	6	377
11	Île-de-France	95	3	17	110	Brignancourt	204	8	212
11	Île-de-France	95	3	03	116	Bruyères-sur-Oise	3700	62	3762
11	Île-de-France	95	3	16	119	Buhy	307	2	309
11	Île-de-France	95	3	34	120	Butry-sur-Oise	2026	36	2062
11	Île-de-France	95	3	96	127	Cergy	56988	912	57900
11	Île-de-France	95	3	03	134	Champagne-sur-Oise	4657	65	4722
11	Île-de-France	95	3	16	139	La Chapelle-en-Vexin	331	5	336
11	Île-de-France	95	3	16	141	Charmont	28	0	28
11	Île-de-France	95	3	17	142	Chars	1811	18	1829
11	Île-de-France	95	2	15	144	Châtenay-en-France	69	0	69
11	Île-de-France	95	2	15	149	Chaumontel	3289	46	3335
11	Île-de-France	95	3	16	150	Chaussy	633	18	651
11	Île-de-France	95	3	25	151	Chauvry	301	8	309
11	Île-de-France	95	2	13	154	Chennevières-lès-Louvres	344	2	346
11	Île-de-France	95	3	16	157	Chérence	149	2	151
11	Île-de-France	95	3	27	166	Cléry-en-Vexin	405	10	415
11	Île-de-France	95	3	27	169	Commeny	379	9	388
11	Île-de-France	95	3	27	170	Condécourt	545	5	550
11	Île-de-France	95	1	05	176	Cormeilles-en-Parisis	23038	280	23318
11	Île-de-France	95	3	17	177	Cormeilles-en-Vexin	1112	9	1121
11	Île-de-France	95	3	27	181	Courcelles-sur-Viosne	306	7	313
11	Île-de-France	95	3	39	183	Courdimanche	6495	97	6592
11	Île-de-France	95	2	09	197	Deuil-la-Barre	21509	232	21741
11	Île-de-France	95	2	06	199	Domont	14827	248	15075
11	Île-de-France	95	3	07	203	Eaubonne	24062	324	24386
11	Île-de-France	95	2	08	205	Écouen	7374	141	7515
11	Île-de-France	95	2	09	210	Enghien-les-Bains	11809	150	11959
11	Île-de-France	95	3	34	211	Ennery	2244	30	2274
11	Île-de-France	95	2	13	212	Épiais-lès-Louvres	88	0	88
11	Île-de-France	95	3	17	213	Épiais-Rhus	645	5	650
11	Île-de-France	95	2	15	214	Épinay-Champlâtreux	67	0	67
11	Île-de-France	95	3	37	218	Éragny	16886	259	17145
11	Île-de-France	95	3	10	219	Ermont	27446	267	27713
11	Île-de-France	95	2	08	229	Ézanville	8979	126	9105
11	Île-de-France	95	2	15	241	Fontenay-en-Parisis	1912	21	1933
11	Île-de-France	95	2	15	250	Fosses	9565	68	9633
11	Île-de-France	95	3	11	252	Franconville	33097	227	33324
11	Île-de-France	95	3	27	253	Frémainville	490	1	491
11	Île-de-France	95	3	17	254	Frémécourt	543	8	551
11	Île-de-France	95	3	25	256	Frépillon	2795	33	2828
11	Île-de-France	95	1	31	257	La Frette-sur-Seine	4569	52	4621
11	Île-de-France	95	3	34	258	Frouville	369	12	381
11	Île-de-France	95	3	27	259	Gadancourt	99	2	101
11	Île-de-France	95	2	97	268	Garges-lès-Gonesse	40012	262	40274
11	Île-de-France	95	3	16	270	Genainville	557	9	566
11	Île-de-France	95	3	34	271	Génicourt	489	14	503
11	Île-de-France	95	2	13	277	Gonesse	26356	271	26627
11	Île-de-France	95	2	30	280	Goussainville	30996	241	31237
11	Île-de-France	95	3	27	282	Gouzangrez	173	3	176
11	Île-de-France	95	3	17	287	Grisy-les-Plâtres	607	7	614
11	Île-de-France	95	2	18	288	Groslay	8460	141	8601
11	Île-de-France	95	3	27	295	Guiry-en-Vexin	154	3	157
11	Île-de-France	95	3	17	298	Haravilliers	539	5	544
11	Île-de-France	95	3	16	301	Haute-Isle	319	5	324
11	Île-de-France	95	3	17	303	Le Heaulme	191	3	194
11	Île-de-France	95	3	34	304	Hédouville	250	4	254
11	Île-de-France	95	1	31	306	Herblay	26016	517	26533
11	Île-de-France	95	3	34	308	Hérouville	610	42	652
11	Île-de-France	95	3	16	309	Hodent	250	7	257
11	Île-de-France	95	3	14	313	L; Isle-Adam	11744	235	11979
11	Île-de-France	95	2	15	316	Jagny-sous-Bois	254	0	254
11	Île-de-France	95	3	39	323	Jouy-le-Moutier	16589	207	16796
11	Île-de-France	95	3	34	328	Labbeville	569	11	580
11	Île-de-France	95	2	15	331	Lassy	187	1	188
11	Île-de-France	95	3	34	341	Livilliers	381	3	384
11	Île-de-France	95	3	27	348	Longuesse	530	26	556
11	Île-de-France	95	2	30	351	Louvres	9339	70	9409
11	Île-de-France	95	2	15	352	Luzarches	4289	61	4350
11	Île-de-France	95	2	26	353	Maffliers	1664	12	1676
11	Île-de-France	95	3	16	355	Magny-en-Vexin	5752	59	5811
11	Île-de-France	95	2	15	365	Mareil-en-France	694	6	700
11	Île-de-France	95	2	24	369	Margency	2852	39	2891
11	Île-de-France	95	3	17	370	Marines	3254	64	3318
11	Île-de-France	95	2	15	371	Marly-la-Ville	5472	45	5517
11	Île-de-France	95	3	16	379	Maudétour-en-Vexin	197	3	200
11	Île-de-France	95	3	17	387	Menouville	90	2	92
11	Île-de-France	95	3	39	388	Menucourt	5287	62	5349
11	Île-de-France	95	3	14	392	Mériel	4443	58	4501
11	Île-de-France	95	3	21	394	Méry-sur-Oise	9260	150	9410
11	Île-de-France	95	2	08	395	Le Mesnil-Aubry	912	6	918
11	Île-de-France	95	2	06	409	Moisselles	1255	3	1258
11	Île-de-France	95	3	27	422	Montgeroult	426	2	428
11	Île-de-France	95	1	05	424	Montigny-lès-Cormeilles	19041	255	19296
11	Île-de-France	95	3	20	426	Montlignon	2561	124	2685
11	Île-de-France	95	2	09	427	Montmagny	14250	173	14423
11	Île-de-France	95	2	18	428	Montmorency	21194	281	21475
11	Île-de-France	95	3	16	429	Montreuil-sur-Epte	443	9	452
11	Île-de-France	95	2	26	430	Montsoult	3396	32	3428
11	Île-de-France	95	3	03	436	Mours	1352	14	1366
11	Île-de-France	95	3	17	438	Moussy	151	2	153
11	Île-de-France	95	3	14	445	Nerville-la-Forêt	653	16	669
11	Île-de-France	95	3	34	446	Nesles-la-Vallée	1820	40	1860
11	Île-de-France	95	3	17	447	Neuilly-en-Vexin	203	2	205
11	Île-de-France	95	3	39	450	Neuville-sur-Oise	2014	52	2066
11	Île-de-France	95	3	03	452	Nointel	833	14	847
11	Île-de-France	95	2	26	456	Noisy-sur-Oise	688	10	698
11	Île-de-France	95	3	17	459	Nucourt	735	14	749
11	Île-de-France	95	3	16	462	Omerville	301	7	308
11	Île-de-France	95	3	29	476	Osny	16236	301	16537
11	Île-de-France	95	3	14	480	Parmain	5531	80	5611
11	Île-de-France	95	3	27	483	Le Perchay	548	5	553
11	Île-de-France	95	3	03	487	Persan	10498	94	10592
11	Île-de-France	95	3	28	488	Pierrelaye	7958	164	8122
11	Île-de-France	95	2	08	489	Piscop	714	64	778
11	Île-de-France	95	3	28	491	Le Plessis-Bouchard	7730	82	7812
11	Île-de-France	95	2	08	492	Le Plessis-Gassot	73	0	73
11	Île-de-France	95	2	15	493	Le Plessis-Luzarches	131	1	132
11	Île-de-France	95	3	19	500	Pontoise	29548	1463	31011
11	Île-de-France	95	3	14	504	Presles	3788	72	3860
11	Île-de-France	95	2	15	509	Puiseux-en-France	3294	22	3316
11	Île-de-France	95	3	29	510	Puiseux-Pontoise	433	5	438
11	Île-de-France	95	3	16	523	La Roche-Guyon	454	60	514
11	Île-de-France	95	2	13	527	Roissy-en-France	2750	27	2777
11	Île-de-France	95	3	03	529	Ronquerolles	858	20	878
11	Île-de-France	95	3	27	535	Sagy	1160	28	1188
11	Île-de-France	95	2	08	539	Saint-Brice-sous-Forêt	14320	167	14487
11	Île-de-France	95	3	16	541	Saint-Clair-sur-Epte	934	8	942
11	Île-de-France	95	3	16	543	Saint-Cyr-en-Arthies	228	3	231
11	Île-de-France	95	3	16	554	Saint-Gervais	958	20	978
11	Île-de-France	95	2	40	555	Saint-Gratien	20156	170	20326
11	Île-de-France	95	3	20	563	Saint-Leu-la-Forêt	14766	196	14962
11	Île-de-France	95	2	26	566	Saint-Martin-du-Tertre	2586	16	2602
11	Île-de-France	95	3	21	572	Saint-Ouen-l;Aumône	23608	281	23889
11	Île-de-France	95	3	20	574	Saint-Prix	7308	156	7464
11	Île-de-France	95	2	15	580	Saint-Witz	2566	69	2635
11	Île-de-France	95	1	22	582	Sannois	26090	569	26659
11	Île-de-France	95	3	17	584	Santeuil	603	9	612
11	Île-de-France	95	2	98	585	Sarcelles	58614	590	59204
11	Île-de-France	95	3	27	592	Seraincourt	1332	27	1359
11	Île-de-France	95	2	26	594	Seugy	1035	20	1055
11	Île-de-France	95	2	24	598	Soisy-sous-Montmorency	17428	242	17670
11	Île-de-France	95	2	15	604	Survilliers	3833	33	3866
11	Île-de-France	95	3	25	607	Taverny	26144	296	26440
11	Île-de-France	95	3	27	610	Théméricourt	264	6	270
11	Île-de-France	95	3	17	611	Theuville	28	1	29
11	Île-de-France	95	2	13	612	Le Thillay	4118	39	4157
11	Île-de-France	95	3	27	625	Us	1318	15	1333
11	Île-de-France	95	3	34	627	Vallangoujard	634	10	644
11	Île-de-France	95	3	34	628	Valmondois	1204	22	1226
11	Île-de-France	95	2	13	633	Vaudherland	90	1	91
11	Île-de-France	95	3	39	637	Vauréal	16180	263	16443
11	Île-de-France	95	2	13	641	Vémars	2205	25	2230
11	Île-de-France	95	3	16	651	Vétheuil	887	14	901
11	Île-de-France	95	2	26	652	Viarmes	4985	84	5069
11	Île-de-France	95	3	16	656	Vienne-en-Arthies	417	10	427
11	Île-de-France	95	3	27	658	Vigny	1077	17	1094
11	Île-de-France	95	2	26	660	Villaines-sous-Bois	671	10	681
11	Île-de-France	95	2	13	675	Villeron	811	4	815
11	Île-de-France	95	3	16	676	Villers-en-Arthies	461	8	469
11	Île-de-France	95	3	14	678	Villiers-Adam	828	11	839
11	Île-de-France	95	2	35	680	Villiers-le-Bel	26736	268	27004
11	Île-de-France	95	2	15	682	Villiers-le-Sec	176	0	176
11	Île-de-France	95	3	16	690	Wy-dit-Joli-Village	327	5	332
01	Guadeloupe	971	2	93	101	Les Abymes	58534	733	59267
01	Guadeloupe	971	2	03	102	Anse-Bertrand	4775	79	4854
01	Guadeloupe	971	1	04	103	Baie-Mahault	30251	524	30775
01	Guadeloupe	971	1	36	104	Baillif	5214	98	5312
01	Guadeloupe	971	1	94	105	Basse-Terre	11915	230	12145
01	Guadeloupe	971	1	07	106	Bouillante	7545	130	7675
01	Guadeloupe	971	1	90	107	Capesterre-Belle-Eau	19321	223	19544
01	Guadeloupe	971	2	09	108	Capesterre-de-Marie-Galante	3381	81	3462
01	Guadeloupe	971	1	33	111	Deshaies	4431	64	4495
01	Guadeloupe	971	2	10	110	La Désirade	1579	67	1646
01	Guadeloupe	971	2	91	113	Le Gosier	26311	432	26743
01	Guadeloupe	971	1	42	109	Gourbeyre	7949	211	8160
01	Guadeloupe	971	1	43	114	Goyave	8065	143	8208
01	Guadeloupe	971	2	12	112	Grand-Bourg	5530	192	5722
01	Guadeloupe	971	1	13	115	Lamentin	15913	278	16191
01	Guadeloupe	971	2	95	116	Morne-à-l;Eau	16725	170	16895
01	Guadeloupe	971	2	96	117	Le Moule	22381	335	22716
01	Guadeloupe	971	1	92	118	Petit-Bourg	23199	407	23606
01	Guadeloupe	971	2	19	119	Petit-Canal	8038	77	8115
01	Guadeloupe	971	2	97	120	Pointe-à-Pitre	16427	123	16550
01	Guadeloupe	971	1	24	121	Pointe-Noire	7006	145	7151
01	Guadeloupe	971	2	03	122	Port-Louis	5440	72	5512
01	Guadeloupe	971	1	26	124	Saint-Claude	10467	221	10688
01	Guadeloupe	971	2	27	125	Saint-François	14797	201	14998
01	Guadeloupe	971	2	28	126	Saint-Louis	2650	92	2742
01	Guadeloupe	971	2	98	128	Sainte-Anne	24192	419	24611
01	Guadeloupe	971	1	99	129	Sainte-Rose	20155	288	20443
01	Guadeloupe	971	1	34	130	Terre-de-Bas	1095	47	1142
01	Guadeloupe	971	1	34	131	Terre-de-Haut	1787	52	1839
01	Guadeloupe	971	1	35	132	Trois-Rivières	8755	203	8958
01	Guadeloupe	971	1	35	133	Vieux-Fort	1824	22	1846
01	Guadeloupe	971	1	36	134	Vieux-Habitants	7703	191	7894
02	Martinique	972	2	01	201	L; Ajoupa-Bouillon	1735	30	1765
02	Martinique	972	3	02	202	Les Anses-d;Arlet	3852	52	3904
02	Martinique	972	2	03	203	Basse-Pointe	3711	82	3793
02	Martinique	972	4	05	234	Bellefontaine	1437	73	1510
02	Martinique	972	4	04	204	Le Carbet	3771	52	3823
02	Martinique	972	4	05	205	Case-Pilote	4469	100	4569
02	Martinique	972	3	06	206	Le Diamant	6066	145	6211
02	Martinique	972	3	07	207	Ducos	16896	313	17209
02	Martinique	972	4	29	208	Fonds-Saint-Denis	857	2	859
02	Martinique	972	1	99	209	Fort-de-France	87216	1407	88623
02	Martinique	972	3	94	210	Le François	19218	329	19547
02	Martinique	972	2	18	211	Grand;Rivière	605	8	613
02	Martinique	972	2	15	212	Gros-Morne	10588	149	10737
02	Martinique	972	1	95	213	Le Lamentin	39360	636	39996
02	Martinique	972	2	17	214	Le Lorrain	7526	120	7646
02	Martinique	972	2	18	215	Macouba	1193	18	1211
02	Martinique	972	2	19	216	Le Marigot	3603	65	3668
02	Martinique	972	3	20	217	Le Marin	8690	161	8851
02	Martinique	972	4	21	218	Le Morne-Rouge	5083	151	5234
02	Martinique	972	4	04	233	Le Morne-Vert	1857	25	1882
02	Martinique	972	4	23	219	Le Prêcheur	1664	33	1697
02	Martinique	972	3	24	220	Rivière-Pilote	13221	104	13325
02	Martinique	972	3	25	221	Rivière-Salée	12767	273	13040
02	Martinique	972	2	96	222	Le Robert	23918	177	24095
02	Martinique	972	3	27	223	Saint-Esprit	9335	94	9429
02	Martinique	972	1	28	224	Saint-Joseph	16717	340	17057
02	Martinique	972	4	29	225	Saint-Pierre	4425	57	4482
02	Martinique	972	3	30	226	Sainte-Anne	4684	50	4734
02	Martinique	972	3	31	227	Sainte-Luce	9926	205	10131
02	Martinique	972	2	97	228	Sainte-Marie	18389	233	18622
02	Martinique	972	1	98	229	Schoelcher	20814	395	21209
02	Martinique	972	2	34	230	La Trinité	13724	241	13965
02	Martinique	972	3	35	231	Les Trois-Îlets	7627	107	7734
02	Martinique	972	3	36	232	Le Vauclin	9229	135	9364
03	Guyane	973	2	16	360	Apatou	6704	32	6736
03	Guyane	973	2	09	361	Awala-Yalimapo	1305	12	1317
03	Guyane	973	1	12	356	Camopi	1625	14	1639
03	Guyane	973	1	99	302	Cayenne	55753	249	56002
03	Guyane	973	2	16	357	Grand-Santi	5065	26	5091
03	Guyane	973	1	06	303	Iracoubo	1976	19	1995
03	Guyane	973	1	07	304	Kourou	25189	215	25404
03	Guyane	973	1	08	305	Macouria	9640	111	9751
03	Guyane	973	2	09	306	Mana	8952	157	9109
03	Guyane	973	2	16	353	Maripasoula	8473	56	8529
03	Guyane	973	1	19	307	Matoury	28110	297	28407
03	Guyane	973	1	15	313	Montsinéry-Tonnegrande	2217	17	2234
03	Guyane	973	1	12	314	Ouanary	94	4	98
03	Guyane	973	2	16	362	Papaichton	4827	5	4832
03	Guyane	973	1	01	301	Régina	874	15	889
03	Guyane	973	1	10	309	Remire-Montjoly	19279	412	19691
03	Guyane	973	1	11	310	Roura	2601	63	2664
03	Guyane	973	1	14	358	Saint-Élie	555	1	556
03	Guyane	973	1	12	308	Saint-Georges	4037	96	4133
03	Guyane	973	2	13	311	Saint-Laurent-du-Maroni	38367	290	38657
03	Guyane	973	2	16	352	Saül	155	7	162
03	Guyane	973	1	14	312	Sinnamary	3242	29	3271
04	La Réunion	974	2	01	401	Les Avirons	10580	150	10730
04	La Réunion	974	3	02	402	Bras-Panon	11725	135	11860
04	La Réunion	974	2	22	424	Cilaos	5807	101	5908
04	La Réunion	974	2	03	403	Entre-Deux	6133	91	6224
04	La Réunion	974	2	04	404	L; Étang-Salé	13467	192	13659
04	La Réunion	974	2	05	405	Petite-Île	11566	105	11671
04	La Réunion	974	3	06	406	La Plaine-des-Palmistes	5213	84	5297
04	La Réunion	974	4	91	407	Le Port	38418	250	38668
04	La Réunion	974	4	08	408	La Possession	30373	411	30784
04	La Réunion	974	3	92	409	Saint-André	53955	356	54311
04	La Réunion	974	3	90	410	Saint-Benoît	35063	189	35252
04	La Réunion	974	1	93	411	Saint-Denis	145022	1467	146489
04	La Réunion	974	2	94	412	Saint-Joseph	35976	483	36459
04	La Réunion	974	4	95	413	Saint-Leu	30966	332	31298
04	La Réunion	974	2	96	414	Saint-Louis	52038	469	52507
04	La Réunion	974	4	97	415	Saint-Paul	103346	1472	104818
04	La Réunion	974	2	26	417	Saint-Philippe	5086	56	5142
04	La Réunion	974	2	98	416	Saint-Pierre	79228	799	80027
04	La Réunion	974	1	30	418	Sainte-Marie	29951	342	30293
04	La Réunion	974	3	31	419	Sainte-Rose	6806	89	6895
04	La Réunion	974	1	32	420	Sainte-Suzanne	22421	206	22627
04	La Réunion	974	3	33	421	Salazie	7510	80	7590
04	La Réunion	974	2	99	422	Le Tampon	73365	809	74174
04	La Réunion	974	4	36	423	Les Trois-Bassins	7121	99	7220
